Acc_BBAN,Acc_IBAN,Acc_Open_Dt,Balance,Cust_ID,Expense,Expense_Category,browser,device,dr_cr,login_time,logout_time,txn_Dt,txn_ID,txn_amount,txn_code,txn_remarks,txn_time,txn_type
RHOS43398039713911,GB61LNNL27019625918822,8/4/2019,5822.3,100001,N,Credited,SAFARI,PC,Cr,7:14:43,11:24:53,8/4/2019,49760811,466.51,1,Reduce meeting read collection interest health news. Others prevent truth argue author type others. Outside mission end foreign until.,9:22:10,NEFT
RHOS43398039713911,GB61LNNL27019625918822,8/4/2019,6288.81,100001,N,Credited,CHROME,MOBILE,Cr,11:59:09,15:18:06,8/4/2019,42666943,466.51,5,"Occur environment film method.
Box region behavior job half. But toward energy yeah wide. Opportunity coach them along sometimes treat.
Sound matter remain six analysis fast. Society idea clearly.",13:39:29,CARDS
RHOS43398039713911,GB61LNNL27019625918822,8/4/2019,6755.32,100001,N,Credited,SAFARI,POS,Cr,16:58:31,18:27:45,8/4/2019,38399527,466.51,1,"Admit space read Mrs fear. Me whether customer return close. Evening show together star single. Away newspaper four me ask offer look.
To most place wide why. Teach peace worry rate.",17:54:01,NEFT
RHOS43398039713911,GB61LNNL27019625918822,8/4/2019,7221.83,100001,N,Credited,SAFARI,MOBILE,Cr,20:43:50,22:28:44,8/4/2019,83195211,466.51,4,"Surface important challenge sport during dinner movement. Raise power late their south teach color.
Summer contain teach owner. Include subject moment yet less owner student.",21:20:11,UPI
RHOS43398039713911,GB61LNNL27019625918822,8/4/2019,5409.04,100001,Y,Household Consumables,EDGE,MOBILE,Dr,11:38:00,21:00:49,8/12/2019,84209757,1812.79,7,"Action general event. Floor certainly series option about personal class mission.
Product money budget sign gun lay risk. Cold face question task finally.",15:02:14,DD
RHOS43398039713911,GB61LNNL27019625918822,8/4/2019,6001.55,100001,N,Credited,MI,PC,Cr,3:47:43,5:55:49,8/24/2019,42376019,592.51,6,"Once approach five garden subject threat land. Real together allow dark agency. Trip property throughout me major itself painting.
Situation magazine for boy. Act bed whatever then.",5:02:24,CHEQUE
RHOS43398039713911,GB61LNNL27019625918822,8/4/2019,6594.06,100001,N,Credited,CHROME,POS,Cr,10:19:52,13:19:06,8/24/2019,4986911,592.51,6,"Everybody laugh level. Else letter when far economic role case. Own discussion week religious some six.
Fall power success out officer great seat. Surface wide like order federal.",11:52:36,CHEQUE
RHOS43398039713911,GB61LNNL27019625918822,8/4/2019,7186.57,100001,N,Credited,OPERA,MOBILE,Cr,13:13:48,15:34:09,8/24/2019,60386700,592.51,6,Low site home former detail democratic any. Loss song Mr will plant a president read. Success property want simple short.,14:27:39,CHEQUE
RHOS43398039713911,GB61LNNL27019625918822,8/4/2019,7779.08,100001,N,Credited,EDGE,MOBILE,Cr,17:02:46,19:40:03,8/24/2019,1781007,592.51,4,"Year hope about include. Industry partner Mr read. Wall future vote.
Board bed decade culture morning. Loss she room top another development.",18:58:46,UPI
RHOS43398039713911,GB61LNNL27019625918822,8/4/2019,7186.57,100001,Y,Dining,IE,PC,Dr,19:19:26,22:05:21,8/24/2019,33186894,592.51,7,"Rather energy career sound. It today stock make police popular involve world.
Because away top main. Plant out couple change. Line side about around.",20:24:41,DD
RHOS43398039713911,GB61LNNL27019625918822,8/4/2019,7175.44,100001,Y,Online Shopping,CHROME,POS,Dr,9:07:53,11:31:41,8/29/2019,82630249,11.13,2,"Page maybe simply surface include economy attack. Cultural arrive recently goal single again friend. Modern none question international chance upon.
Per herself standard.",10:37:20,IMPS
RHOS43398039713911,GB61LNNL27019625918822,8/4/2019,7186.57,100001,N,Credited,FF,PC,Cr,19:21:48,23:56:57,8/29/2019,99401139,11.13,2,"Still tell admit war water have. Majority sell hear sound major response.
Police protect your voice. Even human sea recently water risk certain. Street create plant summer.",21:25:34,IMPS
RHOS43398039713911,GB61LNNL27019625918822,8/4/2019,6831.67,100001,Y,Dining,IE,POS,Dr,5:27:16,8:53:45,8/31/2019,82016425,354.9,4,"Program large writer almost social drive early. Clear bring nor best poor direction.
Cold enough value third follow skin blood. Soldier else rock.",7:44:01,UPI
RHOS43398039713911,GB61LNNL27019625918822,8/4/2019,6476.77,100001,Y,Personal Care,FF,POS,Dr,11:34:53,14:47:05,8/31/2019,18615449,354.9,2,Middle upon explain reason anything third part. Start street yeah air article medical they soldier.,12:28:39,IMPS
RHOS43398039713911,GB61LNNL27019625918822,8/4/2019,6121.87,100001,Y,Groceries,FF,MOBILE,Dr,14:02:25,16:37:12,8/31/2019,28249566,354.9,7,Subject address it these travel past cut. Responsibility decide success reality war.,14:31:49,DD
RHOS43398039713911,GB61LNNL27019625918822,8/4/2019,6476.77,100001,N,Credited,SAFARI,PC,Cr,20:39:21,22:04:46,8/31/2019,99997304,354.9,5,"Attention speak off. Born none tell book budget place word.
Determine thought space front foreign increase direction research. Ready long develop thought.",21:31:12,CARDS
RHOS43398039713911,GB61LNNL27019625918822,8/4/2019,7083.88,100001,N,Credited,CHROME,PC,Cr,3:28:49,4:57:18,9/4/2019,20591809,607.11,4,Police arrive per thing anyone tough rule. Recent left action kitchen certainly including. Item security environmental smile. Next attention follow of.,4:27:07,UPI
RHOS43398039713911,GB61LNNL27019625918822,8/4/2019,7690.99,100001,N,Credited,MI,PC,Cr,9:04:21,11:41:29,9/4/2019,45110948,607.11,5,"Head eight cultural half staff. Return everyone affect true month she experience. Their fear if point wife catch.
Whole lay full entire boy. Sister fight appear whole after continue too.",11:01:36,CARDS
RHOS43398039713911,GB61LNNL27019625918822,8/4/2019,7083.88,100001,Y,Utilities,FF,PC,Dr,12:29:45,14:58:22,9/4/2019,74070916,607.11,3,"Inside enter blue late. Shoulder far even whose bit more organization.
Democratic democratic crime policy teacher dog true. Table common name yeah as. Nor opportunity when fly side newspaper data.",14:25:55,RTGS
RHOS43398039713911,GB61LNNL27019625918822,8/4/2019,7690.99,100001,N,Credited,OPERA,MOBILE,Cr,14:31:06,16:45:57,9/4/2019,34290231,607.11,6,"Performance special good chair single particularly. Read school break your yeah good return.
Argue significant force sea current team. Continue her cause see. Movie value question ball rest data.",16:13:08,CHEQUE
RHOS43398039713911,GB61LNNL27019625918822,8/4/2019,8298.1,100001,N,Credited,MI,PC,Cr,20:58:13,23:36:17,9/4/2019,91133441,607.11,4,"Set she church. Rather interview benefit such finish article.
At above environmental Mrs production strong past. International mind weight south. Community condition school hair.",22:06:52,UPI
RHOS43398039713911,GB61LNNL27019625918822,8/4/2019,9149.31,100001,N,Credited,FF,MOBILE,Cr,5:19:56,8:43:37,9/6/2019,67034819,851.21,4,"Plant tell spring beautiful off friend born. Service father Mrs enough front.
Prove street sing social. Along attention staff sort finally stock.",6:51:33,UPI
RHOS43398039713911,GB61LNNL27019625918822,8/4/2019,8298.1,100001,Y,Transportation,CHROME,PC,Dr,9:51:24,12:42:56,9/6/2019,15808660,851.21,5,Community while decision number base out best hair. Nation glass less former newspaper.,11:39:25,CARDS
RHOS43398039713911,GB61LNNL27019625918822,8/4/2019,7446.89,100001,Y,Online Shopping,IE,PC,Dr,12:31:19,16:50:05,9/6/2019,81776856,851.21,4,"Message just politics care respond top medical manager. Entire Republican allow dream toward senior.
School under big certain discuss six. Scene draw ten certainly not.",14:34:02,UPI
RHOS43398039713911,GB61LNNL27019625918822,8/4/2019,8298.1,100001,N,Credited,MI,POS,Cr,20:33:16,23:19:07,9/6/2019,7772894,851.21,4,"Fire network forget father. Five very guy management. Law edge strong quickly law local.
Much ready green write meeting. Board prepare former.
High type help local. Seem heavy will morning case.",21:57:47,UPI
RHOS43398039713911,GB61LNNL27019625918822,8/4/2019,8741.44,100001,N,Credited,CHROME,PC,Cr,6:40:04,8:53:26,9/26/2019,17889858,443.34,7,"House explain shoulder. Behavior baby claim foreign financial. Phone item ahead behavior.
Opportunity teach start. Discuss night card leave.",7:40:20,DD
RHOS43398039713911,GB61LNNL27019625918822,8/4/2019,9184.78,100001,N,Credited,MI,PC,Cr,10:08:26,12:50:24,9/26/2019,99697563,443.34,6,Where tax rich image control radio card. So size where ever campaign new. So market wonder get change include including.,11:42:30,CHEQUE
RHOS43398039713911,GB61LNNL27019625918822,8/4/2019,9628.12,100001,N,Credited,OPERA,POS,Cr,13:10:52,16:09:10,9/26/2019,37973322,443.34,1,Central government magazine interest all already explain. Candidate seat theory pick so.,14:35:18,NEFT
RHOS43398039713911,GB61LNNL27019625918822,8/4/2019,9184.78,100001,Y,Rent,SAFARI,POS,Dr,18:31:35,19:50:52,9/26/2019,49064254,443.34,3,"Enough professional kid artist build do hear. Blue because close operation building social coach leg.
World new new relate natural. High month and fund city buy.",19:20:11,RTGS
RHOS43398039713911,GB61LNNL27019625918822,8/4/2019,8741.44,100001,Y,Transportation,IE,MOBILE,Dr,20:59:48,22:59:00,9/26/2019,11807179,443.34,5,Save trouble high recently cause ball like. Choice fish various cause. Sport majority purpose use fear century home at.,22:04:35,CARDS
RHOS43398039713911,GB61LNNL27019625918822,8/4/2019,9689.32,100001,N,Credited,CHROME,PC,Cr,4:53:25,7:14:59,9/30/2019,40219615,947.88,2,"Great action discussion well. Memory concern administration between cover them subject. Sign focus perhaps risk.
Stock say enjoy east. Effect everyone own south important three foot.",6:33:31,IMPS
RHOS43398039713911,GB61LNNL27019625918822,8/4/2019,8741.44,100001,Y,Utilities,CHROME,PC,Dr,10:25:12,14:05:12,9/30/2019,54421219,947.88,7,"Along house could price weight gun. On town trial bill human.
The system easy administration magazine. Build out sort just remain service control. Speak while after speech on dark scientist.",11:57:49,DD
RHOS43398039713911,GB61LNNL27019625918822,8/4/2019,7793.56,100001,Y,Online Shopping,FF,POS,Dr,13:01:50,16:42:03,9/30/2019,63552812,947.88,5,"Drug pick claim government name. Space still want drug want safe.
Read phone mind while. Writer help market college prevent social. Race if prove real food.",14:42:20,CARDS
RHOS43398039713911,GB61LNNL27019625918822,8/4/2019,8741.44,100001,N,Credited,OPERA,MOBILE,Cr,21:16:16,22:56:44,9/30/2019,22591920,947.88,5,"Base show four movie young make financial. Us section happy affect lose owner. Impact history piece.
Social need make should voice structure. Center peace item heart have fact part.",22:08:39,CARDS
RHOS43398039713911,GB61LNNL27019625918822,8/4/2019,8949.8,100001,N,Credited,EDGE,POS,Cr,5:48:49,11:17:24,10/13/2019,79316460,208.36,4,"Million effort within television reflect same box. Reason research personal accept interesting crime side.
End too still kid attorney. Low current blue business rule read PM. Their form in.",9:25:21,UPI
RHOS43398039713911,GB61LNNL27019625918822,8/4/2019,8741.44,100001,Y,Groceries,OPERA,PC,Dr,15:37:24,20:23:54,10/13/2019,86311953,208.36,5,"Great trip south some lawyer. Remain hope various whose. Choose beyond identify style maybe.
None end join only issue black. Return government maybe move board allow majority.",16:42:32,CARDS
RHOS43398039713911,GB61LNNL27019625918822,8/4/2019,10556.94,100001,N,Credited,IE,PC,Cr,15:03:12,25:46:46,10/14/2019,37139384,1815.5,5,"But possible begin executive analysis what. Majority receive yard discuss present trade.
Matter avoid wind pass. Including newspaper order service spend. Nice best tree own less large politics.",21:02:33,CARDS
RHOS43398039713911,GB61LNNL27019625918822,8/4/2019,9781.86,100001,Y,Insurance,CHROME,POS,Dr,7:01:43,9:55:00,10/17/2019,76560552,775.08,7,All hour available yes. View after southern expert arm. Maintain remember company. After end around sing job finish chair.,7:33:03,DD
RHOS43398039713911,GB61LNNL27019625918822,8/4/2019,10556.94,100001,N,Credited,OPERA,MOBILE,Cr,9:20:59,10:34:55,10/17/2019,72515884,775.08,5,Avoid only often too late. Car blood behavior near. Thought recognize myself special different read.,10:03:52,CARDS
RHOS43398039713911,GB61LNNL27019625918822,8/4/2019,11332.02,100001,N,Credited,SAFARI,PC,Cr,14:27:46,17:10:49,10/17/2019,31169479,775.08,1,"Themselves happy available somebody those over follow. Voice happen cause home her same outside often.
Degree research same.",15:16:36,NEFT
RHOS43398039713911,GB61LNNL27019625918822,8/4/2019,10556.94,100001,Y,Insurance,EDGE,MOBILE,Dr,18:15:25,20:17:25,10/17/2019,53835321,775.08,3,"Know small or site exist. Child near even baby.
Office movement involve about morning hot put. Forget deal special program scene question true two. Positive group as writer.",19:24:37,RTGS
RHOS43398039713911,GB61LNNL27019625918822,8/4/2019,8620.22,100001,Y,Personal Care,CHROME,PC,Dr,6:20:13,9:23:58,10/19/2019,90055348,1936.72,4,"Right sell address world hard build money. Few both day fire wait. When safe baby.
Parent technology appear part statement. Ago strong culture view skill yes. Sing important increase suggest create.",7:59:54,UPI
RHOS43398039713911,GB61LNNL27019625918822,8/4/2019,6683.5,100001,Y,Groceries,FF,MOBILE,Dr,10:28:09,13:35:03,10/19/2019,47883857,1936.72,1,Black account college total father nearly reality gun. Painting open paper president. Past expect citizen adult thank partner specific carry.,12:15:04,NEFT
RHOS43398039713911,GB61LNNL27019625918822,8/4/2019,4746.78,100001,Y,Entertainment,FF,PC,Dr,13:29:03,17:06:38,10/19/2019,95142173,1936.72,1,"Training reflect room tonight design campaign help. Community language treat since suffer remain.
Cultural score fact food. Popular eye enough four seven.",15:21:16,NEFT
RHOS43398039713911,GB61LNNL27019625918822,8/4/2019,2810.06,100001,Y,Rent,MI,MOBILE,Dr,22:12:52,24:32:55,10/19/2019,66865339,1936.72,4,"Return reason allow. Especially point hold north game door bag.
Second speak need happen week what executive nice. Protect sell sea church base mother step half.",23:59:45,UPI
RHOS43398039713911,GB61LNNL27019625918822,8/4/2019,2672.78,100001,Y,Groceries,OPERA,PC,Dr,5:48:36,7:55:39,10/30/2019,10760666,137.28,7,"Age a magazine group organization democratic. Per appear wish.
Report vote reduce admit half. The walk high travel well apply program. Expert hold grow career onto decision.",6:57:13,DD
RHOS43398039713911,GB61LNNL27019625918822,8/4/2019,2810.06,100001,N,Credited,MI,MOBILE,Cr,10:14:09,13:40:24,10/30/2019,40066899,137.28,5,"Concern magazine forget. Rather continue poor idea gas imagine claim.
Threat practice movement college thank. Call race grow nor eat cup current.",11:55:01,CARDS
RHOS43398039713911,GB61LNNL27019625918822,8/4/2019,2947.34,100001,N,Credited,IE,MOBILE,Cr,12:38:05,14:33:26,10/30/2019,85551855,137.28,4,"Agent policy consider too anything make. Rate name professor maintain town break. Raise last door event.
Respond career kitchen source despite.",13:06:49,UPI
RHOS43398039713911,GB61LNNL27019625918822,8/4/2019,2810.06,100001,Y,Personal Care,CHROME,PC,Dr,18:16:55,20:47:19,10/30/2019,80584834,137.28,3,"Identify then dinner however short. Fall federal garden specific day over. Growth visit data similar recent item specific.
Feeling sport paper four though forward. Power hospital scientist natural.",19:26:08,RTGS
RHOS43398039713911,GB61LNNL27019625918822,8/4/2019,2672.78,100001,Y,Online Shopping,MI,POS,Dr,21:20:06,23:36:53,10/30/2019,73637004,137.28,1,"From theory we range. Own because discover fact population.
Skill tell sure dark mother until late. Life build if day offer military likely.",22:06:43,NEFT
RHOS43398039713911,GB61LNNL27019625918822,8/4/2019,3371.58,100001,N,Credited,OPERA,POS,Cr,8:29:53,10:08:06,10/31/2019,61563445,698.8,4,"Quality leader cover in entire billion know. Determine claim deal need fall music benefit.
Indicate exactly coach establish huge.",9:35:08,UPI
RHOS43398039713911,GB61LNNL27019625918822,8/4/2019,2672.78,100001,Y,Household Consumables,FF,POS,Dr,12:53:15,15:55:45,10/31/2019,49427462,698.8,1,"Into across book will gas reality red beautiful. Fund many hard maintain response.
Size society night surface left feel play. One war dream respond.",13:53:22,NEFT
RHOS43398039713911,GB61LNNL27019625918822,8/4/2019,1973.98,100001,Y,Utilities,SAFARI,POS,Dr,13:14:45,16:51:00,10/31/2019,64516707,698.8,2,Raise might small risk color push medical somebody. Apply part help sport share sing property. Man local affect join outside treat more. Politics stay campaign woman food.,15:09:39,IMPS
RHOS43398039713911,GB61LNNL27019625918822,8/4/2019,1275.18,100001,Y,Entertainment,FF,MOBILE,Dr,18:25:22,20:35:12,10/31/2019,82732677,698.8,4,Even plant family dark action without your. Hand star me government war when. Tell tell push newspaper rule.,19:20:29,UPI
RHOS43398039713911,GB61LNNL27019625918822,8/4/2019,1959.14,100001,N,Credited,FF,MOBILE,Cr,17:32:46,27:07:05,11/3/2019,18886849,683.96,6,"About discussion peace law ten around argue.
Stand describe perform enjoy raise own finish. Recognize including phone.
Forward tree identify fast.",22:33:50,CHEQUE
RHOS43398039713911,GB61LNNL27019625918822,8/4/2019,268.11,100001,Y,Insurance,OPERA,POS,Dr,7:00:25,10:06:17,11/17/2019,6163099,1691.03,7,"Seek crime that raise listen environment no. Plant blue better forward around TV us model.
Speech century decade else car. Also husband check. Must budget cut.",8:09:38,DD
RHOS43398039713911,GB61LNNL27019625918822,8/4/2019,1409.07,100001,N,Credited,MI,POS,Cr,6:21:16,9:39:16,11/18/2019,67203468,1140.96,1,"Per without bed safe. Marriage seven type class ball night.
Eye movement however professional they partner. Claim early beat yes machine write.",7:31:55,NEFT
RHOS43398039713911,GB61LNNL27019625918822,8/4/2019,2550.03,100001,N,Credited,OPERA,MOBILE,Cr,8:06:43,10:14:56,11/18/2019,2313054,1140.96,5,Half interesting mean party. True Mr sign until adult low box. Him onto example bit.,9:37:44,CARDS
RHOS43398039713911,GB61LNNL27019625918822,8/4/2019,3690.99,100001,N,Credited,SAFARI,POS,Cr,14:41:00,17:44:05,11/18/2019,6493424,1140.96,1,"Fall second pretty today condition hot. Seven drug Congress unit certain in know.
Activity true avoid drive.
Direction see up soon quickly forward. Family nearly quickly certain.",16:12:06,NEFT
RHOS43398039713911,GB61LNNL27019625918822,8/4/2019,4831.95,100001,N,Credited,MI,MOBILE,Cr,18:47:50,20:16:14,11/18/2019,90353475,1140.96,5,"Material half meet score week nearly project. Law lot should teacher around. Century appear various strategy reality.
Full task four century thousand fast. Again usually fire offer blue speak.",19:28:46,CARDS
RHOS43398039713911,GB61LNNL27019625918822,8/4/2019,3342.26,100001,Y,Groceries,FF,POS,Dr,10:19:19,17:07:36,11/23/2019,11450115,1489.69,6,Country current inside fine other information find. Region raise late trouble candidate because. Follow song response doctor prove professional particular.,15:05:15,CHEQUE
RHOS43398039713911,GB61LNNL27019625918822,8/4/2019,4698.17,100001,N,Credited,CHROME,MOBILE,Cr,5:01:46,7:21:29,11/27/2019,11271826,1355.91,3,"Through coach side ten already short language. Mean vote loss artist experience.
Paper song stand rock sometimes. Themselves majority discussion hold over.",6:25:02,RTGS
RHOS43398039713911,GB61LNNL27019625918822,8/4/2019,3342.26,100001,Y,Rent,SAFARI,MOBILE,Dr,10:53:27,14:12:17,11/27/2019,58618271,1355.91,7,"Half investment yard behavior treatment trial speak.
Week break own couple. Brother hand debate.
Agreement attention threat company. Food gas reveal chance. Debate here wrong event water analysis.",12:16:39,DD
RHOS43398039713911,GB61LNNL27019625918822,8/4/2019,1986.35,100001,Y,Groceries,EDGE,PC,Dr,16:42:56,19:54:49,11/27/2019,80184300,1355.91,5,"Whom new buy may affect. Accept big others yeah act fast. Reduce but team true which rate age.
Glass everybody already decade list gun. Each catch should possible car.",18:59:00,CARDS
RHOS43398039713911,GB61LNNL27019625918822,8/4/2019,630.44,100001,Y,Rent,MI,PC,Dr,17:06:18,20:04:05,11/27/2019,83471087,1355.91,3,"Such establish wonder add.
Area direction stay. Find war space. Bank information seem subject nothing. Player pay themselves watch star.",19:26:30,RTGS
RHOS43398039713911,GB61LNNL27019625918822,8/4/2019,1702.88,100001,N,Credited,SAFARI,POS,Cr,8:25:38,10:31:53,12/1/2019,55527491,1072.44,2,Either eight model strong loss contain. Foreign under push quality role. Affect operation cup executive hard number.,9:39:39,IMPS
RHOS43398039713911,GB61LNNL27019625918822,8/4/2019,630.44,100001,Y,Utilities,CHROME,PC,Dr,15:06:57,16:54:16,12/1/2019,47597952,1072.44,4,"More itself test go other join most. Something would watch light area hold. History car over baby pull.
World inside military including. Relate staff lose.",15:41:42,UPI
RHOS43398039713911,GB61LNNL27019625918822,8/4/2019,1789.66,100001,N,Credited,OPERA,MOBILE,Cr,7:58:22,9:52:40,12/2/2019,62290869,1159.22,6,Around cup brother low join avoid serious. Police at again though another industry deep. Itself meeting police reveal.,9:00:48,CHEQUE
RHOS43398039713911,GB61LNNL27019625918822,8/4/2019,2948.88,100001,N,Credited,IE,POS,Cr,12:00:55,13:38:52,12/2/2019,42664321,1159.22,1,Bank address political care rock. Continue shake smile near model now. Forget question fall explain across front yet. Report these those vote.,12:50:45,NEFT
RHOS43398039713911,GB61LNNL27019625918822,8/4/2019,1789.66,100001,Y,Household Consumables,SAFARI,POS,Dr,16:33:46,18:47:17,12/2/2019,50577033,1159.22,7,"Interview within certainly. Hour PM bag evidence. History station risk officer side indeed recent.
Nice whatever radio face look market. Expect baby serve region imagine owner north.",17:25:59,DD
RHOS43398039713911,GB61LNNL27019625918822,8/4/2019,2948.88,100001,N,Credited,OPERA,MOBILE,Cr,21:03:39,24:35:42,12/2/2019,60849984,1159.22,5,Vote firm begin million news. Lose talk alone. Skill environmental impact office cold station image situation. Station early hair job day.,22:20:05,CARDS
RHOS43398039713911,GB61LNNL27019625918822,8/4/2019,4453.54,100001,N,Credited,MI,MOBILE,Cr,10:14:59,13:26:35,12/3/2019,26820514,1504.66,7,"Establish father be major information drive man condition. Continue tree small. Evidence husband anything themselves turn pass.
Brother soldier long. Stay ask before century pressure any.",11:04:32,DD
RHOS43398039713911,GB61LNNL27019625918822,8/4/2019,5958.2,100001,N,Credited,MI,MOBILE,Cr,9:27:52,15:07:46,12/3/2019,14185908,1504.66,5,Ahead forward strong idea. Cost include hold serious. Building authority difficult.,12:27:25,CARDS
RHOS43398039713911,GB61LNNL27019625918822,8/4/2019,7462.86,100001,N,Credited,OPERA,POS,Cr,20:04:01,22:44:08,12/3/2019,15564221,1504.66,2,Work this Mr audience term. However change investment purpose. Country next interest maybe certainly feel nothing. Style pull you.,21:44:20,IMPS
RHOS43398039713911,GB61LNNL27019625918822,8/4/2019,8958.93,100001,N,Credited,SAFARI,MOBILE,Cr,3:51:33,6:00:12,12/6/2019,60905727,1496.07,4,Hand bank tax growth similar author. Ahead doctor everybody either star. Environment nothing senior shake.,5:15:37,UPI
RHOS43398039713911,GB61LNNL27019625918822,8/4/2019,7462.86,100001,Y,Dining,EDGE,MOBILE,Dr,9:47:02,12:15:59,12/6/2019,14896354,1496.07,6,"Focus life TV herself. Prevent office hand will artist hope physical. Sing step work color.
Democrat health outside across. Many build inside car. People voice though during all east after.",10:29:36,CHEQUE
RHOS43398039713911,GB61LNNL27019625918822,8/4/2019,5966.79,100001,Y,Medicals,FF,POS,Dr,13:33:02,16:39:11,12/6/2019,77589750,1496.07,2,Agree range east nice form traditional police. Mission provide player throw. Season computer peace own adult arrive example.,14:43:23,IMPS
RHOS43398039713911,GB61LNNL27019625918822,8/4/2019,4470.72,100001,Y,Insurance,MI,MOBILE,Dr,15:38:30,18:34:55,12/6/2019,61520820,1496.07,4,"Word bank blue course. Strategy kitchen sort black look maybe.
Threat walk fast particular dog staff. Marriage American data color. Environmental child maybe expert recent alone.",17:17:56,UPI
RHOS43398039713911,GB61LNNL27019625918822,8/4/2019,2974.65,100001,Y,Groceries,MI,POS,Dr,20:48:57,23:25:24,12/6/2019,15175595,1496.07,7,"Whatever former practice all event for time. To piece sing sea option long.
Activity so such democratic seat there yeah. Subject threat serve heavy report husband quickly hotel.",22:18:08,DD
RHOS43398039713911,GB61LNNL27019625918822,8/4/2019,3232.03,100001,N,Credited,SAFARI,MOBILE,Cr,14:05:12,21:15:18,12/14/2019,81276837,257.38,3,Within mention never of. Nothing important mission base organization baby. Performance pattern different marriage.,15:43:25,RTGS
RHOS43398039713911,GB61LNNL27019625918822,8/4/2019,1536.62,100001,Y,Personal Care,EDGE,PC,Dr,6:59:58,13:15:23,12/30/2019,74954414,1695.41,2,Smile suffer name lot. There machine save forward because whole. Respond most two next current buy.,9:39:40,IMPS
RHOS43398039713911,GB61LNNL27019625918822,8/4/2019,1977.02,100001,N,Credited,EDGE,PC,Cr,15:57:49,22:55:05,1/11/2020,29089338,440.4,1,"Difference trip weight night something. Word tree understand.
Real section sister other industry back stock. Purpose security level class husband.",19:42:57,NEFT
RHOS43398039713911,GB61LNNL27019625918822,8/4/2019,2870.49,100001,N,Credited,FF,MOBILE,Cr,5:19:08,7:20:48,1/16/2020,25572803,893.47,7,"Thus help both wear join project. Opportunity decide sure go moment gas indicate.
We short yet technology public. Chair source dinner control build itself age. Western all gas next.",5:55:18,DD
RHOS43398039713911,GB61LNNL27019625918822,8/4/2019,3763.96,100001,N,Credited,EDGE,POS,Cr,6:47:43,10:21:23,1/16/2020,79865913,893.47,2,"Your walk turn. Nor point call gun house positive they.
Day ten a window guy conference. Heart quality lawyer property central factor.",8:43:58,IMPS
RHOS43398039713911,GB61LNNL27019625918822,8/4/2019,4657.43,100001,N,Credited,EDGE,PC,Cr,13:37:04,15:43:57,1/16/2020,63804843,893.47,1,"Against company respond beyond black pass ready. Establish think clear project report father prepare. Serve serious with sure represent.
Easy performance end network security force reach.",14:20:21,NEFT
RHOS43398039713911,GB61LNNL27019625918822,8/4/2019,5550.9,100001,N,Credited,MI,MOBILE,Cr,17:26:15,19:28:41,1/16/2020,91922632,893.47,7,"Process side big perhaps true their stop. Produce each democratic money eat.
Appear who course quite wrong friend move. Five within pass money big ready before.",17:51:09,DD
RHOS43398039713911,GB61LNNL27019625918822,8/4/2019,4657.43,100001,Y,Medicals,MI,POS,Dr,21:07:42,23:28:43,1/16/2020,58242568,893.47,1,"Recently vote call lawyer pressure fact keep. Compare myself meet improve to nor.
Read yourself mind yes. Fire always identify big wait forget.",23:03:29,NEFT
RHOS43398039713911,GB61LNNL27019625918822,8/4/2019,4143.75,100001,Y,Medicals,CHROME,POS,Dr,13:34:19,20:29:14,1/25/2020,16062399,513.68,5,Marriage crime business type music start part. Again north commercial behavior board herself always student. Deep tough safe set food.,14:51:45,CARDS
RHOS43398039713911,GB61LNNL27019625918822,8/4/2019,5867.72,100001,N,Credited,MI,MOBILE,Cr,16:08:29,19:31:48,2/3/2020,38726033,1723.97,6,"Hundred both discuss forward. Appear author fund rather person.
Where manager employee reveal water. Within growth no hard special thousand. He agency now mouth.",18:08:26,CHEQUE
RHOS43398039713911,GB61LNNL27019625918822,8/4/2019,6099.98,100001,N,Credited,MI,MOBILE,Cr,5:06:40,7:17:32,2/6/2020,92767478,232.26,4,"Middle democratic fact vote seven cold above. Quite view tend either player scientist a involve.
Movie key especially attack. Buy seek image sell other network. Along across small four.",5:45:36,UPI
RHOS43398039713911,GB61LNNL27019625918822,8/4/2019,5867.72,100001,Y,Utilities,SAFARI,MOBILE,Dr,11:39:44,13:35:35,2/6/2020,39969033,232.26,3,"Another maybe same successful audience history.
Society marriage which authority word answer cut. Question measure despite foot need. Window remain mention close sort support not.",12:48:05,RTGS
RHOS43398039713911,GB61LNNL27019625918822,8/4/2019,5635.46,100001,Y,Medicals,CHROME,PC,Dr,15:53:47,17:49:16,2/6/2020,82496081,232.26,1,Eat surface land surface example candidate bag idea. Believe throughout break final stock. Visit television leave every half adult bag.,17:08:51,NEFT
RHOS43398039713911,GB61LNNL27019625918822,8/4/2019,5403.2,100001,Y,Dining,EDGE,POS,Dr,19:33:39,23:14:14,2/6/2020,96407646,232.26,3,Later student report debate audience occur. Whole station gas situation under environment. Hear decide mouth how around keep. Up spring least.,21:56:23,RTGS
RHOS43398039713911,GB61LNNL27019625918822,8/4/2019,5482.91,100001,N,Credited,MI,MOBILE,Cr,9:11:21,13:28:43,2/7/2020,83082665,79.71,5,Sometimes member walk program should manager. Value protect hot. Safe million blood item fish seek moment. Service course high hundred when enjoy.,11:10:01,CARDS
RHOS43398039713911,GB61LNNL27019625918822,8/4/2019,5403.2,100001,Y,Medicals,MI,POS,Dr,13:31:41,15:58:07,2/7/2020,88530789,79.71,5,Too different worry material certainly off news. It born star color economic somebody.,14:50:20,CARDS
RHOS43398039713911,GB61LNNL27019625918822,8/4/2019,5323.49,100001,Y,Dining,SAFARI,MOBILE,Dr,20:31:26,23:44:13,2/7/2020,76429880,79.71,1,Cause too oil level right. Successful such learn. Impact themselves there suggest read.,23:03:32,NEFT
RHOS43398039713911,GB61LNNL27019625918822,8/4/2019,3361.65,100001,Y,Rent,MI,MOBILE,Dr,3:32:32,5:51:54,2/10/2020,80224655,1961.84,7,"Knowledge party edge seem. Suffer entire around prove second wait traditional.
Doctor age line good. But Republican them. Draw sound would.",5:05:41,DD
RHOS43398039713911,GB61LNNL27019625918822,8/4/2019,5323.49,100001,N,Credited,MI,POS,Cr,9:48:22,12:33:19,2/10/2020,60804167,1961.84,4,"Structure yet over standard. President call there exist.
Professional keep success four chair true cold. Create government lead peace consider.",11:18:54,UPI
RHOS43398039713911,GB61LNNL27019625918822,8/4/2019,3361.65,100001,Y,Medicals,OPERA,PC,Dr,10:23:25,13:23:58,2/10/2020,57759432,1961.84,5,Training space describe weight behavior reflect. Theory way put together early baby scientist entire.,12:22:03,CARDS
RHOS43398039713911,GB61LNNL27019625918822,8/4/2019,1399.81,100001,Y,Insurance,EDGE,PC,Dr,16:49:09,19:32:16,2/10/2020,15837448,1961.84,5,Process board decision since story defense. Not PM identify be exist prevent will. Development us certain or.,18:43:26,CARDS
RHOS43398039713911,GB61LNNL27019625918822,8/4/2019,3361.65,100001,N,Credited,EDGE,PC,Cr,20:13:24,22:47:36,2/10/2020,27774588,1961.84,2,"Until plant environment read. Power likely series your morning notice.
Option performance relationship challenge democratic step. Individual different space method finally.",22:09:21,IMPS
RHOS43398039713911,GB61LNNL27019625918822,8/4/2019,1897.98,100001,Y,Entertainment,OPERA,MOBILE,Dr,4:50:41,8:28:40,2/16/2020,9965089,1463.67,1,Health recognize involve daughter eat about field. Treat list character recently street camera. Vote one nature glass imagine individual. Responsibility size be campaign.,6:27:22,NEFT
RHOS43398039713911,GB61LNNL27019625918822,8/4/2019,3361.65,100001,N,Credited,IE,MOBILE,Cr,11:04:02,13:47:15,2/16/2020,54051492,1463.67,4,Plant benefit crime sort feel parent. Kid attack close then stop help share. Statement budget age trip as different various.,11:38:21,UPI
RHOS43398039713911,GB61LNNL27019625918822,8/4/2019,4825.32,100001,N,Credited,IE,PC,Cr,14:19:42,16:51:12,2/16/2020,96258361,1463.67,3,Collection into best street total clearly feel. Beat third site. Figure want stand range. Media visit full event.,16:17:46,RTGS
RHOS43398039713911,GB61LNNL27019625918822,8/4/2019,3361.65,100001,Y,Online Shopping,OPERA,POS,Dr,21:06:26,23:25:01,2/16/2020,39361486,1463.67,1,"Win change figure plan professor inside themselves. Watch hit health rock.
Throw light among over develop away win.
Require down behavior speak character maybe man interest. Present party follow.",21:40:40,NEFT
RHOS43398039713911,GB61LNNL27019625918822,8/4/2019,2725.78,100001,Y,Personal Care,SAFARI,PC,Dr,2:55:48,5:32:15,2/17/2020,67328833,635.87,3,Middle write only rock. Time cultural out doctor newspaper. Face authority before lead. World money now democratic window arm traditional blood.,4:17:28,RTGS
RHOS43398039713911,GB61LNNL27019625918822,8/4/2019,2089.91,100001,Y,Personal Care,IE,PC,Dr,8:06:14,10:35:27,2/17/2020,14486944,635.87,4,Score back suffer might movement six believe food. Forward anything during happen structure religious quickly and.,10:03:52,UPI
RHOS43398039713911,GB61LNNL27019625918822,8/4/2019,2725.78,100001,N,Credited,SAFARI,PC,Cr,14:30:23,16:55:49,2/17/2020,73992721,635.87,4,"High story administration watch. Task like hope range specific fight.
Pm cell boy matter. Decision beat remain account require.
Final happy cup.
Let administration maintain president kid.",15:51:52,UPI
RHOS43398039713911,GB61LNNL27019625918822,8/4/2019,3361.65,100001,N,Credited,CHROME,POS,Cr,17:01:15,18:38:18,2/17/2020,28620839,635.87,2,"Stage although his chance stage reality bank kid. Spend table professor yet other practice defense.
No capital whatever prevent particular white. Whose company that.",17:48:38,IMPS
RHOS43398039713911,GB61LNNL27019625918822,8/4/2019,2725.78,100001,Y,Entertainment,OPERA,MOBILE,Dr,21:34:22,22:41:21,2/17/2020,54673571,635.87,2,"Since drug manage pretty head.
Chance party place tell. Have later arrive good across every.
Knowledge class investment Democrat. Police speech remain.",22:02:58,IMPS
RHOS43398039713911,GB61LNNL27019625918822,8/4/2019,2108.88,100001,Y,Medicals,FF,MOBILE,Dr,6:00:14,7:14:26,2/20/2020,10237656,616.9,4,"Bad feel painting nation. Individual employee official economy put director full.
Yeah inside possible decide team position news. Book investment whole baby cup. Thing democratic like feeling.",6:31:02,UPI
RHOS43398039713911,GB61LNNL27019625918822,8/4/2019,2725.78,100001,N,Credited,OPERA,MOBILE,Cr,8:23:13,12:33:54,2/20/2020,94929843,616.9,3,"Service should oil own product their.
Teacher scientist network throughout theory card. The begin method message attack stock responsibility. President institution almost far manager machine.",10:28:55,RTGS
RHOS43398039713911,GB61LNNL27019625918822,8/4/2019,2108.88,100001,Y,Entertainment,EDGE,PC,Dr,15:26:28,16:48:39,2/20/2020,49157260,616.9,2,"Wait look pretty movie research mean political. Week know police.
Door your listen exactly any during. Hotel church page onto. Today however room meeting suddenly.",16:11:41,IMPS
RHOS43398039713911,GB61LNNL27019625918822,8/4/2019,2725.78,100001,N,Credited,IE,POS,Cr,21:53:29,24:48:15,2/20/2020,90857690,616.9,7,Production fall cultural similar can. Career tax account within.,22:58:06,DD
RHOS43398039713911,GB61LNNL27019625918822,8/4/2019,2229.7,100001,Y,Personal Care,SAFARI,POS,Dr,6:55:07,10:04:34,2/25/2020,36542130,496.08,1,"Form business many. Major center dark camera decision cold once. Effort article community dog tonight table lawyer.
High form conference range reason population. Ok guy ahead trial.",9:06:22,NEFT
RHOS43398039713911,GB61LNNL27019625918822,8/4/2019,1733.62,100001,Y,Household Consumables,IE,POS,Dr,14:40:45,17:03:55,2/25/2020,30125858,496.08,7,Not feeling company not. Nice south effort mouth source throw four. Turn series radio little. No practice heart president.,15:42:33,DD
RHOS43398039713911,GB61LNNL27019625918822,8/4/2019,1237.54,100001,Y,Dining,EDGE,MOBILE,Dr,20:09:13,24:50:05,2/25/2020,28299189,496.08,3,Real relationship lawyer born month people. Compare exactly fall executive artist. Cost believe eight stage push be service.,23:00:32,RTGS
RHOS43398039713911,GB61LNNL27019625918822,8/4/2019,2644.25,100001,N,Credited,CHROME,MOBILE,Cr,5:39:25,9:59:06,3/4/2020,29006168,1406.71,7,"Discussion sort event federal cultural college happy.
Over together over yard. Necessary continue big next even own. Quickly measure perform best.",8:29:14,DD
RHOS43398039713911,GB61LNNL27019625918822,8/4/2019,4050.96,100001,N,Credited,OPERA,POS,Cr,14:51:41,19:00:11,3/4/2020,74832897,1406.71,5,What economic range sell. Common take rather evening. Yeah teacher field professional research none.,17:30:20,CARDS
RHOS43398039713911,GB61LNNL27019625918822,8/4/2019,2644.25,100001,Y,Household Consumables,EDGE,MOBILE,Dr,21:37:36,23:29:02,3/4/2020,11730842,1406.71,4,"Your throw including exactly carry experience leave. Analysis off serious where. Officer side gas move sea audience involve.
Run down example road. You toward position maintain.",22:32:56,UPI
RHOS43398039713911,GB61LNNL27019625918822,8/4/2019,809.79,100001,Y,Groceries,IE,MOBILE,Dr,10:19:01,16:16:55,3/24/2020,89689554,1834.46,2,Food strategy these middle around total culture. Understand adult right choose defense table allow.,12:17:59,IMPS
RHOS43398039713911,GB61LNNL27019625918822,8/4/2019,2644.25,100001,N,Credited,FF,MOBILE,Cr,15:09:53,17:50:01,3/24/2020,3237373,1834.46,2,"Likely middle finish mean rest despite. Wait edge tend service friend.
Get represent bring. Station world since turn.
Too agent to support recent group. Fall specific public truth.",16:05:46,IMPS
RHOS43398039713911,GB61LNNL27019625918822,8/4/2019,2872.12,100001,N,Credited,IE,MOBILE,Cr,13:03:09,19:37:12,4/1/2020,60960078,227.87,2,Provide black some report article. When rich blood. Still first our activity.,14:53:16,IMPS
RHOS43398039713911,GB61LNNL27019625918822,8/4/2019,2596.15,100001,Y,Insurance,CHROME,POS,Dr,5:59:38,9:45:00,4/11/2020,97534037,275.97,4,"Apply purpose use speak result pick write. Necessary easy positive side friend even current. Total back popular source often hour.
Field media customer surface whole wrong. Local treat building also.",7:25:50,UPI
RHOS43398039713911,GB61LNNL27019625918822,8/4/2019,2320.18,100001,Y,Utilities,FF,POS,Dr,9:44:12,12:52:56,4/11/2020,50102112,275.97,1,Our outside home small senior home green. Skin reason former help whom.,11:22:54,NEFT
RHOS43398039713911,GB61LNNL27019625918822,8/4/2019,2596.15,100001,N,Credited,SAFARI,MOBILE,Cr,14:41:26,17:46:09,4/11/2020,248440,275.97,3,Put name billion begin whatever production. Raise life trip effort tell room. Important after yourself.,15:22:41,RTGS
RHOS43398039713911,GB61LNNL27019625918822,8/4/2019,2320.18,100001,Y,Dining,EDGE,PC,Dr,19:56:11,21:58:20,4/11/2020,60789631,275.97,1,"Son ok save which. Will detail free low. Show yes leave affect term born stay.
Government baby all around why us ability. Son rest relate least cover black.",20:40:43,NEFT
RHOS43398039713911,GB61LNNL27019625918822,8/4/2019,3637.96,100001,N,Credited,IE,PC,Cr,17:49:24,26:03:15,4/15/2020,54438262,1317.78,5,"Close and performance bring pay voice check.
Cost letter find leg. That trade though nature. Yet so first current detail accept.
Light develop ten over mind best. Reflect strategy class.",22:11:41,CARDS
RHOS43398039713911,GB61LNNL27019625918822,8/4/2019,2094.34,100001,Y,Groceries,OPERA,PC,Dr,11:27:07,22:19:12,4/27/2020,34908105,1543.62,4,"Phone itself group keep baby. Nature son physical fund but show.
Popular board or science pretty age performance that. Newspaper radio kid. Fine their strategy reflect would.",17:06:26,UPI
RHOS43398039713911,GB61LNNL27019625918822,8/4/2019,699.41,100001,Y,Online Shopping,EDGE,POS,Dr,11:02:07,18:50:34,5/1/2020,86523837,1394.93,3,"Major when medical simply.
Because very born stop church trip political. Heart up TV perhaps travel government.",13:51:37,RTGS
RHOS43398039713911,GB61LNNL27019625918822,8/4/2019,1722.01,100001,N,Credited,EDGE,MOBILE,Cr,11:19:35,14:55:19,5/6/2020,46210739,1022.6,1,"Exactly note trade economic move. Election enough record no condition spring other environment.
Every visit ok hold investment room where. Create difference finally miss choice indicate.",12:58:32,NEFT
RHOS43398039713911,GB61LNNL27019625918822,8/4/2019,699.41,100001,Y,Utilities,FF,POS,Dr,16:53:18,18:31:22,5/6/2020,55734882,1022.6,1,"Medical difficult order red imagine base. Another nothing husband even clear here high provide.
Much wide mind military itself like. Data detail too.",17:42:47,NEFT
RHOS43398039713911,GB61LNNL27019625918822,8/4/2019,925.21,100001,N,Credited,IE,MOBILE,Cr,8:20:28,12:57:55,5/7/2020,72661086,225.8,4,Analysis represent care kitchen response analysis stage PM. Follow accept particular floor. Kitchen appear very wish require Democrat their.,11:15:01,UPI
RHOS43398039713911,GB61LNNL27019625918822,8/4/2019,699.41,100001,Y,Medicals,CHROME,POS,Dr,12:27:02,16:19:36,5/7/2020,12888948,225.8,7,"Almost well everybody. Floor top tell certainly. Note speak person can quickly. Continue pay walk follow.
Make seem also create risk measure during. Whole what place race. Can soon including.",14:18:11,DD
RHOS43398039713911,GB61LNNL27019625918822,8/4/2019,925.21,100001,N,Credited,SAFARI,MOBILE,Cr,21:35:04,24:09:53,5/7/2020,48856720,225.8,1,"Success human break spring trade. Crime nice bit make thank picture often.
Science focus wonder particularly today. Painting simply table so building expert pay what.",22:14:02,NEFT
RHOS43398039713911,GB61LNNL27019625918822,8/4/2019,1528.26,100001,N,Credited,CHROME,PC,Cr,5:20:06,7:57:43,5/26/2020,11667810,603.05,6,"Available back produce red. Program prove from force feel from forget environmental.
Threat some business future through. Standard drop scene attack lay face. Play show authority training keep.",6:31:47,CHEQUE
RHOS43398039713911,GB61LNNL27019625918822,8/4/2019,925.21,100001,Y,Online Shopping,SAFARI,POS,Dr,12:42:20,16:00:46,5/26/2020,87820324,603.05,5,"Again since kid after shake. Building may west station. Suddenly particular up contain miss sometimes grow.
Upon any room structure concern. West site physical image ago skin according term.",14:02:29,CARDS
RHOS43398039713911,GB61LNNL27019625918822,8/4/2019,1528.26,100001,N,Credited,MI,POS,Cr,14:01:51,16:19:54,5/26/2020,86695749,603.05,2,"House positive least reduce decision staff four radio. Decade gun investment left. Traditional general information fly.
Produce rise identify try laugh around alone.",15:31:52,IMPS
RHOS43398039713911,GB61LNNL27019625918822,8/4/2019,925.21,100001,Y,Household Consumables,CHROME,MOBILE,Dr,19:36:30,21:52:08,5/26/2020,68697266,603.05,1,"Group represent song read accept. Event remember should organization. Myself beyond herself point.
Both type near call since community. Coach support drop always.",20:09:23,NEFT
RHOS43398039713911,GB61LNNL27019625918822,8/4/2019,1859.05,100001,N,Credited,IE,POS,Cr,7:49:20,9:31:59,5/30/2020,14518201,933.84,2,"Century today rate yard during right cell. Involve adult sister sit its against.
Low arm prepare sell human safe. All upon raise along early.",9:05:17,IMPS
RHOS43398039713911,GB61LNNL27019625918822,8/4/2019,2792.89,100001,N,Credited,CHROME,POS,Cr,13:35:30,16:16:13,5/30/2020,74059225,933.84,1,Case no all gas bring box like help. Fall rise democratic leader charge if expert begin.,15:35:04,NEFT
RHOS43398039713911,GB61LNNL27019625918822,8/4/2019,3726.73,100001,N,Credited,EDGE,MOBILE,Cr,15:19:47,17:12:42,5/30/2020,4392873,933.84,2,"American second us fact positive. Seem also job produce consumer politics also.
Floor civil father southern guy easy computer. Table science office water.",16:09:03,IMPS
RHOS43398039713911,GB61LNNL27019625918822,8/4/2019,2792.89,100001,Y,Rent,MI,MOBILE,Dr,22:03:02,24:12:33,5/30/2020,18523416,933.84,3,"Sport chair point than must model. Common turn word remain fight try.
Knowledge too rule travel rule nothing executive argue.",23:16:39,RTGS
RHOS43398039713911,GB61LNNL27019625918822,8/4/2019,4177.6,100001,N,Credited,EDGE,POS,Cr,13:37:27,23:42:43,6/10/2020,76917226,1384.71,4,"Wall life machine. Fire collection ago money share article green.
Source board level join school.
Article nature lose writer work church total able. Lose item campaign.",18:17:04,UPI
RHOS43398039713911,GB61LNNL27019625918822,8/4/2019,5055.32,100001,N,Credited,FF,MOBILE,Cr,5:32:45,12:15:58,6/13/2020,14693014,877.72,4,"Black better federal I. Store war money.
Special send build other analysis high they certainly. Able major relate away bar. Might try manager maybe whether her prepare.",8:48:24,UPI
RHOS43398039713911,GB61LNNL27019625918822,8/4/2019,4177.6,100001,Y,Medicals,IE,PC,Dr,19:47:32,24:10:16,6/13/2020,86663458,877.72,5,"East camera over data. Cost return drug.
Catch red bill form lawyer item support wear. Travel personal need factor. Always out data economy future I determine.",21:13:07,CARDS
RHOS43398039713911,GB61LNNL27019625918822,8/4/2019,5133.65,100001,N,Credited,CHROME,PC,Cr,4:20:54,7:30:18,6/18/2020,15721099,956.05,7,High improve three between certainly maintain. Speak author happy back stock. Fly authority quickly return again entire should.,5:59:04,DD
RHOS43398039713911,GB61LNNL27019625918822,8/4/2019,4177.6,100001,Y,Utilities,EDGE,PC,Dr,6:10:24,9:50:48,6/18/2020,12797455,956.05,4,Foot southern here. Pressure scientist every everything if artist. Tell south practice never cause game.,8:08:30,UPI
RHOS43398039713911,GB61LNNL27019625918822,8/4/2019,3221.55,100001,Y,Online Shopping,SAFARI,PC,Dr,10:07:21,14:00:27,6/18/2020,3481004,956.05,4,Ability effort adult education. Discover financial act save.,12:02:14,UPI
RHOS43398039713911,GB61LNNL27019625918822,8/4/2019,4177.6,100001,N,Credited,IE,MOBILE,Cr,17:05:26,19:33:58,6/18/2020,78547018,956.05,3,Nothing other sell cost main hotel probably fear. Machine suggest turn test. Admit least example begin establish.,18:55:07,RTGS
RHOS43398039713911,GB61LNNL27019625918822,8/4/2019,5133.65,100001,N,Credited,CHROME,MOBILE,Cr,20:29:49,21:27:26,6/18/2020,42956938,956.05,1,Ten Congress line know right shake purpose. Another relationship despite tree. Painting beat entire enough raise fact live.,21:01:00,NEFT
RHOS43398039713911,GB61LNNL27019625918822,8/4/2019,4519.52,100001,Y,Personal Care,OPERA,POS,Dr,4:11:46,6:33:10,6/26/2020,88570112,614.13,1,Teach nor respond cultural senior whose. Medical instead account.,4:55:54,NEFT
RHOS43398039713911,GB61LNNL27019625918822,8/4/2019,3905.39,100001,Y,Transportation,MI,PC,Dr,13:00:23,15:51:35,6/26/2020,65676325,614.13,4,Marriage allow series worry lose their hair. Direction college put pretty above happen stay. Year whatever party present. Make commercial century modern.,14:07:27,UPI
RHOS43398039713911,GB61LNNL27019625918822,8/4/2019,4519.52,100001,N,Credited,IE,POS,Cr,16:12:44,19:21:01,6/26/2020,50139637,614.13,2,"Mention today vote yourself chance give. Sound program interest where system.
Young quite push. Skin guy break walk fast. Form religious former kid soon care activity.",17:11:34,IMPS
RHOS43398039713911,GB61LNNL27019625918822,8/4/2019,5133.65,100001,N,Credited,IE,POS,Cr,18:16:26,22:28:21,6/26/2020,79589741,614.13,4,Machine five exist half design others. Professor official lay necessary travel every indeed. Tough onto close capital.,20:16:31,UPI
RHOS43398039713911,GB61LNNL27019625918822,8/4/2019,6959.9,100001,N,Credited,SAFARI,MOBILE,Cr,5:46:22,7:49:25,6/28/2020,23978331,1826.25,1,"Quickly science finally trip do.
Writer similar challenge every save wonder. Friend tend different buy family bad.
Book kitchen church perform ready assume. Again seem to deep set.",7:22:12,NEFT
RHOS43398039713911,GB61LNNL27019625918822,8/4/2019,8786.15,100001,N,Credited,CHROME,POS,Cr,9:37:37,12:11:51,6/28/2020,70582932,1826.25,6,"Low build article south positive be. Conference we church without. Yard seven their size realize she.
Later option maybe place production. Piece rock never fund.
Skill admit rest.",10:56:16,CHEQUE
RHOS43398039713911,GB61LNNL27019625918822,8/4/2019,6959.9,100001,Y,Transportation,SAFARI,POS,Dr,15:16:04,17:49:57,6/28/2020,71171852,1826.25,6,"Agency send old like group.
Whole beautiful attack very. Few one respond think everybody remember hold.
Event that investment check lot stop. Relate whether money industry Mrs body.",15:59:46,CHEQUE
RHOS43398039713911,GB61LNNL27019625918822,8/4/2019,8786.15,100001,N,Credited,FF,PC,Cr,16:52:29,18:29:55,6/28/2020,16948457,1826.25,1,Mind something pressure phone matter pretty. Reach black later themselves ahead spring. Nice clear from money age.,17:32:15,NEFT
RHOS43398039713911,GB61LNNL27019625918822,8/4/2019,10612.4,100001,N,Credited,IE,MOBILE,Cr,19:28:53,21:35:18,6/28/2020,38079733,1826.25,2,"Me through least Mr.
Begin card community hot. Wonder understand radio fire summer color analysis. Walk various rich keep age.
Medical media imagine into young station fire. Less bill receive kind.",20:21:16,IMPS
RHOS43398039713911,GB61LNNL27019625918822,8/4/2019,10331.05,100001,Y,Rent,FF,POS,Dr,4:47:50,8:38:08,7/3/2020,17447072,281.35,3,"Into high catch yeah return especially single. Short carry class like necessary possible pattern.
Hit well right your material environmental within yet. Officer group agency group animal too.",6:44:29,RTGS
RHOS43398039713911,GB61LNNL27019625918822,8/4/2019,10049.7,100001,Y,Household Consumables,SAFARI,MOBILE,Dr,7:02:35,8:42:16,7/3/2020,75273354,281.35,5,"This customer similar nor town.
Same energy decide head spring everybody town. Talk month state.
Especially movement point to exist far candidate. A central check nature effort law.",8:09:44,CARDS
RHOS43398039713911,GB61LNNL27019625918822,8/4/2019,9768.35,100001,Y,Groceries,FF,PC,Dr,11:55:22,15:28:53,7/3/2020,3326664,281.35,1,Work research employee range no position human Democrat. Suffer bad bag old institution movie. Yet team hand war difficult.,13:53:53,NEFT
RHOS43398039713911,GB61LNNL27019625918822,8/4/2019,9487,100001,Y,Personal Care,FF,POS,Dr,16:33:47,18:53:59,7/3/2020,51693909,281.35,2,"Indicate future age teach himself artist outside hope. My money case save mind though.
Sound attention their your present. Win individual democratic nearly.
Guy option lay night. Smile two trial.",18:28:49,IMPS
RHOS43398039713911,GB61LNNL27019625918822,8/4/2019,9768.35,100001,N,Credited,IE,POS,Cr,19:56:10,23:39:20,7/3/2020,94170771,281.35,7,Cost thought finally yard how. Yes concern they world head. Increase should apply quickly try then ok. Administration hold strategy likely bring.,21:48:03,DD
RHOS43398039713911,GB61LNNL27019625918822,8/4/2019,11130.6,100001,N,Credited,OPERA,POS,Cr,14:09:14,19:08:12,7/6/2020,78600959,1362.25,1,"Realize almost choose already treatment. Cold high prepare professor.
Investment member look minute. Hope service strong best save myself. Tend air response bad.",17:06:45,NEFT
RHOS43398039713911,GB61LNNL27019625918822,8/4/2019,11352.98,100001,N,Credited,OPERA,PC,Cr,4:07:38,7:00:14,7/7/2020,13068066,222.38,4,"Message time response movement minute instead. Reduce son direction task skin ever again. Animal hit most.
Identify step itself various true former. Key water avoid hard long item.",5:52:48,UPI
RHOS43398039713911,GB61LNNL27019625918822,8/4/2019,11575.36,100001,N,Credited,FF,POS,Cr,10:00:24,11:49:24,7/7/2020,10135563,222.38,2,"Small wish rock office. Exactly pick star street allow left news.
Should lawyer office they network air next. Under government apply apply. Couple star drug design seat.",11:12:06,IMPS
RHOS43398039713911,GB61LNNL27019625918822,8/4/2019,11797.74,100001,N,Credited,IE,POS,Cr,14:44:28,16:51:47,7/7/2020,57012650,222.38,7,Process bill listen go believe speak personal worker. Plan big eye until environment happen good.,15:15:47,DD
RHOS43398039713911,GB61LNNL27019625918822,8/4/2019,11575.36,100001,Y,Personal Care,SAFARI,POS,Dr,19:17:20,22:22:52,7/7/2020,87270501,222.38,6,It environmental probably short especially cup assume. Box beautiful room hard. Pm firm usually production show.,21:08:59,CHEQUE
RHOS43398039713911,GB61LNNL27019625918822,8/4/2019,10929.83,100001,Y,Online Shopping,OPERA,MOBILE,Dr,7:43:50,10:32:23,7/10/2020,53528858,645.53,6,Smile letter appear throughout about low guy whose. Mind trial whom evidence. Special maintain yeah form day. Order win change dark clearly.,9:23:17,CHEQUE
RHOS43398039713911,GB61LNNL27019625918822,8/4/2019,11575.36,100001,N,Credited,CHROME,POS,Cr,9:06:36,11:29:42,7/10/2020,13423438,645.53,7,"She national anyone company with sound. Easy politics star people. Wait top forward however from.
True catch floor team. Image practice offer personal. Quality anything interest two language.",9:45:13,DD
RHOS43398039713911,GB61LNNL27019625918822,8/4/2019,12220.89,100001,N,Credited,SAFARI,PC,Cr,13:18:47,16:36:59,7/10/2020,9372481,645.53,4,"Pattern knowledge return hold cup. Commercial myself quality middle whether.
Data leg thought off. Mission again perform consumer fund growth sound behind.",15:10:03,UPI
RHOS43398039713911,GB61LNNL27019625918822,8/4/2019,12866.42,100001,N,Credited,SAFARI,PC,Cr,17:40:53,20:27:28,7/10/2020,89230299,645.53,3,"Against tax pull yes relationship play across. Only their first free lay radio party.
Attack second take school. Price fund item top policy. Generation institution popular city garden.",19:21:31,RTGS
RHOS43398039713911,GB61LNNL27019625918822,8/4/2019,13438.78,100001,N,Credited,CHROME,PC,Cr,2:54:04,6:29:25,7/11/2020,36743964,572.36,6,"Memory organization we later sport. Another trial none really space finally minute.
Within including call huge. Science street theory thing.",4:47:44,CHEQUE
RHOS43398039713911,GB61LNNL27019625918822,8/4/2019,12866.42,100001,Y,Personal Care,FF,PC,Dr,8:40:36,10:07:04,7/11/2020,40602929,572.36,3,"Top trip brother. Rise government in capital. Allow base hand sea term anyone.
All time international bar production popular language. Talk how subject hour. Situation manage strong.",9:35:22,RTGS
RHOS43398039713911,GB61LNNL27019625918822,8/4/2019,13438.78,100001,N,Credited,IE,PC,Cr,10:49:12,12:59:38,7/11/2020,54092310,572.36,4,"Social a woman organization who sign. Hour reality cell one.
Cell citizen interesting three radio there full detail. Manage sport skill development. Race red together third.",12:32:03,UPI
RHOS43398039713911,GB61LNNL27019625918822,8/4/2019,14011.14,100001,N,Credited,CHROME,POS,Cr,16:49:24,18:47:17,7/11/2020,79127639,572.36,1,Else first event instead official home message. Politics worry space site adult quickly. Stay now community suggest so.,17:34:04,NEFT
RHOS43398039713911,GB61LNNL27019625918822,8/4/2019,14583.5,100001,N,Credited,OPERA,PC,Cr,20:46:57,23:30:14,7/11/2020,55760836,572.36,5,American option this either nation recently employee building. Improve bad head. Keep plan wonder knowledge happy.,22:26:10,CARDS
RHOS43398039713911,GB61LNNL27019625918822,8/4/2019,13652.94,100001,Y,Groceries,IE,MOBILE,Dr,6:47:36,13:01:35,7/14/2020,88695648,930.56,2,"Animal either lawyer. Continue style party require him wrong stay. Ten college during create.
Bag arrive whatever throw television generation pretty.",9:24:35,IMPS
RHOS43398039713911,GB61LNNL27019625918822,8/4/2019,14583.5,100001,N,Credited,MI,POS,Cr,19:42:36,26:14:23,7/14/2020,33917382,930.56,2,"Positive end give water economic group. Against walk billion along necessary.
Apply stop of room. Grow writer send sea training president. Style determine along interesting.",23:30:31,IMPS
RHOS43398039713911,GB61LNNL27019625918822,8/4/2019,13533.96,100001,Y,Household Consumables,MI,PC,Dr,8:03:06,10:24:37,7/17/2020,23453746,1049.54,6,"Including maintain method mouth truth music specific. Already simple else finally doctor.
Miss people skin land experience may.",9:16:19,CHEQUE
RHOS43398039713911,GB61LNNL27019625918822,8/4/2019,14583.5,100001,N,Credited,IE,PC,Cr,11:29:34,15:30:01,7/17/2020,79333467,1049.54,3,Whether similar I report mother especially provide. Cover baby right else. Social party impact outside recognize later.,13:31:32,RTGS
RHOS43398039713911,GB61LNNL27019625918822,8/4/2019,13533.96,100001,Y,Insurance,CHROME,POS,Dr,16:47:45,19:36:39,7/17/2020,8900470,1049.54,6,Seat position establish move dinner. Key art east cell response shoulder wrong another. Three until reason.,17:33:37,CHEQUE
RHOS43398039713911,GB61LNNL27019625918822,8/4/2019,12484.42,100001,Y,Dining,CHROME,POS,Dr,22:10:56,24:38:28,7/17/2020,40358031,1049.54,7,"Could teach difficult professional. Here serious law couple say.
Class pressure watch but dog pattern. Law his buy program. Cell live bring.",23:24:27,DD
RHOS43398039713911,GB61LNNL27019625918822,8/4/2019,12602.45,100001,N,Credited,FF,MOBILE,Cr,9:30:15,15:06:58,7/21/2020,9382220,118.03,4,"Recognize close way fact. Series point line short sea organization.
Property audience investment course social although reveal. Member my across. Thought which relationship usually move wait.",11:59:05,UPI
RHOS43398039713911,GB61LNNL27019625918822,8/4/2019,12484.42,100001,Y,Dining,OPERA,MOBILE,Dr,18:29:38,23:29:40,7/21/2020,24027427,118.03,6,Care simply figure kitchen adult institution standard. Congress home end our. Can participant together region care raise treat challenge.,20:36:10,CHEQUE
RHOS43398039713911,GB61LNNL27019625918822,8/4/2019,10522.21,100001,Y,Personal Care,EDGE,MOBILE,Dr,19:04:39,23:53:47,7/31/2020,27028469,1962.21,1,"Behind short fight source seem authority sit section. Seven throughout north medical bill him plan travel.
Cup third power hair. Season safe purpose point.",21:18:29,NEFT
RHOS43398039713911,GB61LNNL27019625918822,8/4/2019,8604.02,100001,Y,Household Consumables,CHROME,PC,Dr,8:46:25,13:01:35,8/12/2020,74012107,1918.19,5,Build relate just smile save true attention. Business everybody song expect kid. While arrive less offer carry although.,11:37:48,CARDS
RHOS43398039713911,GB61LNNL27019625918822,8/4/2019,6685.83,100001,Y,Transportation,OPERA,MOBILE,Dr,15:48:09,19:03:57,8/12/2020,3099506,1918.19,4,Manager you Mrs information military than. Interview soldier ask father charge nature. Decision entire reflect third window anything.,17:36:59,UPI
RHOS43398039713911,GB61LNNL27019625918822,8/4/2019,4767.64,100001,Y,Personal Care,SAFARI,MOBILE,Dr,19:07:37,21:54:28,8/12/2020,72694541,1918.19,1,"Even computer high own.
Laugh black including across. Value cause game region usually wish sense physical. Vote as white stop.
Million top sing door another. Hear sea blood sound.",19:47:55,NEFT
RHOS43398039713911,GB61LNNL27019625918822,8/4/2019,4417.5,100001,Y,Groceries,MI,POS,Dr,7:27:54,9:22:41,8/15/2020,114691,350.14,7,Leader he bed girl. International discussion somebody question. Spring realize everyone yard.,8:14:05,DD
RHOS43398039713911,GB61LNNL27019625918822,8/4/2019,4067.36,100001,Y,Utilities,FF,PC,Dr,13:17:56,16:28:56,8/15/2020,22097385,350.14,6,Conference reach center matter. World direction community long food break.,14:56:29,CHEQUE
RHOS43398039713911,GB61LNNL27019625918822,8/4/2019,4417.5,100001,N,Credited,IE,POS,Cr,17:59:20,22:33:47,8/15/2020,86000994,350.14,6,Letter arrive speech make thought organization. Poor hotel leg break common prepare leader hotel.,20:22:00,CHEQUE
RHOS43398039713911,GB61LNNL27019625918822,8/4/2019,4594.84,100001,N,Credited,OPERA,POS,Cr,7:11:59,8:22:35,8/26/2020,45542473,177.34,6,Where unit good artist popular. Government ten national according professor include heavy everything. Discussion experience become sport detail move account difficult.,7:37:58,CHEQUE
RHOS43398039713911,GB61LNNL27019625918822,8/4/2019,4417.5,100001,Y,Entertainment,OPERA,MOBILE,Dr,9:59:46,13:07:12,8/26/2020,8681034,177.34,1,"Wife hair material south time area. Many yeah use into. Soon last party manager form sense.
Garden yes address. Find measure across.",11:15:16,NEFT
RHOS43398039713911,GB61LNNL27019625918822,8/4/2019,4594.84,100001,N,Credited,SAFARI,POS,Cr,13:42:14,16:23:09,8/26/2020,19722610,177.34,2,Know seat war lawyer right hit. Strong arm Mr few knowledge ago check.,15:09:41,IMPS
RHOS43398039713911,GB61LNNL27019625918822,8/4/2019,4772.18,100001,N,Credited,SAFARI,PC,Cr,17:05:15,18:44:18,8/26/2020,42655220,177.34,1,"Marriage school become rate agree computer few. East analysis five kitchen.
Training late miss discussion study. Condition hair affect. Cultural budget each.",18:08:00,NEFT
RHOS43398039713911,GB61LNNL27019625918822,8/4/2019,4949.52,100001,N,Credited,CHROME,MOBILE,Cr,21:50:49,24:18:40,8/26/2020,47916807,177.34,7,"Operation create leader figure goal. Kitchen keep story.
Experience production number gun high list Mrs.
Development such have suffer. Without clear trade human drug phone.",22:29:13,DD
RHOS43398039713911,GB61LNNL27019625918822,8/4/2019,6401.4,100001,N,Credited,FF,PC,Cr,13:20:11,18:08:17,9/5/2020,77022905,1451.88,6,Recent begin popular go. Forget piece new behind. Focus seven stand reveal crime direction course.,14:44:21,CHEQUE
RHOS43398039713911,GB61LNNL27019625918822,8/4/2019,7853.28,100001,N,Credited,SAFARI,MOBILE,Cr,16:38:33,22:53:38,9/5/2020,65490518,1451.88,5,"Industry than production theory little usually set. Operation industry Congress. Girl professor Mr talk.
Along quite study themselves check. Reduce we control send security.",20:35:23,CARDS
RHOS43398039713911,GB61LNNL27019625918822,8/4/2019,8054.82,100001,N,Credited,MI,POS,Cr,4:46:37,7:15:28,9/6/2020,79884594,201.54,3,Floor consumer rather race dream. Example state example group adult. Race film ability determine history hundred that.,6:36:31,RTGS
RHOS43398039713911,GB61LNNL27019625918822,8/4/2019,7853.28,100001,Y,Transportation,CHROME,MOBILE,Dr,13:10:51,15:55:11,9/6/2020,98935468,201.54,1,"Weight next among media.
Choice think you security house continue center. Trip attorney leg street.",13:56:18,NEFT
RHOS43398039713911,GB61LNNL27019625918822,8/4/2019,7651.74,100001,Y,Groceries,SAFARI,PC,Dr,15:14:35,19:06:41,9/6/2020,35596561,201.54,5,Bit everybody beat activity matter. Know one should. Name care summer my help forget main rest.,16:46:56,CARDS
RHOS43398039713911,GB61LNNL27019625918822,8/4/2019,7450.2,100001,Y,Entertainment,CHROME,MOBILE,Dr,19:11:46,23:19:26,9/6/2020,83498497,201.54,1,"Despite eye significant mother couple suggest.
Social letter chance hour. Never feeling hear news mouth live.",21:27:23,NEFT
RHOS43398039713911,GB61LNNL27019625918822,8/4/2019,5875.57,100001,Y,Transportation,OPERA,PC,Dr,4:34:43,7:16:51,9/22/2020,1824087,1574.63,4,If laugh too think middle decide. Camera soldier available so baby. Important per course. Gun often fund.,6:07:46,UPI
RHOS43398039713911,GB61LNNL27019625918822,8/4/2019,4300.94,100001,Y,Household Consumables,SAFARI,POS,Dr,8:05:31,11:54:41,9/22/2020,13855222,1574.63,2,"White popular experience sit evening nature.
Capital including herself drop effort assume. Beautiful feel resource dinner admit actually response. Thus theory black purpose later which.",10:24:17,IMPS
RHOS43398039713911,GB61LNNL27019625918822,8/4/2019,5875.57,100001,N,Credited,MI,MOBILE,Cr,13:45:02,17:14:49,9/22/2020,58902769,1574.63,2,"Answer performance certainly than determine. Room daughter door wonder.
Fast quickly director girl color education growth. Rule husband realize boy. New city someone process nation.",15:36:26,IMPS
RHOS43398039713911,GB61LNNL27019625918822,8/4/2019,7450.2,100001,N,Credited,FF,MOBILE,Cr,19:55:45,22:20:52,9/22/2020,10457900,1574.63,3,"Happy open strong job positive. Field wish argue staff term policy. Even late after drug expert your.
Which campaign along war lead. Chair pull bar from key western quality.",21:34:10,RTGS
RHOS43398039713911,GB61LNNL27019625918822,8/4/2019,6530.09,100001,Y,Groceries,SAFARI,MOBILE,Dr,7:26:43,15:17:39,9/29/2020,8824394,920.11,3,"Item require moment return. Teacher themselves provide strong property list everything. Friend sound compare second program.
Risk across ground sort record. Over anyone tell another rest baby.",11:20:33,RTGS
RHOS43398039713911,GB61LNNL27019625918822,8/4/2019,5609.98,100001,Y,Online Shopping,FF,PC,Dr,20:28:00,26:28:50,9/29/2020,96269565,920.11,7,"Pass consider evening worry either. Yard speech dog.
But bar four maybe western. Yet trade discussion sing half all sort evidence. Work yeah Congress traditional wall myself.",23:46:00,DD
RHOS43398039713911,GB61LNNL27019625918822,8/4/2019,5214.38,100001,Y,Groceries,SAFARI,PC,Dr,10:56:50,16:18:14,10/7/2020,20360061,395.6,1,"Finally improve decide situation. Own cost forget TV soldier door after by.
Sound this office support. Up owner force to adult. Color street professor.",14:32:22,NEFT
RHOS43398039713911,GB61LNNL27019625918822,8/4/2019,4818.78,100001,Y,Transportation,SAFARI,MOBILE,Dr,19:57:54,24:55:03,10/7/2020,5680689,395.6,7,"Keep character bad interest record book. Attention standard finally executive sport business. Impact just parent low population.
Religious that box.",23:48:31,DD
RHOS43398039713911,GB61LNNL27019625918822,8/4/2019,3113.57,100001,Y,Online Shopping,MI,MOBILE,Dr,11:50:16,16:24:20,10/9/2020,27710746,1705.21,3,"Also all war fast measure stuff someone. Family leader sister happy term security. Travel story rather class.
Sort nor example common. Morning fine every article race show.",14:44:31,RTGS
RHOS43398039713911,GB61LNNL27019625918822,8/4/2019,4818.78,100001,N,Credited,SAFARI,MOBILE,Cr,14:14:00,19:49:14,10/9/2020,77077684,1705.21,4,"Attorney later can state language. General budget question author but sometimes blood.
Crime maintain agreement such leader. Worry group simply effect foot. Also strong them section.",16:04:27,UPI
RHOS43398039713911,GB61LNNL27019625918822,8/4/2019,5921.59,100001,N,Credited,CHROME,PC,Cr,6:31:27,11:21:14,10/11/2020,9072367,1102.81,3,"Want consumer whatever nearly. Fine fight door laugh community. End everybody lay meet record statement.
Though go decide else business. Get image information daughter marriage hundred.",9:03:27,RTGS
RHOS43398039713911,GB61LNNL27019625918822,8/4/2019,7024.4,100001,N,Credited,CHROME,PC,Cr,12:42:18,17:25:05,10/11/2020,41521410,1102.81,5,"Hear follow water.
Cover pay former small.
Tell pressure past food speak. Where turn Mr book.",15:16:06,CARDS
RHOS43398039713911,GB61LNNL27019625918822,8/4/2019,8127.21,100001,N,Credited,IE,POS,Cr,16:13:09,20:17:20,10/11/2020,54000759,1102.81,1,"Popular why each force attention. Traditional help not woman yeah.
Affect peace a easy whether need worker. Tough product much how mean green defense. Here view everyone.",19:07:46,NEFT
RHOS43398039713911,GB61LNNL27019625918822,8/4/2019,8664.31,100001,N,Credited,SAFARI,PC,Cr,5:21:48,8:36:53,10/22/2020,76297441,537.1,6,Phone if day season different smile tell writer. How dark wide smile answer somebody. Specific candidate dog imagine commercial nearly.,6:50:24,CHEQUE
RHOS43398039713911,GB61LNNL27019625918822,8/4/2019,8127.21,100001,Y,Online Shopping,FF,POS,Dr,12:08:13,16:08:23,10/22/2020,18162653,537.1,4,"Soon experience tough language. Account item anyone.
Rule he even best test. Company recently before lawyer.
Because order western very. Cold draw boy manage black.",14:12:29,UPI
RHOS43398039713911,GB61LNNL27019625918822,8/4/2019,8664.31,100001,N,Credited,CHROME,POS,Cr,18:47:11,22:30:26,10/22/2020,54957015,537.1,2,Wait matter difficult build. Available bank go key.,19:51:19,IMPS
RHOS43398039713911,GB61LNNL27019625918822,8/4/2019,9354.68,100001,N,Credited,EDGE,POS,Cr,12:40:46,17:06:34,10/27/2020,10547304,690.37,7,Program road gas hold. Realize include summer nothing baby push learn. First quite citizen material democratic church open. Coach traditional term air oil learn discuss.,14:10:45,DD
RHOS43398039713911,GB61LNNL27019625918822,8/4/2019,8664.31,100001,Y,Dining,SAFARI,PC,Dr,19:29:15,23:38:21,10/27/2020,51966157,690.37,2,"Once talk name choice beat.
Congress thought soon his house. Eye spend wait about interview report. Least stage Mrs executive. Former far appear heart play.",20:18:04,IMPS
RHOS43398039713911,GB61LNNL27019625918822,8/4/2019,7977.07,100001,Y,Personal Care,IE,PC,Dr,19:55:56,28:49:24,11/4/2020,54370173,687.24,6,"Treat defense enter guy line risk cut.
First realize well to keep strategy. Senior dream what recently. Wife network eye health economic.",23:40:54,CHEQUE
RHOS43398039713911,GB61LNNL27019625918822,8/4/2019,8798.34,100001,N,Credited,CHROME,PC,Cr,7:39:08,11:04:27,11/14/2020,93627160,821.27,6,"Cost whether guess very. Support recently while daughter capital. Almost total consider.
Every oil information question. Raise realize bit agent fund throughout suffer boy.",9:38:47,CHEQUE
RHOS43398039713911,GB61LNNL27019625918822,8/4/2019,7977.07,100001,Y,Entertainment,CHROME,MOBILE,Dr,10:49:05,15:42:00,11/14/2020,87541984,821.27,2,Risk turn where value also peace. Home direction not difference occur someone. For still simply imagine win type fast authority.,12:58:07,IMPS
RHOS43398039713911,GB61LNNL27019625918822,8/4/2019,8798.34,100001,N,Credited,SAFARI,POS,Cr,18:31:44,22:25:31,11/14/2020,79452465,821.27,2,Kitchen news special contain away style. Industry either moment agency money art. Nice nation a idea those page pick.,19:43:37,IMPS
RHOS43398039713911,GB61LNNL27019625918822,8/4/2019,7541,100001,Y,Medicals,SAFARI,MOBILE,Dr,5:02:21,8:02:21,11/24/2020,99807955,1257.34,1,"Story office fall own produce popular. Read against meeting organization available.
Yard decision detail weight father half. Fact tax put risk suffer social. Partner create them.",6:58:16,NEFT
RHOS43398039713911,GB61LNNL27019625918822,8/4/2019,6283.66,100001,Y,Personal Care,IE,PC,Dr,12:45:17,16:13:48,11/24/2020,5725915,1257.34,3,Campaign include among again fear television picture later. Task join true close account base their. Simple however along understand. Right poor race direction.,13:23:33,RTGS
RHOS43398039713911,GB61LNNL27019625918822,8/4/2019,7541,100001,N,Credited,CHROME,PC,Cr,16:38:12,22:06:02,11/24/2020,73911586,1257.34,2,Value information picture. Thus guess alone her tax without. Rather clear agreement enough.,19:27:11,IMPS
RHOS43398039713911,GB61LNNL27019625918822,8/4/2019,8890.47,100001,N,Credited,MI,POS,Cr,19:04:22,22:49:20,11/27/2020,85758612,1349.47,5,"Civil green card population article government. Example win line high not. Want above one person moment mind tend.
Big very deep list audience fly.",20:16:52,CARDS
RHOS43398039713911,GB61LNNL27019625918822,8/4/2019,10092.49,100001,N,Credited,CHROME,MOBILE,Cr,6:42:52,9:54:26,12/6/2020,51362317,1202.02,3,Call material often affect yet adult majority respond. Give example learn blue senior. Customer right you arm. Range bit audience development gun son relationship.,8:02:44,RTGS
RHOS43398039713911,GB61LNNL27019625918822,8/4/2019,11294.51,100001,N,Credited,FF,MOBILE,Cr,10:33:41,13:20:13,12/6/2020,39039781,1202.02,2,Would ahead no add. Cost truth give mouth. Only allow water picture matter give situation drive.,12:43:37,IMPS
RHOS43398039713911,GB61LNNL27019625918822,8/4/2019,12496.53,100001,N,Credited,CHROME,PC,Cr,14:29:01,17:45:38,12/6/2020,33400242,1202.02,5,"Own nor cell. Adult outside often according. Rule scene dark off computer couple.
Entire main technology full commercial song you. Usually difficult bad price.",16:39:54,CARDS
RHOS43398039713911,GB61LNNL27019625918822,8/4/2019,11294.51,100001,Y,Medicals,EDGE,POS,Dr,19:22:42,21:24:15,12/6/2020,32959505,1202.02,1,"Stay study eat worker. West too company leg rather be police. Describe large for industry traditional see middle.
Success need most card against even. Design it hour.",20:33:46,NEFT
RHOS43398039713911,GB61LNNL27019625918822,8/4/2019,13059.78,100001,N,Credited,IE,MOBILE,Cr,7:43:36,9:53:59,12/12/2020,59942023,1765.27,7,"Commercial nothing list. Assume agreement car itself number already rich.
Box still understand college citizen area parent. You piece anyone economy.",8:56:35,DD
RHOS43398039713911,GB61LNNL27019625918822,8/4/2019,14825.05,100001,N,Credited,EDGE,POS,Cr,13:46:37,16:51:06,12/12/2020,43697953,1765.27,1,All end off machine person. Run light yourself stop chance with. Manage nothing also effort local. Professional back behind fill item tell green.,14:50:47,NEFT
RHOS43398039713911,GB61LNNL27019625918822,8/4/2019,13059.78,100001,Y,Utilities,OPERA,PC,Dr,17:21:41,21:20:59,12/12/2020,85276956,1765.27,3,"Stop hair while most upon. Pattern marriage argue else.
Blue open choose fight purpose partner tax. Past letter student task.",18:21:32,RTGS
RHOS43398039713911,GB61LNNL27019625918822,8/4/2019,12134.29,100001,Y,Transportation,SAFARI,POS,Dr,9:14:06,12:15:24,12/20/2020,69319662,925.49,1,"Need itself read every box media wind. Majority paper tonight degree him. Clearly far realize you hundred election.
Station who night main.
Ask we picture among machine either experience.",10:37:38,NEFT
RHOS43398039713911,GB61LNNL27019625918822,8/4/2019,13059.78,100001,N,Credited,MI,POS,Cr,14:41:43,18:26:18,12/20/2020,67831166,925.49,4,Mind through region expect although return white none. Plan piece wish everything bar detail. Community pass test son difficult move friend. Feel agency focus fish set.,16:09:48,UPI
RHOS43398039713911,GB61LNNL27019625918822,8/4/2019,12134.29,100001,Y,Rent,OPERA,PC,Dr,22:46:11,24:24:46,12/20/2020,36274550,925.49,2,Green administration performance society say investment. From test street win man gas.,23:29:14,IMPS
RHOS43398039713911,GB61LNNL27019625918822,8/4/2019,13939.28,100001,N,Credited,IE,MOBILE,Cr,5:21:59,8:24:19,1/5/2021,76427923,1804.99,5,"Whole finish environmental method though us. Born name late. Financial floor red want.
Professor art arm early our. Glass structure his look have. Dream test care process let computer.",6:21:03,CARDS
RHOS43398039713911,GB61LNNL27019625918822,8/4/2019,12134.29,100001,Y,Medicals,EDGE,MOBILE,Dr,15:35:34,17:44:36,1/5/2021,46337481,1804.99,7,"Mr goal education large develop. Field until stuff great hot stage. We expert push away. Three window together painting none.
Skill decade news fund how student. Religious course option.",16:23:16,DD
RHOS43398039713911,GB61LNNL27019625918822,8/4/2019,13939.28,100001,N,Credited,EDGE,POS,Cr,19:25:29,22:40:56,1/5/2021,45437373,1804.99,5,Policy will as management mission face professional night. Hotel short moment rather wear admit human lot. Others itself vote result grow catch.,20:20:10,CARDS
RHOS43398039713911,GB61LNNL27019625918822,8/4/2019,14763.45,100001,N,Credited,IE,PC,Cr,4:48:54,7:40:49,1/8/2021,68564872,824.17,4,"Certainly population who piece serious type audience son.
Pretty successful play about strong race pattern eight. Actually test station growth security tough.",6:26:30,UPI
RHOS43398039713911,GB61LNNL27019625918822,8/4/2019,15587.62,100001,N,Credited,MI,PC,Cr,7:55:16,9:12:30,1/8/2021,42179627,824.17,2,"Game behavior get none control lose. Share material analysis country win participant. Could quite kitchen president bit for.
Subject throughout Mr analysis animal various.",8:45:18,IMPS
RHOS43398039713911,GB61LNNL27019625918822,8/4/2019,16411.79,100001,N,Credited,CHROME,PC,Cr,14:16:50,17:25:36,1/8/2021,98233236,824.17,7,Movie own stand hair. Its team huge throw represent how behind. Model who speech protect pretty order young his.,15:45:29,DD
RHOS43398039713911,GB61LNNL27019625918822,8/4/2019,17235.96,100001,N,Credited,FF,PC,Cr,17:53:14,21:08:44,1/8/2021,40780238,824.17,5,"Begin rather agreement fill main among miss.
Sure size current white cut. Hotel form increase today stay. Rule point nor believe bank record.",19:41:35,CARDS
RHOS43398039713911,GB61LNNL27019625918822,8/4/2019,18060.13,100001,N,Credited,FF,MOBILE,Cr,21:10:39,24:09:50,1/8/2021,86232340,824.17,5,"Tonight data technology score without yard. Than crime shoulder leader.
Us give explain teacher. Fine game start western society here.",22:25:39,CARDS
RHOS43398039713911,GB61LNNL27019625918822,8/4/2019,19050.71,100001,N,Credited,CHROME,PC,Cr,8:21:11,16:05:49,1/15/2021,54117693,990.58,4,Military explain rather traditional military. Together drive statement at describe.,13:12:55,UPI
RHOS43398039713911,GB61LNNL27019625918822,8/4/2019,19420.77,100001,N,Credited,FF,PC,Cr,13:45:16,20:00:34,1/28/2021,14673597,370.06,3,Operation policy book central job. Attorney least action sea follow.,18:19:19,RTGS
RHOS43398039713911,GB61LNNL27019625918822,8/4/2019,20395.57,100001,N,Credited,SAFARI,MOBILE,Cr,7:59:58,10:02:02,1/30/2021,56711318,974.8,7,"Arm job specific break speak follow important. Thus family than say. Modern security adult eye.
Concern process structure.",8:48:19,DD
RHOS43398039713911,GB61LNNL27019625918822,8/4/2019,19420.77,100001,Y,Personal Care,EDGE,POS,Dr,10:52:30,13:38:59,1/30/2021,59342335,974.8,2,Cultural social from set film this. Middle significant person teacher change. Third worry among dinner who ago space.,11:40:59,IMPS
RHOS43398039713911,GB61LNNL27019625918822,8/4/2019,18445.97,100001,Y,Entertainment,OPERA,MOBILE,Dr,17:55:26,21:05:14,1/30/2021,61032378,974.8,1,Reason somebody feel computer leg. Building move less series foot. Treat ready bit citizen hotel cell create.,19:05:49,NEFT
RHOS43398039713911,GB61LNNL27019625918822,8/4/2019,17471.17,100001,Y,Personal Care,CHROME,POS,Dr,17:27:00,20:36:34,1/30/2021,93535229,974.8,5,Store school career should pick model. Direction prepare common student method various kitchen. Pm four record condition none gas.,19:40:52,CARDS
RHOS43398039713911,GB61LNNL27019625918822,8/4/2019,19235.23,100001,N,Credited,CHROME,POS,Cr,5:06:20,7:00:27,2/9/2021,10065174,1764.06,7,"Often according recognize church can.
Hospital environmental interest investment. Think include particularly smile worry painting.",6:34:55,DD
RHOS43398039713911,GB61LNNL27019625918822,8/4/2019,20999.29,100001,N,Credited,OPERA,POS,Cr,9:48:22,11:47:42,2/9/2021,12691456,1764.06,2,"Wide thus travel father image. Trip white opportunity particularly look.
About range a girl seven best. Nice so beautiful more everybody record scientist. Nothing administration necessary whose.",10:26:48,IMPS
RHOS43398039713911,GB61LNNL27019625918822,8/4/2019,19235.23,100001,Y,Utilities,SAFARI,PC,Dr,12:42:04,14:41:52,2/9/2021,63521573,1764.06,5,"Chair before form debate follow person couple. Plant may wife economy always. Republican talk large miss husband newspaper.
Both beyond shake participant. Grow drive family north manager nice.",14:06:31,CARDS
RHOS43398039713911,GB61LNNL27019625918822,8/4/2019,17471.17,100001,Y,Medicals,SAFARI,MOBILE,Dr,16:53:03,19:13:19,2/9/2021,88211350,1764.06,6,Letter recent still chance thus player. Audience economy move along campaign alone add. Color suggest build story.,17:48:55,CHEQUE
RHOS43398039713911,GB61LNNL27019625918822,8/4/2019,15707.11,100001,Y,Utilities,OPERA,MOBILE,Dr,22:37:21,24:57:08,2/9/2021,86165761,1764.06,5,"For difficult light again. As four test notice young operation.
Hair authority responsibility degree. Indeed country sport boy general support alone. Candidate ground watch race well third worker.",23:07:28,CARDS
RHOS43398039713911,GB61LNNL27019625918822,8/4/2019,14291.27,100001,Y,Medicals,SAFARI,POS,Dr,12:32:31,18:07:20,2/10/2021,62643245,1415.84,5,"Want eight southern everyone hotel notice medical. Result that today around.
Suffer degree north. They every indeed lead.",15:36:55,CARDS
RHOS43398039713911,GB61LNNL27019625918822,8/4/2019,15174.23,100001,N,Credited,MI,MOBILE,Cr,5:32:43,9:57:56,2/19/2021,15310057,882.96,6,"Professor at write wrong lead assume goal. South figure bring long. Any us low author arm.
Year number building finish while. It theory my election no.",8:33:03,CHEQUE
RHOS43398039713911,GB61LNNL27019625918822,8/4/2019,16057.19,100001,N,Credited,CHROME,POS,Cr,15:16:34,20:26:06,2/19/2021,39420022,882.96,1,Through score business ability. Describe economy model. Either join administration item recognize number. Yes town without live person a.,19:10:42,NEFT
RHOS43398039713911,GB61LNNL27019625918822,8/4/2019,16619.23,100001,N,Credited,FF,PC,Cr,7:34:31,10:46:16,2/24/2021,44536381,562.04,5,"Upon run machine even whatever candidate huge. Exactly seat less make buy. Defense instead popular near.
Change toward research heavy. Quality five work mind sit against.",9:44:28,CARDS
RHOS43398039713911,GB61LNNL27019625918822,8/4/2019,16057.19,100001,Y,Dining,OPERA,PC,Dr,11:29:43,13:21:35,2/24/2021,45701566,562.04,1,"Fly bring organization his concern per. Ball budget bar contain day mean describe.
Home close grow indicate past whatever treatment. Entire wish hold friend those road.",12:12:02,NEFT
RHOS43398039713911,GB61LNNL27019625918822,8/4/2019,15495.15,100001,Y,Personal Care,IE,MOBILE,Dr,16:41:22,20:38:11,2/24/2021,58199534,562.04,4,Throw newspaper city cell. These like music inside population. Option especially professor her so former fill.,18:28:15,UPI
RHOS43398039713911,GB61LNNL27019625918822,8/4/2019,17221.22,100001,N,Credited,SAFARI,PC,Cr,14:15:28,20:04:08,2/27/2021,20427542,1726.07,1,"Drug almost simply measure some loss board director.
Have ever action list indeed six alone. Still hit dark let. Lose plan her ask truth off.",18:21:49,NEFT
RHOS43398039713911,GB61LNNL27019625918822,8/4/2019,18069.07,100001,N,Credited,IE,MOBILE,Cr,4:30:02,6:50:32,3/1/2021,10958704,847.85,2,Bed arrive toward turn fact. Sense middle miss third treatment. Care participant little discuss whom cup.,5:41:45,IMPS
RHOS43398039713911,GB61LNNL27019625918822,8/4/2019,17221.22,100001,Y,Medicals,SAFARI,POS,Dr,8:22:23,11:17:59,3/1/2021,15166920,847.85,7,"Strong wind just society. Development surface base such rather gas beyond. Finally site smile glass take record.
Able surface church role onto.",9:39:07,DD
RHOS43398039713911,GB61LNNL27019625918822,8/4/2019,18069.07,100001,N,Credited,IE,MOBILE,Cr,14:12:25,17:04:33,3/1/2021,90845994,847.85,3,"Could study certainly thing. Clear civil play form.
Air employee four society national. Keep support room wall play teach. Off surface theory specific his.",15:05:46,RTGS
RHOS43398039713911,GB61LNNL27019625918822,8/4/2019,18916.92,100001,N,Credited,FF,POS,Cr,14:43:45,18:01:34,3/1/2021,25831245,847.85,3,"Bring home read wall question list. Skill quickly work dark window film surface. Student modern despite movement stock PM.
Attention keep ask party. Cup represent number carry southern different.",16:38:39,RTGS
RHOS43398039713911,GB61LNNL27019625918822,8/4/2019,18069.07,100001,Y,Transportation,FF,MOBILE,Dr,20:34:04,23:32:11,3/1/2021,62851268,847.85,5,"Concern lot boy land business while know.
Recently claim pretty woman. Police his yeah network. Help popular something figure.
Improve vote possible manage. Mrs idea hit.",22:04:22,CARDS
RHOS43398039713911,GB61LNNL27019625918822,8/4/2019,16590.33,100001,Y,Online Shopping,FF,PC,Dr,13:10:12,15:10:24,3/22/2021,96973325,1478.74,6,"Store lawyer security common. Friend six even month company beyond.
Especially day term hope apply year. Likely step smile if. Three top age remain.",14:14:29,CHEQUE
RHOS43398039713911,GB61LNNL27019625918822,8/4/2019,18069.07,100001,N,Credited,CHROME,PC,Cr,21:15:04,23:50:24,3/22/2021,46142788,1478.74,5,"Sit long every home long hotel create way. Approach many six power would.
Up increase real score professional lot sometimes. Bit however cultural. Beyond affect determine exist condition must.",22:52:49,CARDS
RHOS43398039713911,GB61LNNL27019625918822,8/4/2019,19948.33,100001,N,Credited,EDGE,PC,Cr,4:01:18,7:21:10,3/24/2021,14536304,1879.26,7,"Most listen chair key win both story. Forget court attention debate most believe discover.
Standard least meeting its pay. Service four across produce card. Mother or reduce either view.",6:19:30,DD
RHOS43398039713911,GB61LNNL27019625918822,8/4/2019,21827.59,100001,N,Credited,MI,MOBILE,Cr,12:54:32,16:18:28,3/24/2021,88840512,1879.26,3,"Give talk attention green. Child whatever every walk. Box three such save partner card though.
Girl successful nor budget case sell sea. Defense especially animal story public wind form.",13:58:51,RTGS
RHOS43398039713911,GB61LNNL27019625918822,8/4/2019,19948.33,100001,Y,Transportation,MI,PC,Dr,16:48:34,20:45:00,3/24/2021,73119012,1879.26,4,"Rule during offer especially. Its continue become kid box similar work family.
Green account everything cover science wall plan toward. Line garden true spend.",18:49:03,UPI
RHOS43398039713911,GB61LNNL27019625918822,8/4/2019,21827.59,100001,N,Credited,CHROME,MOBILE,Cr,22:40:54,25:48:17,3/24/2021,51507206,1879.26,6,"Us medical particular card serious. Majority light gun speech present.
Including he throw station country. Account plan bar term toward soldier know.",23:25:28,CHEQUE
RHOS43398039713911,GB61LNNL27019625918822,8/4/2019,22881.34,100001,N,Credited,EDGE,PC,Cr,2:50:27,6:27:43,3/26/2021,75451752,1053.75,3,Experience box student blood institution allow hear. Consider appear build case clearly develop per.,5:04:50,RTGS
RHOS43398039713911,GB61LNNL27019625918822,8/4/2019,21827.59,100001,Y,Groceries,CHROME,PC,Dr,9:08:14,11:59:40,3/26/2021,26896984,1053.75,4,"Give for model ahead information indicate. Full factor alone care out idea speak.
Year beyond husband vote. Community establish hit. Phone eye Mr son speak analysis.",11:02:04,UPI
RHOS43398039713911,GB61LNNL27019625918822,8/4/2019,22881.34,100001,N,Credited,FF,POS,Cr,14:07:15,16:41:38,3/26/2021,57904726,1053.75,3,Civil happy fire. Writer yes value control region. Remember fire account keep seven window.,14:47:31,RTGS
RHOS43398039713911,GB61LNNL27019625918822,8/4/2019,21827.59,100001,Y,Medicals,MI,POS,Dr,22:27:31,24:50:58,3/26/2021,99245702,1053.75,1,Every about up military next commercial. Worry what yet might news station other. Meet late trip.,23:28:10,NEFT
RHOS43398039713911,GB61LNNL27019625918822,8/4/2019,20801.59,100001,Y,Household Consumables,EDGE,POS,Dr,3:49:19,7:14:25,3/29/2021,44351151,1026,2,"Site maintain well something production national. Because state growth. Little play rise often.
Talk million car visit hear. Per enter policy street green class.
Street hour particularly find job.",5:54:40,IMPS
RHOS43398039713911,GB61LNNL27019625918822,8/4/2019,19775.59,100001,Y,Online Shopping,OPERA,MOBILE,Dr,10:01:51,12:10:13,3/29/2021,93552073,1026,4,Discover reduce game turn. Executive simple exist society usually last. Piece race world close. Rule far figure grow month firm.,10:54:20,UPI
RHOS43398039713911,GB61LNNL27019625918822,8/4/2019,20801.59,100001,N,Credited,CHROME,POS,Cr,17:52:30,20:36:09,3/29/2021,8166999,1026,5,Perhaps herself enough seat personal card their affect. Name look dinner store here involve despite year.,19:09:47,CARDS
RHOS43398039713911,GB61LNNL27019625918822,8/4/2019,21827.59,100001,N,Credited,EDGE,MOBILE,Cr,22:06:32,24:41:29,3/29/2021,26708829,1026,5,"Because theory party go cut cultural stock. Data happy pretty me strategy security class. Skin break everyone huge west parent painting.
Drive despite wear change.",22:35:42,CARDS
RHOS43398039713911,GB61LNNL27019625918822,8/4/2019,20891.87,100001,Y,Entertainment,IE,PC,Dr,6:42:35,8:00:18,4/9/2021,12640539,935.72,3,"Apply television bring national contain ground.
Authority actually man raise kid.
Rock carry direction.",7:35:12,RTGS
RHOS43398039713911,GB61LNNL27019625918822,8/4/2019,19956.15,100001,Y,Transportation,OPERA,POS,Dr,9:05:40,12:13:33,4/9/2021,28399582,935.72,5,"Down instead now own rate occur born. Collection little start hold official. Institution find third sort understand conference.
Draw show nearly trouble officer heart. Without east east blue.",10:47:36,CARDS
RHOS43398039713911,GB61LNNL27019625918822,8/4/2019,20891.87,100001,N,Credited,OPERA,MOBILE,Cr,12:48:44,15:16:44,4/9/2021,88968742,935.72,3,Heart animal he anything though plan back. Owner defense issue include town. Four sea dream example every moment expert.,14:04:15,RTGS
RHOS43398039713911,GB61LNNL27019625918822,8/4/2019,21827.59,100001,N,Credited,MI,POS,Cr,17:12:01,20:17:19,4/9/2021,87413809,935.72,2,Discuss laugh address cold second view. Me effect drop senior. Option power who wait ten space. Religious capital director structure.,19:01:02,IMPS
RHOS43398039713911,GB61LNNL27019625918822,8/4/2019,20891.87,100001,Y,Groceries,SAFARI,MOBILE,Dr,19:34:37,22:01:23,4/9/2021,59233831,935.72,2,Own never add issue stay collection. Year right talk key may process always form.,20:24:20,IMPS
RHOS43398039713911,GB61LNNL27019625918822,8/4/2019,22512.22,100001,N,Credited,IE,POS,Cr,3:10:17,5:42:08,4/22/2021,90912658,1620.35,2,Answer your responsibility customer stage owner. Save series hundred how free method. Sit popular drive need.,4:58:11,IMPS
RHOS43398039713911,GB61LNNL27019625918822,8/4/2019,20891.87,100001,Y,Online Shopping,CHROME,MOBILE,Dr,8:35:55,11:18:09,4/22/2021,73579571,1620.35,4,Positive live happen future me growth which. Her town item positive dream.,10:14:25,UPI
RHOS43398039713911,GB61LNNL27019625918822,8/4/2019,19271.52,100001,Y,Household Consumables,EDGE,MOBILE,Dr,16:23:43,17:45:05,4/22/2021,93720939,1620.35,3,Fight American sometimes yourself think quite age. Case without need story. Term less Mrs listen two college.,16:55:50,RTGS
RHOS43398039713911,GB61LNNL27019625918822,8/4/2019,20891.87,100001,N,Credited,SAFARI,POS,Cr,22:18:52,25:38:08,4/22/2021,70650280,1620.35,7,"Base appear process per speech bank stage.
Far daughter report author kitchen suggest. Believe have enjoy right day.
Dog but care human nice cell professional. Run service power moment safe never.",23:27:43,DD
RHOS43398039713911,GB61LNNL27019625918822,8/4/2019,21430.4,100001,N,Credited,MI,PC,Cr,6:42:53,9:04:34,4/23/2021,8798534,538.53,5,"Sense big far ask. Allow admit family total check else head able.
Response never safe section edge campaign. Everything risk build nor. Dark against international window main involve sign.",7:47:30,CARDS
RHOS43398039713911,GB61LNNL27019625918822,8/4/2019,21968.93,100001,N,Credited,EDGE,MOBILE,Cr,16:45:01,19:46:01,4/23/2021,18080933,538.53,4,"Minute cell common collection would. Federal response wonder whose ready story benefit.
Act each explain behind information quite maybe. Piece these natural even fund.",17:44:54,UPI
RHOS43398039713911,GB61LNNL27019625918822,8/4/2019,22507.46,100001,N,Credited,FF,PC,Cr,17:45:10,23:17:29,4/23/2021,60406187,538.53,5,"Sure would any hit television single. Discuss tend practice hand situation century.
Economic nor edge artist capital. Reflect care whether they represent.",20:43:58,CARDS
RHOS43398039713911,GB61LNNL27019625918822,8/4/2019,23170.74,100001,N,Credited,EDGE,POS,Cr,14:40:11,17:40:58,4/24/2021,61132481,663.28,6,"Beat tell around high available attack bed career. Help also reach eat. Drug low most draw fish manage low her.
Week especially finally visit in safe. Husband according upon win.",15:29:29,CHEQUE
RHOS43398039713911,GB61LNNL27019625918822,8/4/2019,22507.46,100001,Y,Dining,OPERA,MOBILE,Dr,13:45:52,19:58:31,4/24/2021,26527567,663.28,7,Financial official while son action could. Consider either positive result who rise likely claim.,17:44:59,DD
RHOS43398039713911,GB61LNNL27019625918822,8/4/2019,21897.94,100001,Y,Rent,SAFARI,POS,Dr,8:33:43,12:58:39,4/27/2021,12541690,609.52,7,Including station far medical little. Source radio statement sing design attention. Few enter win industry election car.,11:16:35,DD
RHOS43398039713911,GB61LNNL27019625918822,8/4/2019,22507.46,100001,N,Credited,IE,MOBILE,Cr,14:08:07,18:16:32,4/27/2021,62545501,609.52,5,"Of audience movement analysis green enter nature. Whom term point.
Walk page improve whole kind writer anyone. System information contain western. Too he TV wall agreement himself along yard.",16:39:36,CARDS
RHOS43398039713911,GB61LNNL27019625918822,8/4/2019,22629.78,100001,N,Credited,FF,POS,Cr,3:21:58,8:31:01,4/28/2021,1274967,122.32,5,Clearly season large dog full determine hour. Property class different. Lead whatever truth situation response reach. Upon pick language method imagine threat.,6:08:03,CARDS
RHOS43398039713911,GB61LNNL27019625918822,8/4/2019,22752.1,100001,N,Credited,CHROME,PC,Cr,15:44:13,19:20:53,4/28/2021,8302397,122.32,1,"Require sure quite. Just by political stock yeah. Partner majority no stop instead exist.
Among hair source two create natural majority. Decide use tell character.",17:37:43,NEFT
RHOS43398039713911,GB61LNNL27019625918822,8/4/2019,22629.78,100001,Y,Household Consumables,IE,POS,Dr,20:59:06,23:54:49,4/28/2021,2683034,122.32,5,"Bill growth level us. Maybe total which well not.
Wear sure anyone during leave act. Difference growth she each decade item. Miss suffer rule.",22:18:15,CARDS
RHOS43398039713911,GB61LNNL27019625918822,8/4/2019,22184.89,100001,Y,Transportation,MI,PC,Dr,5:01:15,8:04:20,4/30/2021,66101604,444.89,6,Forward recognize board level view cultural financial. Finally others truth music international suddenly agent. Interesting message wall child.,6:31:24,CHEQUE
RHOS43398039713911,GB61LNNL27019625918822,8/4/2019,22629.78,100001,N,Credited,EDGE,MOBILE,Cr,9:51:45,12:31:19,4/30/2021,68244835,444.89,6,Series because program interest want we significant. Bad deep thus security indicate something.,10:56:13,CHEQUE
RHOS43398039713911,GB61LNNL27019625918822,8/4/2019,22184.89,100001,Y,Household Consumables,MI,MOBILE,Dr,14:25:23,16:40:51,4/30/2021,24646543,444.89,7,Collection state agent minute. Old produce past among. Section issue these society benefit hair.,15:17:26,DD
RHOS43398039713911,GB61LNNL27019625918822,8/4/2019,22629.78,100001,N,Credited,EDGE,MOBILE,Cr,14:34:20,18:08:29,4/30/2021,29731329,444.89,6,"Consider common water over mother life. Parent southern difficult draw next week with.
Event price than. Huge course hear note always.",16:19:58,CHEQUE
RHOS43398039713911,GB61LNNL27019625918822,8/4/2019,23074.67,100001,N,Credited,EDGE,POS,Cr,19:33:03,21:28:31,4/30/2021,89173008,444.89,6,Nor test experience official include charge will. Tend call describe. Television wide thank difference step debate.,20:59:33,CHEQUE
RHOS43398039713911,GB61LNNL27019625918822,8/4/2019,22473.91,100001,Y,Entertainment,FF,PC,Dr,13:26:43,17:02:53,5/2/2021,36230099,600.76,2,"Shake story room role. Carry investment check want type spend.
Building health view chance. Particularly build third. New east professor.",15:19:14,IMPS
RHOS43398039713911,GB61LNNL27019625918822,8/4/2019,21393.02,100001,Y,Medicals,SAFARI,POS,Dr,7:41:20,13:07:39,5/7/2021,87151169,1080.89,4,"Return full site quite little up draw. Leave final address represent without set law. Any media country Democrat.
Dog behind glass region. Finally for should nearly.",10:16:54,UPI
RHOS43398039713911,GB61LNNL27019625918822,8/4/2019,20312.13,100001,Y,Dining,OPERA,MOBILE,Dr,16:07:42,19:37:37,5/7/2021,11069331,1080.89,1,Them avoid sea human party memory information foreign. Baby himself expert second parent. Well common floor government data.,17:36:18,NEFT
RHOS43398039713911,GB61LNNL27019625918822,8/4/2019,21393.02,100001,N,Credited,MI,PC,Cr,20:06:57,24:25:07,5/7/2021,72513682,1080.89,6,"This enjoy she action. Tell single skin add.
Employee large within seat. Upon billion else trouble.
Total about court another. Provide assume me thing recognize.",23:05:18,CHEQUE
RHOS43398039713911,GB61LNNL27019625918822,8/4/2019,23333.47,100001,N,Credited,OPERA,MOBILE,Cr,6:44:21,9:04:55,5/11/2021,6971502,1940.45,3,"But town lawyer white number play wonder.
System pay financial position little movement rather. Beautiful ahead mean campaign reveal political. Fight require door both guy involve husband I.",7:55:20,RTGS
RHOS43398039713911,GB61LNNL27019625918822,8/4/2019,21393.02,100001,Y,Online Shopping,FF,PC,Dr,8:54:49,11:52:03,5/11/2021,6011727,1940.45,5,Market water minute radio alone by citizen include. Raise north issue represent. Tree same magazine natural model or offer require.,10:31:30,CARDS
RHOS43398039713911,GB61LNNL27019625918822,8/4/2019,19452.57,100001,Y,Household Consumables,CHROME,POS,Dr,14:09:17,17:16:44,5/11/2021,92218192,1940.45,1,"Lead structure drop color agree. Age unit science detail now do alone. Community much room huge system between serious cause.
Leave and every character effort. Painting word green door.",15:58:04,NEFT
RHOS43398039713911,GB61LNNL27019625918822,8/4/2019,17512.12,100001,Y,Entertainment,CHROME,PC,Dr,15:34:18,17:07:57,5/11/2021,69002274,1940.45,4,"Yeah treat under near just along. Finally among quite couple she bed though.
Treatment open suffer others mean not. Exist account section ever significant inside.",16:22:40,UPI
RHOS43398039713911,GB61LNNL27019625918822,8/4/2019,19452.57,100001,N,Credited,EDGE,PC,Cr,22:15:49,23:53:03,5/11/2021,52112645,1940.45,6,"Relationship adult few stand table teacher PM. Poor return about benefit health possible write evidence. Value choose another possible.
War question travel including off. Assume economy way out.",23:13:41,CHEQUE
RHOS43398039713911,GB61LNNL27019625918822,8/4/2019,17478.32,100001,Y,Entertainment,MI,PC,Dr,8:47:31,18:12:16,5/25/2021,42488934,1974.25,3,Well to first bed first better wear speech. Pay also must boy care should lead. Friend why suddenly after rule hope claim professor.,13:20:14,RTGS
RHOS43398039713911,GB61LNNL27019625918822,8/4/2019,16590.59,100001,Y,Personal Care,FF,PC,Dr,7:51:30,18:28:07,6/8/2021,57566061,887.73,5,Area hotel coach husband music cultural size. Change security individual foreign throw. Speak letter room know. Head because drop mother.,12:28:27,CARDS
RHOS43398039713911,GB61LNNL27019625918822,8/4/2019,15720.95,100001,Y,Dining,SAFARI,MOBILE,Dr,5:43:47,7:35:38,6/21/2021,53974693,869.64,6,"Establish how fight set. Individual try usually performance us because.
Card thousand nation only defense training. Policy seek line people either according. So method identify.",6:29:17,CHEQUE
RHOS43398039713911,GB61LNNL27019625918822,8/4/2019,16590.59,100001,N,Credited,MI,POS,Cr,13:33:55,16:04:30,6/21/2021,39973849,869.64,7,Cell back none develop everything. Ahead everything beat military remember although within.,14:22:17,DD
RHOS43398039713911,GB61LNNL27019625918822,8/4/2019,17460.23,100001,N,Credited,IE,MOBILE,Cr,17:37:08,21:09:21,6/21/2021,66826330,869.64,4,"Eat include month lose whole. Born thing start.
In contain drug. Decision dark which professor answer although its. Often which yard across.",18:46:30,UPI
RHOS43398039713911,GB61LNNL27019625918822,8/4/2019,18329.87,100001,N,Credited,EDGE,PC,Cr,18:41:07,21:10:29,6/21/2021,3758618,869.64,1,Likely name success order. Car society gun according produce piece later. Third indicate conference understand group ability.,19:25:09,NEFT
RHOS43398039713911,GB61LNNL27019625918822,8/4/2019,17998.71,100001,Y,Dining,MI,POS,Dr,3:33:58,6:29:27,6/24/2021,49033595,331.16,4,"Yet car business. Decision able very use measure management.
Final issue ability truth world step. Modern book realize attack. Build these score much later month hope campaign.",4:44:01,UPI
RHOS43398039713911,GB61LNNL27019625918822,8/4/2019,17667.55,100001,Y,Entertainment,MI,PC,Dr,9:58:14,12:52:27,6/24/2021,74093816,331.16,7,"Class cover contain him with nature fear. Spend lose shake. Chance return trade huge set young lawyer.
Sea try ability pattern answer weight per.",11:57:09,DD
RHOS43398039713911,GB61LNNL27019625918822,8/4/2019,17336.39,100001,Y,Dining,SAFARI,MOBILE,Dr,12:54:43,14:50:22,6/24/2021,84620354,331.16,4,"Address thought can threat however whose enter. Eye security worker end.
Democratic husband conference pull respond billion.",13:24:59,UPI
RHOS43398039713911,GB61LNNL27019625918822,8/4/2019,17005.23,100001,Y,Online Shopping,IE,POS,Dr,17:54:51,20:28:21,6/24/2021,22708328,331.16,7,"Drop collection campaign town.
Order east everything appear other bit. Hotel listen quality great.
However player west court. Happy fall body already today include game.",18:38:15,DD
RHOS43398039713911,GB61LNNL27019625918822,8/4/2019,16674.07,100001,Y,Insurance,OPERA,POS,Dr,19:51:24,22:04:16,6/24/2021,70554847,331.16,1,"On cup young laugh. Care case gun a subject.
Development hope easy administration. Agent growth apply arrive current wait region.",21:33:46,NEFT
RHOS43398039713911,GB61LNNL27019625918822,8/4/2019,15655.6,100001,Y,Transportation,FF,PC,Dr,6:07:05,9:17:48,7/15/2021,7419270,1018.47,7,"Future knowledge floor protect any before yes. Big none fly administration region human.
Study successful sit. Back month history of for lead network. Plan somebody course respond.",8:02:19,DD
RHOS43398039713911,GB61LNNL27019625918822,8/4/2019,16674.07,100001,N,Credited,SAFARI,PC,Cr,8:38:09,11:05:03,7/15/2021,16326002,1018.47,7,"Interest realize run floor this where. Other support prepare beat activity.
Environment they in think show left audience. Politics general matter. Win total film fish.",10:32:22,DD
RHOS43398039713911,GB61LNNL27019625918822,8/4/2019,17692.54,100001,N,Credited,SAFARI,MOBILE,Cr,17:29:56,20:48:53,7/15/2021,85056336,1018.47,1,"Find plant couple organization language happen. Them energy enough simply sea happen. Economic friend effort.
Rich seem consider probably art job. Society should purpose economic concern hit should.",19:10:59,NEFT
RHOS43398039713911,GB61LNNL27019625918822,8/4/2019,18711.01,100001,N,Credited,OPERA,MOBILE,Cr,21:46:57,25:36:55,7/15/2021,55967600,1018.47,1,Not stuff money maintain development country stay until. Least human art position fine response crime. Color class positive particular agree.,23:16:35,NEFT
RHOS43398039713911,GB61LNNL27019625918822,8/4/2019,17456.77,100001,Y,Personal Care,IE,POS,Dr,14:43:58,21:14:37,7/16/2021,75339791,1254.24,5,"Until animal computer president likely. Eat understand you great reduce federal reason. Indeed prevent say without.
Child clear sea stage make key.",18:28:48,CARDS
RHOS43398039713911,GB61LNNL27019625918822,8/4/2019,16195.83,100001,Y,Insurance,IE,MOBILE,Dr,3:13:26,5:12:16,7/18/2021,18134810,1260.94,3,"Like adult grow sometimes. Mention quite career never. Charge month author PM.
While gas computer. Hard wide discuss yard. I director best why yourself concern.",4:03:56,RTGS
RHOS43398039713911,GB61LNNL27019625918822,8/4/2019,17456.77,100001,N,Credited,EDGE,MOBILE,Cr,6:45:48,9:17:19,7/18/2021,54745391,1260.94,7,Car at significant yeah future write. Yeah sometimes hard rich ago. Interesting away player decide building technology none.,8:45:03,DD
RHOS43398039713911,GB61LNNL27019625918822,8/4/2019,16195.83,100001,Y,Groceries,EDGE,PC,Dr,14:43:22,17:18:26,7/18/2021,16004634,1260.94,3,"Mr happy listen central carry task former.
Great great like significant best.
Able miss newspaper laugh fast during where debate. Have conference relationship each turn.",15:20:09,RTGS
RHOS43398039713911,GB61LNNL27019625918822,8/4/2019,14934.89,100001,Y,Online Shopping,OPERA,POS,Dr,15:57:04,19:22:59,7/18/2021,51592936,1260.94,4,Fear base throughout up stand. Half or character feel movie. Act chair cell.,17:48:10,UPI
RHOS43398039713911,GB61LNNL27019625918822,8/4/2019,13673.95,100001,Y,Transportation,CHROME,POS,Dr,23:06:19,24:49:30,7/18/2021,5321858,1260.94,1,"Specific military interview wide develop.
Speech concern pretty term. People stock world seven trip some. Treat everything rise.",23:36:13,NEFT
RHOS43398039713911,GB61LNNL27019625918822,8/4/2019,12560.42,100001,Y,Personal Care,MI,POS,Dr,4:07:03,6:40:12,7/23/2021,30620292,1113.53,3,List book rate difficult finish early. At usually again culture question young test attention. Whom just manage strategy protect produce item.,6:05:15,RTGS
RHOS43398039713911,GB61LNNL27019625918822,8/4/2019,13673.95,100001,N,Credited,EDGE,MOBILE,Cr,8:41:41,11:00:35,7/23/2021,83109447,1113.53,5,Understand a present such necessary business. Try yourself name. Environment least bill point same common number.,9:37:07,CARDS
RHOS43398039713911,GB61LNNL27019625918822,8/4/2019,12560.42,100001,Y,Dining,FF,PC,Dr,13:33:26,16:21:45,7/23/2021,51864828,1113.53,4,"System difference space moment. Challenge treatment beautiful part car take.
Street whole successful bar create training present. Improve late raise deep especially pattern bag age.",15:20:43,UPI
RHOS43398039713911,GB61LNNL27019625918822,8/4/2019,11446.89,100001,Y,Rent,FF,POS,Dr,16:33:04,18:50:26,7/23/2021,46325846,1113.53,3,"After when word apply. Tax they likely hour have chance such.
Make major friend father fish organization. Why employee point pass.
Station chair line to market page. Serious security far ago.",18:20:08,RTGS
RHOS43398039713911,GB61LNNL27019625918822,8/4/2019,10333.36,100001,Y,Insurance,FF,PC,Dr,19:22:37,21:20:47,7/23/2021,42405566,1113.53,2,City property film situation surface. Although sometimes former risk business direction sister. Task number reflect point operation early author.,20:05:03,IMPS
RHOS43398039713911,GB61LNNL27019625918822,8/4/2019,8377.94,100001,Y,Personal Care,SAFARI,POS,Dr,4:13:43,9:14:16,8/3/2021,64755250,1955.42,5,"Item former exist your. Seat guess act key.
Fear street spend voice affect development organization. Member build response happen. Skill reach worry space summer difference.",6:55:33,CARDS
RHOS43398039713911,GB61LNNL27019625918822,8/4/2019,10333.36,100001,N,Credited,FF,POS,Cr,11:06:08,16:17:55,8/3/2021,41838884,1955.42,2,"Campaign information way not young card walk. Between financial maintain provide identify.
Total push allow can clearly everybody. Congress true lot consider finish.",13:23:24,IMPS
RHOS43398039713911,GB61LNNL27019625918822,8/4/2019,8377.94,100001,Y,Groceries,CHROME,MOBILE,Dr,16:56:55,22:10:20,8/3/2021,17098519,1955.42,6,Hand operation grow sell. Public point public arm play assume. Pull offer machine listen ever just.,19:47:40,CHEQUE
RHOS43398039713911,GB61LNNL27019625918822,8/4/2019,6780.61,100001,Y,Online Shopping,EDGE,PC,Dr,2:20:53,4:48:26,8/9/2021,92810297,1597.33,2,"Whether pattern table fear job way. List spring task grow large west.
But whatever guess true understand former. Force smile grow prove coach maybe need.",4:05:08,IMPS
RHOS43398039713911,GB61LNNL27019625918822,8/4/2019,5183.28,100001,Y,Medicals,FF,POS,Dr,10:28:05,12:46:35,8/9/2021,98569595,1597.33,7,"Else lose in now. Campaign early that cost.
Short significant dream money ground. Call I especially yet laugh.
Improve us everything speak. Wind today yet than character any environment.",11:14:45,DD
RHOS43398039713911,GB61LNNL27019625918822,8/4/2019,6780.61,100001,N,Credited,CHROME,POS,Cr,13:29:48,16:03:35,8/9/2021,69435102,1597.33,2,"Follow summer civil magazine or hard future. Magazine key trial level stuff shoulder soldier.
Age your structure door agency wrong. Hair forward tend play bit.",15:22:35,IMPS
RHOS43398039713911,GB61LNNL27019625918822,8/4/2019,8377.94,100001,N,Credited,CHROME,PC,Cr,17:30:16,20:16:46,8/9/2021,64080512,1597.33,2,"Think strategy exactly bit interview. Before Republican cultural ten attack true rest.
Recently gas everything activity financial suffer. Oil I already write sometimes development benefit.",18:39:52,IMPS
RHOS43398039713911,GB61LNNL27019625918822,8/4/2019,6780.61,100001,Y,Rent,EDGE,POS,Dr,19:18:10,21:15:40,8/9/2021,65154731,1597.33,2,"Possible all free paper TV own arrive. The identify property north say during little father.
Nearly good foot management size. True hundred carry oil low morning visit. Article could couple card.",20:20:06,IMPS
RHOS43398039713911,GB61LNNL27019625918822,8/4/2019,5816.43,100001,Y,Transportation,MI,MOBILE,Dr,3:44:59,7:22:23,8/11/2021,68701666,964.18,6,"Our identify example near animal. Alone small government father. Boy store group dark science.
Continue kid consumer fill take. Dog source happen project them morning player. Type man determine risk.",5:35:21,CHEQUE
RHOS43398039713911,GB61LNNL27019625918822,8/4/2019,4852.25,100001,Y,Transportation,MI,PC,Dr,9:49:34,12:39:27,8/11/2021,53723116,964.18,4,Listen understand media human challenge remember. Everybody senior certain as set money. Could court couple floor operation.,10:40:41,UPI
RHOS43398039713911,GB61LNNL27019625918822,8/4/2019,5816.43,100001,N,Credited,OPERA,POS,Cr,11:00:23,13:31:38,8/11/2021,18053449,964.18,7,Series development speak majority. Yet collection give. Nothing professor save seek night prevent cover.,12:08:01,DD
RHOS43398039713911,GB61LNNL27019625918822,8/4/2019,6780.61,100001,N,Credited,OPERA,PC,Cr,16:11:17,18:47:29,8/11/2021,21024283,964.18,7,"Detail radio we our federal now prove. Describe care sea exist daughter speak morning.
Like alone happy. Good her thank new answer training. Leader executive far up its democratic to.",17:15:45,DD
RHOS43398039713911,GB61LNNL27019625918822,8/4/2019,7744.79,100001,N,Credited,IE,MOBILE,Cr,20:39:35,23:22:13,8/11/2021,92611542,964.18,3,"Guy stop analysis same. Especially there attention staff special. But future situation fund computer.
Impact yourself political local present everything color. Happy tonight but sea why.",22:05:23,RTGS
RHOS43398039713911,GB61LNNL27019625918822,8/4/2019,8669.52,100001,N,Credited,IE,PC,Cr,11:05:42,16:20:39,8/12/2021,15924810,924.73,4,"Well especially piece southern ready study. Company create vote information hour care hotel.
Support before its case body.",13:37:06,UPI
RHOS43398039713911,GB61LNNL27019625918822,8/4/2019,9594.25,100001,N,Credited,CHROME,PC,Cr,17:08:30,20:31:04,8/12/2021,23767140,924.73,4,Two soldier staff low. Ready ready author which property these election. Break tax must agreement value investment consumer.,19:14:23,UPI
RHOS43398039713911,GB61LNNL27019625918822,8/4/2019,9739.58,100001,N,Credited,OPERA,MOBILE,Cr,6:48:30,8:29:29,8/19/2021,52056369,145.33,4,Authority every important billion loss expect memory federal. Lose future guy mean financial weight. Land position admit law local law.,7:27:41,UPI
RHOS43398039713911,GB61LNNL27019625918822,8/4/2019,9884.91,100001,N,Credited,CHROME,MOBILE,Cr,11:07:18,13:34:30,8/19/2021,55683753,145.33,1,"Participant service hotel investment industry.
Everybody executive any least realize. Though single culture prepare follow represent local.",11:52:06,NEFT
RHOS43398039713911,GB61LNNL27019625918822,8/4/2019,9739.58,100001,Y,Utilities,CHROME,POS,Dr,14:33:09,16:21:20,8/19/2021,68873257,145.33,6,"Trouble subject economic color ago.
Walk power true trial. Real bag particular way program. Including respond loss you still vote.
Consumer base factor part. White point plant real top of.",15:35:01,CHEQUE
RHOS43398039713911,GB61LNNL27019625918822,8/4/2019,9884.91,100001,N,Credited,MI,PC,Cr,16:35:08,18:58:28,8/19/2021,4663072,145.33,5,"Character within admit until. Special result interest.
Serve cup view participant check standard brother. Study similar according full player produce.
Though easy rest. Require understand teach use.",17:32:54,CARDS
RHOS43398039713911,GB61LNNL27019625918822,8/4/2019,9739.58,100001,Y,Utilities,MI,PC,Dr,21:04:21,22:41:14,8/19/2021,15958921,145.33,1,"We pay want business decision. Million side data rock require hotel poor discover.
Same participant sound above above administration will.",22:03:05,NEFT
RHOS43398039713911,GB61LNNL27019625918822,8/4/2019,11512.29,100001,N,Credited,MI,POS,Cr,5:41:04,9:05:47,8/25/2021,5842001,1772.71,6,In collection expert perform. Painting determine another question across.,6:56:22,CHEQUE
RHOS43398039713911,GB61LNNL27019625918822,8/4/2019,9739.58,100001,Y,Insurance,SAFARI,PC,Dr,10:23:36,13:59:36,8/25/2021,24147767,1772.71,3,"Notice writer around station their foot. Crime child rock opportunity.
Happen behind board difference help fight sound likely. Available grow necessary nice director ground.",11:49:49,RTGS
RHOS43398039713911,GB61LNNL27019625918822,8/4/2019,7966.87,100001,Y,Household Consumables,OPERA,MOBILE,Dr,16:55:36,18:48:12,8/25/2021,83769894,1772.71,3,Heart choose serious arm else tell write. History table hospital particularly and strong notice.,18:02:21,RTGS
RHOS43398039713911,GB61LNNL27019625918822,8/4/2019,6194.16,100001,Y,Personal Care,SAFARI,MOBILE,Dr,19:50:51,24:00:01,8/25/2021,21743016,1772.71,4,"Show public go. Environment remain movie firm stock appear.
Hand other series check. Republican pressure why behavior.",22:10:14,UPI
RHOS43398039713911,GB61LNNL27019625918822,8/4/2019,6944.02,100001,N,Credited,SAFARI,POS,Cr,8:33:28,11:13:46,8/27/2021,80311973,749.86,5,"Structure with film game. North action model through kid real group.
Environmental woman education sign end. Seem half serious city. Born enjoy worker.",9:09:11,CARDS
RHOS43398039713911,GB61LNNL27019625918822,8/4/2019,7693.88,100001,N,Credited,EDGE,MOBILE,Cr,9:52:46,13:50:06,8/27/2021,59347392,749.86,4,"Vote risk window summer.
Dinner value perform live south could. Medical seat fast dog. Skill player house rock first off.",12:04:45,UPI
RHOS43398039713911,GB61LNNL27019625918822,8/4/2019,6944.02,100001,Y,Rent,OPERA,POS,Dr,15:47:55,16:51:17,8/27/2021,57648361,749.86,4,"Majority most not father management cultural cultural build. Create occur event.
My peace begin provide draw. My artist speak space.",16:17:37,UPI
RHOS43398039713911,GB61LNNL27019625918822,8/4/2019,6194.16,100001,Y,Entertainment,EDGE,MOBILE,Dr,19:36:12,22:49:34,8/27/2021,62418140,749.86,6,Mouth marriage civil act senior. Such unit according guy something certainly. Crime send window key lose five them individual.,21:59:05,CHEQUE
RHOS43398039713911,GB61LNNL27019625918822,8/4/2019,5521.59,100001,Y,Personal Care,IE,MOBILE,Dr,14:18:33,25:15:13,8/28/2021,24588027,672.57,3,"Perform card factor talk history. Myself stage loss high yes trouble.
Field assume hundred determine help number western six. Happy tree name where report popular outside.",19:24:56,RTGS
RHOS43398039713911,GB61LNNL27019625918822,8/4/2019,6892.61,100001,N,Credited,SAFARI,MOBILE,Cr,5:52:50,8:14:53,9/1/2021,5000852,1371.02,4,"Cost sea garden cause player major. Gas what management. Head maintain clearly different behavior.
Street great event onto child key. Shake especially since.",7:02:17,UPI
RHOS43398039713911,GB61LNNL27019625918822,8/4/2019,5521.59,100001,Y,Online Shopping,SAFARI,MOBILE,Dr,7:47:10,11:09:38,9/1/2021,83315749,1371.02,4,Head author personal record. Hundred budget in discuss. More suggest official respond shake trade describe although.,9:22:25,UPI
RHOS43398039713911,GB61LNNL27019625918822,8/4/2019,6892.61,100001,N,Credited,IE,MOBILE,Cr,13:42:20,15:48:45,9/1/2021,85092938,1371.02,1,"Issue month world soldier need year. Enter election manage TV painting. Test leg sound professor artist change.
Member boy perhaps partner drive huge training. Often performance among.",14:39:40,NEFT
RHOS43398039713911,GB61LNNL27019625918822,8/4/2019,5521.59,100001,Y,Insurance,OPERA,POS,Dr,17:28:03,18:52:34,9/1/2021,46674739,1371.02,3,"Figure seek although car particular. Clear land usually seven.
Feeling although commercial social take agent.",18:16:05,RTGS
RHOS43398039713911,GB61LNNL27019625918822,8/4/2019,4150.57,100001,Y,Household Consumables,MI,POS,Dr,21:59:37,24:25:56,9/1/2021,6435738,1371.02,1,Performance box institution in table decade. Hour world woman door avoid himself place. Third of big read these.,22:29:19,NEFT
RHOS43398039713911,GB61LNNL27019625918822,8/4/2019,4272,100001,N,Credited,IE,POS,Cr,16:51:17,21:44:16,9/8/2021,29405787,121.43,4,"Role still mouth agreement practice second. Get state fast hair.
Anything last month baby them strategy learn. Study garden attention politics environment. Television according defense hit year hear.",18:04:32,UPI
RHOS43398039713911,GB61LNNL27019625918822,8/4/2019,6215.38,100001,N,Credited,FF,PC,Cr,3:35:21,6:13:20,9/9/2021,4976523,1943.38,4,"Third information stay risk. My Congress improve fill heart thought. Role discuss show middle then old forget.
Education control police example.",5:37:46,UPI
RHOS43398039713911,GB61LNNL27019625918822,8/4/2019,4272,100001,Y,Insurance,CHROME,MOBILE,Dr,9:53:55,14:06:50,9/9/2021,24279222,1943.38,2,"Ask do usually group. It approach person something report thing yourself beat.
Theory feel start list herself factor expect. Our this here first wall.
Significant out risk.",11:58:37,IMPS
RHOS43398039713911,GB61LNNL27019625918822,8/4/2019,6215.38,100001,N,Credited,FF,MOBILE,Cr,12:40:00,15:58:34,9/9/2021,74547906,1943.38,2,"Debate possible describe marriage probably. That part meeting instead.
Interest word live amount set may.
Full grow local meeting some plant sense letter. Until just drive wife.",14:28:23,IMPS
RHOS43398039713911,GB61LNNL27019625918822,8/4/2019,4272,100001,Y,Entertainment,IE,MOBILE,Dr,19:16:38,23:23:59,9/9/2021,41888544,1943.38,1,"Guess through ready art. Hit rule machine too increase for. Join shoulder program team.
Reflect sport base cost sort course reach miss. Seek ever share investment social.",21:23:16,NEFT
RHOS43398039713911,GB61LNNL27019625918822,8/4/2019,4604.33,100001,N,Credited,MI,POS,Cr,3:38:27,6:08:38,9/13/2021,78825345,332.33,1,"Me cut third red. Drive set positive manage. Usually another blue situation.
Old six worker place vote evening ok.",5:34:16,NEFT
RHOS43398039713911,GB61LNNL27019625918822,8/4/2019,4936.66,100001,N,Credited,CHROME,PC,Cr,6:42:10,10:13:48,9/13/2021,78146815,332.33,3,Machine radio phone. Eight cut remain management buy. Attention Mrs who but produce. Guy board hit statement officer opportunity avoid challenge.,8:20:48,RTGS
RHOS43398039713911,GB61LNNL27019625918822,8/4/2019,4604.33,100001,Y,Rent,CHROME,PC,Dr,11:00:00,13:54:51,9/13/2021,7711626,332.33,2,Debate first seven offer run black bed. Save past trouble born almost democratic treatment realize.,12:57:21,IMPS
RHOS43398039713911,GB61LNNL27019625918822,8/4/2019,4272,100001,Y,Utilities,FF,POS,Dr,18:11:08,20:18:06,9/13/2021,82667771,332.33,1,President race management approach effect plan more road. Move as thus idea worker left.,19:34:32,NEFT
RHOS43398039713911,GB61LNNL27019625918822,8/4/2019,4604.33,100001,N,Credited,OPERA,PC,Cr,19:07:20,20:35:13,9/13/2021,40568591,332.33,1,"Care table audience machine. Visit voice whose source send. Drug however live direction here base. Less middle key nature first.
Leg someone information stuff late involve.",20:09:52,NEFT
RHOS43398039713911,GB61LNNL27019625918822,8/4/2019,2643.57,100001,Y,Dining,OPERA,POS,Dr,13:13:52,19:53:17,9/22/2021,53856357,1960.76,3,Control those large glass ten tree. Term majority education girl fill base your. Down model allow. You son against set.,18:34:38,RTGS
RHOS43398039713911,GB61LNNL27019625918822,8/4/2019,1552.11,100001,Y,Personal Care,EDGE,POS,Dr,5:07:49,8:00:39,10/2/2021,3844441,1091.46,7,"Have behind girl president spend. Area pressure market budget marriage expect rich.
Start government machine life area food late guy. Page talk land.",7:02:27,DD
RHOS43398039713911,GB61LNNL27019625918822,8/4/2019,2643.57,100001,N,Credited,SAFARI,PC,Cr,7:07:12,10:30:45,10/2/2021,44594978,1091.46,3,"Simple exactly hotel when. East agency account once culture forward believe none. Activity among everyone.
Money for partner attack. Third type class positive shake gas never. Child member Mr plant.",8:49:07,RTGS
RHOS43398039713911,GB61LNNL27019625918822,8/4/2019,3735.03,100001,N,Credited,SAFARI,MOBILE,Cr,14:29:15,15:40:19,10/2/2021,92642904,1091.46,7,Thousand cup hot mind for mouth relate. Control government program many. Evening newspaper understand family.,14:58:10,DD
RHOS43398039713911,GB61LNNL27019625918822,8/4/2019,4826.49,100001,N,Credited,MI,POS,Cr,17:08:14,18:53:33,10/2/2021,5964420,1091.46,2,"Upon much she hear hot serve. Picture medical protect fine hair final economy.
Last particularly pressure turn agency you institution. Find consider north rule herself expert probably strategy.",17:41:37,IMPS
RHOS43398039713911,GB61LNNL27019625918822,8/4/2019,3735.03,100001,Y,Dining,OPERA,PC,Dr,19:19:32,21:59:25,10/2/2021,33926582,1091.46,2,"Operation performance forget wrong development would anyone response. Suddenly often analysis garden should. Imagine oil purpose.
I provide magazine data cultural recent. Movement with statement we.",20:52:53,IMPS
RHOS43398039713911,GB61LNNL27019625918822,8/4/2019,3707.01,100001,Y,Online Shopping,FF,POS,Dr,7:16:20,10:25:25,10/3/2021,46968432,28.02,1,Lay every section certainly senior prove sometimes. Door subject recently if book so minute. Spring thought listen.,7:57:17,NEFT
RHOS43398039713911,GB61LNNL27019625918822,8/4/2019,3678.99,100001,Y,Household Consumables,MI,MOBILE,Dr,16:17:06,17:40:37,10/3/2021,85334946,28.02,5,Case tree center own account poor sometimes. Should around hotel team between. Book short none participant Republican by.,17:00:19,CARDS
RHOS43398039713911,GB61LNNL27019625918822,8/4/2019,3707.01,100001,N,Credited,OPERA,PC,Cr,20:10:27,24:43:03,10/3/2021,18482621,28.02,3,"His general get measure wonder pattern role. Across wide easy tax work defense never sea.
Million new any. Allow section degree why box different method.",23:09:28,RTGS
RHOS43398039713911,GB61LNNL27019625918822,8/4/2019,2415.66,100001,Y,Transportation,OPERA,POS,Dr,6:43:39,11:10:14,10/7/2021,76958724,1291.35,2,Top mother but can of option better. Land moment dream their Republican population couple him.,9:26:57,IMPS
RHOS43398039713911,GB61LNNL27019625918822,8/4/2019,3707.01,100001,N,Credited,EDGE,POS,Cr,14:33:22,18:10:26,10/7/2021,84212887,1291.35,4,"Like policy baby team. Majority choice within interview.
Body simple media add information yes face. Particular mean knowledge decade employee participant.",16:16:24,UPI
RHOS43398039713911,GB61LNNL27019625918822,8/4/2019,2415.66,100001,Y,Personal Care,CHROME,MOBILE,Dr,20:21:58,25:10:46,10/7/2021,54576858,1291.35,4,His determine itself ok dog different yourself. Everyone minute third. Break generation environmental smile conference newspaper five.,22:50:23,UPI
RHOS43398039713911,GB61LNNL27019625918822,8/4/2019,4346.45,100001,N,Credited,IE,PC,Cr,6:43:49,8:00:17,10/13/2021,44338183,1930.79,5,"Attorney himself young economy fine stage dream. Offer whom because only.
Able job gas home almost. Health audience order enter.",7:11:38,CARDS
RHOS43398039713911,GB61LNNL27019625918822,8/4/2019,6277.24,100001,N,Credited,SAFARI,MOBILE,Cr,9:09:10,11:58:36,10/13/2021,77352453,1930.79,2,"Not boy stop success especially floor. Not ability during manager. Box pattern before interest wind information among.
Computer walk movie. Billion eat bring hotel. Key fall her say.",10:11:28,IMPS
RHOS43398039713911,GB61LNNL27019625918822,8/4/2019,8208.03,100001,N,Credited,CHROME,POS,Cr,12:20:55,14:48:11,10/13/2021,81728169,1930.79,7,War outside place include. Actually physical owner attack imagine religious. Their daughter enjoy evidence region. Thank low rich represent.,13:30:21,DD
RHOS43398039713911,GB61LNNL27019625918822,8/4/2019,6277.24,100001,Y,Rent,SAFARI,POS,Dr,16:43:12,20:27:14,10/13/2021,648059,1930.79,4,"Home theory rather. Almost able close determine rest the. Top value piece dark gun no.
Magazine me daughter thought focus industry task. Discuss century hit next indeed.",18:42:34,UPI
RHOS43398039713911,GB61LNNL27019625918822,8/4/2019,8208.03,100001,N,Credited,SAFARI,POS,Cr,20:43:45,23:12:47,10/13/2021,52020384,1930.79,3,"Still human clearly house life blue imagine security. Main manage become far help more issue.
Feeling deal our bad law rise ready. Every project tonight response.",21:27:55,RTGS
RHOS43398039713911,GB61LNNL27019625918822,8/4/2019,9386.89,100001,N,Credited,EDGE,POS,Cr,6:35:43,11:35:29,10/14/2021,89050187,1178.86,3,"Let put certainly feel something.
Oil yourself traditional cultural and computer six. Reality show none a husband during language.",9:59:22,RTGS
RHOS43398039713911,GB61LNNL27019625918822,8/4/2019,8208.03,100001,Y,Dining,OPERA,POS,Dr,13:55:01,17:49:36,10/14/2021,74600724,1178.86,4,Less fact great game behavior budget issue. True sell western. Area old thousand civil enter surface lose story. Hit police early road office.,17:00:11,UPI
RHOS43398039713911,GB61LNNL27019625918822,8/4/2019,9635.85,100001,N,Credited,MI,MOBILE,Cr,3:59:19,6:22:15,10/17/2021,29909506,1427.82,5,"Wish loss eat improve check tax. Whole several agreement red low.
Think current modern area. Dog deep finish police.
Enjoy present see hard hand. Move when owner image best. While toward writer cell.",5:26:52,CARDS
RHOS43398039713911,GB61LNNL27019625918822,8/4/2019,11063.67,100001,N,Credited,CHROME,MOBILE,Cr,10:09:28,13:09:23,10/17/2021,3098912,1427.82,2,Other even program no still. Happy should teach believe do firm. Often case reveal unit. Central reduce wife account memory our before.,11:17:30,IMPS
RHOS43398039713911,GB61LNNL27019625918822,8/4/2019,12491.49,100001,N,Credited,SAFARI,MOBILE,Cr,16:23:16,19:45:20,10/17/2021,40005249,1427.82,6,Million series hundred development meeting. Day student call young which prove along letter. Conference year act everyone yes responsibility difference.,17:57:01,CHEQUE
RHOS43398039713911,GB61LNNL27019625918822,8/4/2019,11063.67,100001,Y,Online Shopping,SAFARI,POS,Dr,21:02:39,24:12:04,10/17/2021,96179291,1427.82,5,All whether region sign bank force charge. Yet them theory strategy out truth guy. Else gas start color spring low.,23:19:19,CARDS
AZVR85135161881683,GB95URAP17054870000917,5/17/2016,9082.96,100001,Y,Personal Care,SAFARI,PC,Dr,10:46:47,16:39:20,5/30/2016,44230173,527.19,1,"Magazine do factor property. If under focus toward environment air western save.
Middle represent happy he behind camera American inside. Over could say truth. Lead view project when.",12:57:25,NEFT
AZVR85135161881683,GB95URAP17054870000917,5/17/2016,8555.77,100001,Y,Transportation,MI,PC,Dr,14:34:14,19:23:17,5/30/2016,37021603,527.19,5,"Century shoulder follow arm. One court smile standard.
Agent large still carry only. Able play behind leg training myself.
Prevent as realize speech. Feeling different economic mean purpose.",17:27:21,CARDS
AZVR85135161881683,GB95URAP17054870000917,5/17/2016,6577.24,100001,Y,Utilities,MI,POS,Dr,10:34:51,16:40:38,6/8/2016,46543714,1978.53,2,Dog effort minute spend. Give include check without. Music rule less. Memory hard good executive whether indeed even war.,13:28:34,IMPS
AZVR85135161881683,GB95URAP17054870000917,5/17/2016,7194.22,100001,N,Credited,IE,MOBILE,Cr,12:24:21,19:32:37,6/14/2016,13321666,616.98,3,"Need act one. Final weight speak court road do.
Be doctor focus because. Treat prove husband up purpose.",16:07:50,RTGS
AZVR85135161881683,GB95URAP17054870000917,5/17/2016,5554.93,100001,Y,Household Consumables,OPERA,PC,Dr,6:44:41,9:03:32,6/16/2016,42643418,1639.29,7,"Spring successful sound center candidate fish.
Official might result line sort vote. Population fact lawyer although art political.",8:18:21,DD
AZVR85135161881683,GB95URAP17054870000917,5/17/2016,3915.64,100001,Y,Utilities,IE,MOBILE,Dr,14:27:31,20:12:46,6/16/2016,18486308,1639.29,2,"Interview watch per purpose test. Production level fill guess join.
City staff imagine several agent green represent. Series environment news assume left. Forward wait social station learn red find.",17:22:07,IMPS
AZVR85135161881683,GB95URAP17054870000917,5/17/2016,2276.35,100001,Y,Groceries,CHROME,MOBILE,Dr,18:09:31,21:03:22,6/16/2016,99856694,1639.29,2,Building news positive your however movie institution. Whatever difficult purpose give do.,18:53:27,IMPS
AZVR85135161881683,GB95URAP17054870000917,5/17/2016,683.42,100001,Y,Online Shopping,EDGE,PC,Dr,6:08:28,7:45:19,7/10/2016,43263066,1592.93,7,"Which soldier movie top strategy fine. Might action treat recently growth. Suffer early bag pass choice left.
Thought bring indicate two significant simply.",6:38:12,DD
AZVR85135161881683,GB95URAP17054870000917,5/17/2016,2276.35,100001,N,Credited,CHROME,MOBILE,Cr,9:15:13,11:35:41,7/10/2016,8080912,1592.93,4,"Picture six knowledge realize forget. Science health lot effect.
Pull man be hospital. Bed responsibility doctor ok candidate admit. Probably town for.",10:31:22,UPI
AZVR85135161881683,GB95URAP17054870000917,5/17/2016,3869.28,100001,N,Credited,MI,MOBILE,Cr,15:30:38,17:55:19,7/10/2016,71007762,1592.93,4,Visit growth difference travel some maybe statement upon. Far wind management information child. Him small staff.,15:55:36,UPI
AZVR85135161881683,GB95URAP17054870000917,5/17/2016,5462.21,100001,N,Credited,FF,MOBILE,Cr,17:27:16,20:17:35,7/10/2016,42667742,1592.93,7,"Field gun glass national. Catch space call where. Ability plan sure decide protect clearly.
Manage send large would serve. Phone part among language.",18:50:13,DD
AZVR85135161881683,GB95URAP17054870000917,5/17/2016,7055.14,100001,N,Credited,IE,PC,Cr,19:37:14,22:00:02,7/10/2016,25095562,1592.93,3,Child there answer within language can. Thing both while shake public although difference authority.,20:17:23,RTGS
AZVR85135161881683,GB95URAP17054870000917,5/17/2016,8516.22,100001,N,Credited,IE,POS,Cr,3:31:43,8:10:23,7/12/2016,53005649,1461.08,3,Life these human arrive anything probably dark. Former when weight really them theory ok. Reason close southern produce two own media.,6:28:16,RTGS
AZVR85135161881683,GB95URAP17054870000917,5/17/2016,7055.14,100001,Y,Household Consumables,IE,POS,Dr,14:43:54,17:42:10,7/12/2016,79541640,1461.08,1,"Compare financial source politics. Week conference establish.
Pm though democratic. Rather start able pull newspaper serve. Enjoy pretty hear cup heart meet.",15:23:39,NEFT
AZVR85135161881683,GB95URAP17054870000917,5/17/2016,8516.22,100001,N,Credited,CHROME,POS,Cr,20:29:13,24:17:34,7/12/2016,57093697,1461.08,4,Standard foreign loss yeah parent somebody situation. Necessary suggest state weight offer mission society. City will lot herself better.,22:02:37,UPI
AZVR85135161881683,GB95URAP17054870000917,5/17/2016,8943.04,100001,N,Credited,MI,MOBILE,Cr,6:56:02,9:12:33,7/13/2016,5600489,426.82,5,"Hundred fire reduce suggest fall. Night serve station dog art.
Color man appear list involve. Such beautiful democratic class night what.
Why yard religious policy possible. Lead debate bank floor.",8:33:27,CARDS
AZVR85135161881683,GB95URAP17054870000917,5/17/2016,8516.22,100001,Y,Household Consumables,SAFARI,MOBILE,Dr,14:09:38,16:55:40,7/13/2016,74761067,426.82,5,Social certainly reduce theory left continue crime. Matter feeling pattern no arrive.,16:17:39,CARDS
AZVR85135161881683,GB95URAP17054870000917,5/17/2016,8943.04,100001,N,Credited,MI,POS,Cr,20:30:45,22:17:49,7/13/2016,43651702,426.82,6,Attack surface democratic give. Bit billion director professor the wrong. Full form ready population unit anything.,21:23:25,CHEQUE
AZVR85135161881683,GB95URAP17054870000917,5/17/2016,10183.52,100001,N,Credited,SAFARI,POS,Cr,5:01:31,7:42:15,7/14/2016,12326143,1240.48,5,Theory cost accept store want suffer wait. Both prepare over industry and. Opportunity sort five get thank that generation action.,6:10:12,CARDS
AZVR85135161881683,GB95URAP17054870000917,5/17/2016,11424,100001,N,Credited,CHROME,PC,Cr,8:36:31,10:57:48,7/14/2016,6596156,1240.48,6,"Color source major rise. House either idea. Story information stage.
Provide health drug air rest so little. Bad lot indicate mind soldier clear.",10:29:28,CHEQUE
AZVR85135161881683,GB95URAP17054870000917,5/17/2016,10183.52,100001,Y,Household Consumables,FF,MOBILE,Dr,11:46:49,15:14:08,7/14/2016,31827041,1240.48,2,Five policy future walk movie fine raise itself. Everybody build television successful agreement player practice couple. Pm learn commercial security expert.,13:38:29,IMPS
AZVR85135161881683,GB95URAP17054870000917,5/17/2016,8943.04,100001,Y,Insurance,MI,POS,Dr,16:16:30,18:20:59,7/14/2016,12309856,1240.48,2,"Available enough property fill right help college analysis. Agent board sure ok. Establish grow sport fast several.
Crime hard dinner film. Also city every.",17:40:27,IMPS
AZVR85135161881683,GB95URAP17054870000917,5/17/2016,7702.56,100001,Y,Personal Care,CHROME,PC,Dr,20:28:30,23:10:30,7/14/2016,940153,1240.48,1,Lot upon watch ready. Ball report night right will go morning. Clearly somebody black the consumer attack. Let rise between time.,22:25:50,NEFT
AZVR85135161881683,GB95URAP17054870000917,5/17/2016,7081.65,100001,Y,Online Shopping,SAFARI,MOBILE,Dr,3:41:17,6:45:55,7/17/2016,65729144,620.91,2,"Enough book side game. Professional surface memory central apply. Our today difficult include director interest.
Edge can join garden or. Light low morning around notice level.",6:01:23,IMPS
AZVR85135161881683,GB95URAP17054870000917,5/17/2016,6460.74,100001,Y,Personal Care,IE,PC,Dr,14:34:07,17:39:13,7/17/2016,93933223,620.91,3,"Send eat career attention top poor. Another side single allow. Picture century return oil.
Bad and pressure return. Major member physical language discuss Mr be. Plan tough month fact eat truth.",15:56:27,RTGS
AZVR85135161881683,GB95URAP17054870000917,5/17/2016,5839.83,100001,Y,Insurance,IE,POS,Dr,16:43:21,19:22:22,7/17/2016,37042554,620.91,6,Unit alone player camera than. Article whole city view year.,18:15:27,CHEQUE
AZVR85135161881683,GB95URAP17054870000917,5/17/2016,5055.25,100001,Y,Rent,IE,PC,Dr,3:52:40,5:53:56,7/20/2016,93207409,784.58,5,"Which message area hospital. Reveal information west finally indicate idea difference.
Seven note place young local board. His bar once since. Writer decide manage own.",5:21:05,CARDS
AZVR85135161881683,GB95URAP17054870000917,5/17/2016,4270.67,100001,Y,Entertainment,FF,MOBILE,Dr,9:02:52,11:08:11,7/20/2016,14521577,784.58,7,Media system front nearly nice. Name enter statement treatment several often cause Democrat. Choice during hair free test begin.,10:10:55,DD
AZVR85135161881683,GB95URAP17054870000917,5/17/2016,5055.25,100001,N,Credited,OPERA,MOBILE,Cr,13:19:35,15:27:52,7/20/2016,33371894,784.58,3,"Smile treat list sure be see fear. Treatment may material experience find investment soldier chance. Since leave tough matter catch per suddenly.
Behavior upon participant born treatment experience.",14:33:53,RTGS
AZVR85135161881683,GB95URAP17054870000917,5/17/2016,5839.83,100001,N,Credited,CHROME,PC,Cr,15:10:30,16:43:52,7/20/2016,56740967,784.58,2,"Time forward clearly. Moment affect couple than without.
Serve operation should sometimes deep can. System near protect across box view view. Together step participant matter.",16:07:18,IMPS
AZVR85135161881683,GB95URAP17054870000917,5/17/2016,6624.41,100001,N,Credited,EDGE,MOBILE,Cr,19:19:00,21:15:20,7/20/2016,18551358,784.58,4,"Religious break our design. Garden church study job.
Raise building physical our budget career as. Important improve word operation mother check.",20:07:11,UPI
AZVR85135161881683,GB95URAP17054870000917,5/17/2016,5783.24,100001,Y,Rent,EDGE,PC,Dr,5:11:02,7:38:37,8/2/2016,50469048,841.17,2,"Pay control ever all. Garden it add nice hit toward road.
Recently home treat pick. Trip people measure fact unit product. New likely fill painting still. Beyond key push national.",6:23:28,IMPS
AZVR85135161881683,GB95URAP17054870000917,5/17/2016,4942.07,100001,Y,Insurance,EDGE,MOBILE,Dr,6:33:35,9:55:23,8/2/2016,77968371,841.17,4,Idea analysis chance. Glass talk expect rule tend. Live involve measure view almost me half. Sometimes fill gun human.,8:11:58,UPI
AZVR85135161881683,GB95URAP17054870000917,5/17/2016,5783.24,100001,N,Credited,FF,MOBILE,Cr,11:02:57,13:36:32,8/2/2016,73551997,841.17,4,"Physical alone morning red actually goal serve. Very decide reveal trouble today stay.
Perform choice father. Rate leave and. At society stay medical their choose.",12:36:06,UPI
AZVR85135161881683,GB95URAP17054870000917,5/17/2016,4942.07,100001,Y,Entertainment,SAFARI,MOBILE,Dr,14:33:24,17:10:42,8/2/2016,64765945,841.17,3,Since college movie economy. Same cover argue relate heart crime official with.,16:02:50,RTGS
AZVR85135161881683,GB95URAP17054870000917,5/17/2016,5783.24,100001,N,Credited,MI,POS,Cr,19:12:21,22:18:21,8/2/2016,59063193,841.17,3,West view community media. Relationship pass too knowledge door research. Catch two speech ball surface main decide fall. Town why few energy during then sing.,21:05:51,RTGS
AZVR85135161881683,GB95URAP17054870000917,5/17/2016,6489.23,100001,N,Credited,EDGE,MOBILE,Cr,5:52:39,8:24:11,8/11/2016,57124889,705.99,3,If customer ten join smile certain control. Participant fill rock generation small poor performance check. Pass partner far direction.,6:56:56,RTGS
AZVR85135161881683,GB95URAP17054870000917,5/17/2016,7195.22,100001,N,Credited,CHROME,MOBILE,Cr,9:23:50,12:10:55,8/11/2016,94757675,705.99,1,"Suddenly consider garden these crime off. Their third task wife.
Discussion of foot return beat once. International attorney share line just specific call director. Task about truth position.",10:33:16,NEFT
AZVR85135161881683,GB95URAP17054870000917,5/17/2016,6489.23,100001,Y,Household Consumables,IE,MOBILE,Dr,13:57:06,16:03:24,8/11/2016,2551340,705.99,2,Able effort another. Speech specific nation mouth recent. Change action hand letter four different. Win effort they treat society describe.,15:03:39,IMPS
AZVR85135161881683,GB95URAP17054870000917,5/17/2016,7195.22,100001,N,Credited,CHROME,POS,Cr,16:40:56,18:41:04,8/11/2016,32481495,705.99,4,"He state season knowledge kind ability.
Deal find we major cell here.
Situation threat someone these. Deep source address reduce around check. Street necessary including grow.",17:34:01,UPI
AZVR85135161881683,GB95URAP17054870000917,5/17/2016,7901.21,100001,N,Credited,FF,MOBILE,Cr,23:11:08,25:09:26,8/11/2016,89697696,705.99,5,Agreement go reality kind various current. Current be discover. Vote skin whole near ok.,23:38:31,CARDS
AZVR85135161881683,GB95URAP17054870000917,5/17/2016,6225.41,100001,Y,Insurance,EDGE,MOBILE,Dr,11:51:18,16:15:44,8/18/2016,94754100,1675.8,7,"Fight it site factor policy wrong. Sometimes child his south affect election. Follow hospital season learn.
Treatment nor choice almost research. Side order artist.",13:10:56,DD
AZVR85135161881683,GB95URAP17054870000917,5/17/2016,7007.85,100001,N,Credited,SAFARI,PC,Cr,5:02:49,8:18:38,8/28/2016,49776805,782.44,3,"Administration cold toward us whether theory technology. Only continue who remain tough government doctor central.
Simple boy evidence edge laugh thank amount.",6:27:15,RTGS
AZVR85135161881683,GB95URAP17054870000917,5/17/2016,6225.41,100001,Y,Household Consumables,CHROME,POS,Dr,11:36:00,13:02:13,8/28/2016,97074090,782.44,6,Decide visit response you. Ready whose own manager true per house.,12:21:23,CHEQUE
AZVR85135161881683,GB95URAP17054870000917,5/17/2016,5442.97,100001,Y,Online Shopping,EDGE,POS,Dr,20:06:42,25:07:25,8/28/2016,39059765,782.44,6,"Special second page since police listen. Pay must with least.
Certainly other doctor put least court. Rather page their leg.",22:15:53,CHEQUE
AZVR85135161881683,GB95URAP17054870000917,5/17/2016,7342.53,100001,N,Credited,OPERA,MOBILE,Cr,5:05:44,7:50:47,8/29/2016,52278006,1899.56,6,"Plant home process hotel. Pm member recent late each former.
Although value information leg agreement account. Generation western office son grow pull price.",6:09:47,CHEQUE
AZVR85135161881683,GB95URAP17054870000917,5/17/2016,5442.97,100001,Y,Online Shopping,EDGE,MOBILE,Dr,10:40:37,15:11:31,8/29/2016,61172517,1899.56,7,"Someone key white huge approach way notice. Thus when camera difference election culture.
Successful before Congress. Fast exactly else food among.
Nice while culture right enter thing coach.",12:46:23,DD
AZVR85135161881683,GB95URAP17054870000917,5/17/2016,3543.41,100001,Y,Medicals,EDGE,PC,Dr,16:11:50,21:23:07,8/29/2016,10697863,1899.56,2,Recognize attack kid. Whatever treat identify learn some skill big. Best term last choice deal write structure. Plan what year if clearly without.,19:11:03,IMPS
AZVR85135161881683,GB95URAP17054870000917,5/17/2016,2330.11,100001,Y,Transportation,FF,PC,Dr,7:43:32,15:51:00,9/3/2016,62146029,1213.3,1,"Reach shake group head. Standard pattern field customer spring natural.
One drop this anyone bank their support. Already son under model.",13:32:00,NEFT
AZVR85135161881683,GB95URAP17054870000917,5/17/2016,1156.11,100001,Y,Personal Care,EDGE,POS,Dr,5:11:18,7:44:09,9/5/2016,60815699,1174,7,"Statement score majority mention administration father. Drug eat catch listen plant present.
Bill kitchen huge religious model into idea arrive. Method suddenly growth raise admit along enough.",6:07:10,DD
AZVR85135161881683,GB95URAP17054870000917,5/17/2016,2330.11,100001,N,Credited,EDGE,POS,Cr,8:34:21,12:00:35,9/5/2016,14703249,1174,1,On civil coach hour. Send among identify across program edge. Anyone daughter someone some process role.,10:24:52,NEFT
AZVR85135161881683,GB95URAP17054870000917,5/17/2016,1156.11,100001,Y,Household Consumables,OPERA,MOBILE,Dr,14:35:10,17:10:32,9/5/2016,6485511,1174,2,"Indicate capital above door scientist arrive. End determine blue blue answer. Bed always try take soon view.
Ten share off help fast single. Positive tax responsibility environment your perform.",15:59:46,IMPS
AZVR85135161881683,GB95URAP17054870000917,5/17/2016,2330.11,100001,N,Credited,SAFARI,POS,Cr,18:25:44,20:05:14,9/5/2016,15579577,1174,1,"See then between. Go bill wife.
Run finish rock couple anything even view. Brother magazine that hair before business even.",19:11:01,NEFT
AZVR85135161881683,GB95URAP17054870000917,5/17/2016,1156.11,100001,Y,Insurance,SAFARI,MOBILE,Dr,22:49:39,25:00:37,9/5/2016,9938397,1174,2,"For early audience even good. Training while nothing course break politics rich.
Reveal meeting their beyond. Cell already here measure.",23:15:14,IMPS
AZVR85135161881683,GB95URAP17054870000917,5/17/2016,926.16,100001,Y,Online Shopping,IE,MOBILE,Dr,3:41:43,5:50:17,9/9/2016,96384060,229.95,2,Continue over whose market Republican case. Reason cold success road very which. Six look film brother start call in.,4:26:38,IMPS
AZVR85135161881683,GB95URAP17054870000917,5/17/2016,1156.11,100001,N,Credited,EDGE,MOBILE,Cr,10:01:14,12:44:24,9/9/2016,53484215,229.95,5,"Street man test cause compare wide. City oil road unit heart traditional smile.
Range wall sport marriage inside pay. Hear interest ahead fall late magazine.",11:42:29,CARDS
AZVR85135161881683,GB95URAP17054870000917,5/17/2016,1386.06,100001,N,Credited,SAFARI,MOBILE,Cr,11:54:54,14:25:30,9/9/2016,72119839,229.95,5,Attention yeah hour subject. Alone no above mother. Paper consider write degree. Heart claim low character allow role.,12:33:47,CARDS
AZVR85135161881683,GB95URAP17054870000917,5/17/2016,1156.11,100001,Y,Rent,IE,MOBILE,Dr,18:01:10,21:02:03,9/9/2016,32140057,229.95,5,"Cultural fire with letter source attack. Official hear look it note wall.
Believe development model Mrs. Trial push sing arrive institution. Teach nation out note finally rest participant image.",19:32:36,CARDS
AZVR85135161881683,GB95URAP17054870000917,5/17/2016,926.16,100001,Y,Online Shopping,OPERA,MOBILE,Dr,21:04:15,24:28:11,9/9/2016,75427795,229.95,2,"Itself various social agency my central measure order. Country seem commercial item.
Without unit work by. Team sign modern need need law agent.",22:54:33,IMPS
AZVR85135161881683,GB95URAP17054870000917,5/17/2016,2822.44,100001,N,Credited,FF,POS,Cr,18:35:33,26:48:36,9/12/2016,36006670,1896.28,5,"Lead green thus run hit identify. Country himself debate town.
People middle term unit now.
Page along wish week beyond. Particularly employee woman smile of garden time. Quality him less prepare.",22:11:26,CARDS
AZVR85135161881683,GB95URAP17054870000917,5/17/2016,929.67,100001,Y,Online Shopping,SAFARI,MOBILE,Dr,16:59:06,25:43:02,9/15/2016,16611634,1892.77,6,"Your herself case peace through avoid. Throw play step never tonight enough as. Help those authority main.
Unit beat glass material floor service kid require. Team look six.",19:53:40,CHEQUE
AZVR85135161881683,GB95URAP17054870000917,5/17/2016,2074.28,100001,N,Credited,MI,MOBILE,Cr,18:53:38,21:34:03,9/16/2016,12445271,1144.61,3,"Discover raise road decide concern weight far.
Because it bar. Less read thing newspaper lay child every. Challenge also city development anything.",19:57:44,RTGS
AZVR85135161881683,GB95URAP17054870000917,5/17/2016,3218.89,100001,N,Credited,EDGE,PC,Cr,22:38:44,23:38:57,9/16/2016,89687000,1144.61,1,"Call commercial adult.
Happy result occur individual.
Region green money. Star let only pretty pull of.",23:11:51,NEFT
AZVR85135161881683,GB95URAP17054870000917,5/17/2016,1655.98,100001,Y,Rent,MI,POS,Dr,7:44:46,12:13:58,9/29/2016,38842924,1562.91,2,"Answer start determine street. Gas agency next debate show. Less fly you indeed chance dog responsibility.
Quickly high skill feel. Generation ball anyone free outside yes.",10:02:47,IMPS
AZVR85135161881683,GB95URAP17054870000917,5/17/2016,3218.89,100001,N,Credited,OPERA,PC,Cr,15:03:42,22:10:57,9/29/2016,64466644,1562.91,2,"These own month home news. Budget conference physical commercial themselves.
High space company seek. Form letter message play half. Allow worry bit however discover stop.",18:40:33,IMPS
AZVR85135161881683,GB95URAP17054870000917,5/17/2016,1905.61,100001,Y,Household Consumables,IE,PC,Dr,7:11:14,14:34:09,10/2/2016,4535195,1313.28,2,"Song draw yourself leader medical on mind hour. On either three game send back game.
Cover huge popular. You lawyer parent. Now audience win both within which with.",10:59:37,IMPS
AZVR85135161881683,GB95URAP17054870000917,5/17/2016,592.33,100001,Y,Entertainment,SAFARI,MOBILE,Dr,18:21:24,24:02:35,10/2/2016,87023091,1313.28,4,"He appear hope company. Positive work finish network time race sort appear. Head eight others box.
Pretty citizen walk since. Simply whole important respond.",20:33:44,UPI
AZVR85135161881683,GB95URAP17054870000917,5/17/2016,153.61,100001,Y,Personal Care,MI,PC,Dr,3:42:35,6:06:49,10/11/2016,45639296,438.72,1,"Rate measure walk score dog our old. Official best think force paper catch space.
Make physical choose society. Can the sit according couple age. Marriage individual movie pick.",5:19:15,NEFT
AZVR85135161881683,GB95URAP17054870000917,5/17/2016,592.33,100001,N,Credited,OPERA,PC,Cr,11:29:02,15:01:37,10/11/2016,52867309,438.72,2,"Son place dog everyone. Direction other wife brother.
Put kitchen prepare involve chance morning. Western talk teacher media. None walk particular experience.",13:25:33,IMPS
AZVR85135161881683,GB95URAP17054870000917,5/17/2016,153.61,100001,Y,Online Shopping,OPERA,POS,Dr,18:20:18,21:02:59,10/11/2016,71983776,438.72,1,"Resource front recognize free out none. Chair rock might memory they rate set anything.
Leg especially writer. Popular management claim imagine. Gas somebody assume first. Bar here everyone party.",19:31:36,NEFT
AZVR85135161881683,GB95URAP17054870000917,5/17/2016,592.33,100001,N,Credited,FF,MOBILE,Cr,23:04:57,25:36:52,10/11/2016,69565571,438.72,2,"Anyone sing of reveal scientist instead military. Believe do while but write. Bill whole accept during such raise almost can.
Itself break few management character fill. Rule school peace who.",23:43:47,IMPS
AZVR85135161881683,GB95URAP17054870000917,5/17/2016,1239.24,100001,N,Credited,CHROME,MOBILE,Cr,4:47:04,7:50:41,10/15/2016,92317284,646.91,6,"Of question dinner score approach water decision address. Mind could shake song various material.
Opportunity meet between kind subject girl suggest country. Around husband car.",7:03:14,CHEQUE
AZVR85135161881683,GB95URAP17054870000917,5/17/2016,592.33,100001,Y,Online Shopping,SAFARI,POS,Dr,12:12:52,13:59:48,10/15/2016,64168722,646.91,2,"Protect themselves everybody. Campaign black organization read.
Case guy military seek agency call of. Thank add risk start while worker.",12:45:50,IMPS
AZVR85135161881683,GB95URAP17054870000917,5/17/2016,1239.24,100001,N,Credited,IE,MOBILE,Cr,21:20:46,24:37:41,10/15/2016,15542588,646.91,1,"Kid even identify million join similar. Site cold follow citizen everyone.
Will professional describe responsibility. Fear east enter. Party Democrat serve performance yet matter.",23:36:43,NEFT
AZVR85135161881683,GB95URAP17054870000917,5/17/2016,86.73,100001,Y,Personal Care,OPERA,MOBILE,Dr,11:30:30,17:55:03,10/22/2016,80457978,1152.51,5,"Audience only deep force money. Special would degree. Current ready spring national.
Become analysis local believe baby the. Do large bill key.",14:07:43,CARDS
AZVR85135161881683,GB95URAP17054870000917,5/17/2016,325.15,100001,N,Credited,CHROME,POS,Cr,10:10:18,13:00:51,10/26/2016,34905210,238.42,4,Success particular go alone continue suddenly. Make line owner establish site. Subject attorney factor who.,11:45:06,UPI
AZVR85135161881683,GB95URAP17054870000917,5/17/2016,86.73,100001,Y,Online Shopping,OPERA,PC,Dr,12:08:44,14:13:58,10/26/2016,90312182,238.42,6,Late account statement receive firm. Note large simple. Throw establish bank her major.,12:42:45,CHEQUE
AZVR85135161881683,GB95URAP17054870000917,5/17/2016,325.15,100001,N,Credited,EDGE,POS,Cr,16:16:07,17:31:34,10/26/2016,60928443,238.42,4,"Investment smile within born last simple us throw.
Reflect she word sport decade. Job approach smile.
Begin fly certain technology attorney goal police.",17:01:03,UPI
AZVR85135161881683,GB95URAP17054870000917,5/17/2016,86.73,100001,Y,Transportation,FF,POS,Dr,21:28:05,24:11:24,10/26/2016,12761296,238.42,5,"While house test garden list street film. In night somebody. Attack poor peace ground.
Organization mouth program population attention upon. Most program whole boy ability on school.",22:42:46,CARDS
AZVR85135161881683,GB95URAP17054870000917,5/17/2016,591.78,100001,N,Credited,SAFARI,PC,Cr,11:32:14,15:17:11,11/1/2016,58044971,505.05,4,"Event stop member. Best think future book think argue.
Stop final tend foot. Everybody take try such police. Score hundred sit sit thought model. Change buy who career.",14:28:48,UPI
AZVR85135161881683,GB95URAP17054870000917,5/17/2016,1096.83,100001,N,Credited,MI,PC,Cr,22:32:57,23:49:09,11/1/2016,2896854,505.05,2,"May you perform man ten. Condition only report authority. Painting before future late course.
He sea discussion seek right yeah chair course. Democratic test room wish lot.",23:10:00,IMPS
AZVR85135161881683,GB95URAP17054870000917,5/17/2016,2814.66,100001,N,Credited,OPERA,PC,Cr,19:25:11,21:37:41,11/25/2016,53435828,1717.83,4,Garden most study successful show foreign fear. Scene yourself federal our.,20:09:08,UPI
AZVR85135161881683,GB95URAP17054870000917,5/17/2016,2109.8,100001,Y,Dining,MI,POS,Dr,3:10:27,5:33:55,11/27/2016,29721313,704.86,2,Exactly receive hold one meet. Modern future final. Get difference very not boy drop nothing.,4:12:25,IMPS
AZVR85135161881683,GB95URAP17054870000917,5/17/2016,1404.94,100001,Y,Insurance,MI,PC,Dr,7:08:33,8:46:16,11/27/2016,95746135,704.86,4,"Experience movement spring property center section size. Product time stop financial trip reveal life may.
Culture discussion teach sometimes. Watch bed shoulder step. Science ask rule key eight.",8:01:44,UPI
AZVR85135161881683,GB95URAP17054870000917,5/17/2016,2109.8,100001,N,Credited,IE,PC,Cr,14:41:06,16:23:14,11/27/2016,43723768,704.86,7,"Mr friend center half might south. Win mind east animal nor carry. Success second natural despite history our.
Network lay view bed note ever include. Mind treat of compare by.",15:10:28,DD
AZVR85135161881683,GB95URAP17054870000917,5/17/2016,1404.94,100001,Y,Groceries,SAFARI,MOBILE,Dr,15:39:14,18:53:04,11/27/2016,74740215,704.86,4,"Number time inside already always behind different. Direction decide plant tonight account worker left.
Skill adult decade serious such. Wide tax fly explain want big. Tax need himself.",17:20:11,UPI
AZVR85135161881683,GB95URAP17054870000917,5/17/2016,2109.8,100001,N,Credited,OPERA,PC,Cr,20:18:17,22:05:27,11/27/2016,87351057,704.86,2,Indicate suggest safe never nor expert open environment. Item movement reduce natural. Lawyer religious answer believe seven Democrat test.,21:13:50,IMPS
AZVR85135161881683,GB95URAP17054870000917,5/17/2016,3751.9,100001,N,Credited,MI,PC,Cr,12:40:41,20:36:16,12/2/2016,70696981,1642.1,6,Mission at everybody visit worry area cause. Bank until federal sense fine finish computer.,17:55:39,CHEQUE
AZVR85135161881683,GB95URAP17054870000917,5/17/2016,2744.69,100001,Y,Dining,OPERA,MOBILE,Dr,5:53:03,7:40:41,12/9/2016,72559543,1007.21,5,"Bag begin pressure laugh. Security recent next but future probably. His guess can huge modern include.
Writer spring involve same radio with something. Health only control food over reality.",6:24:23,CARDS
AZVR85135161881683,GB95URAP17054870000917,5/17/2016,1737.48,100001,Y,Rent,SAFARI,POS,Dr,9:49:27,13:02:40,12/9/2016,37731373,1007.21,7,"Begin opportunity oil much. Where though alone word sport price. I be available check house leave. Relate yet reach boy small campaign pressure.
Upon close tonight. Produce food better.",11:45:58,DD
AZVR85135161881683,GB95URAP17054870000917,5/17/2016,2744.69,100001,N,Credited,IE,POS,Cr,13:15:16,15:45:46,12/9/2016,73181903,1007.21,6,Thank after eye seem. Star source future true cut smile degree. Professional behind thank type skin lay.,14:37:08,CHEQUE
AZVR85135161881683,GB95URAP17054870000917,5/17/2016,3751.9,100001,N,Credited,EDGE,POS,Cr,16:37:30,19:08:41,12/9/2016,40764962,1007.21,4,"Hospital see alone where everyone many. Site eat place through civil goal social trip.
Box apply painting decade security pick stage us. Page rich base enough body eight student.",18:29:58,UPI
AZVR85135161881683,GB95URAP17054870000917,5/17/2016,4759.11,100001,N,Credited,FF,MOBILE,Cr,20:11:01,22:09:07,12/9/2016,8548627,1007.21,5,"Wait yes whom dark hair against hear identify. Trade people week war now.
Police rather catch least throughout reach. Attention hour available.",21:43:48,CARDS
AZVR85135161881683,GB95URAP17054870000917,5/17/2016,5279.48,100001,N,Credited,MI,PC,Cr,7:52:53,11:02:37,12/14/2016,1605891,520.37,1,"Last kind structure. Meet structure past. Scientist everyone right care knowledge as.
Large how wind process no knowledge pressure. Two sea view perhaps yet animal trial.",9:58:13,NEFT
AZVR85135161881683,GB95URAP17054870000917,5/17/2016,4759.11,100001,Y,Medicals,MI,PC,Dr,16:00:07,20:47:06,12/14/2016,38317477,520.37,5,Understand wind cup each against stop cell. Him you billion north.,18:24:30,CARDS
AZVR85135161881683,GB95URAP17054870000917,5/17/2016,5008.15,100001,N,Credited,EDGE,POS,Cr,6:11:17,8:20:50,12/24/2016,95894140,249.04,7,"Wrong letter tree radio. Him discover executive within.
Short lead talk follow. Serve experience explain company along.
Entire large also describe. Whatever blood record build.",7:16:06,DD
AZVR85135161881683,GB95URAP17054870000917,5/17/2016,4759.11,100001,Y,Groceries,EDGE,MOBILE,Dr,13:13:12,17:54:07,12/24/2016,28265696,249.04,6,"Couple statement help onto him. Stand everything series pick century between few.
World sort catch buy surface class.
Agency green style avoid term.",15:08:03,CHEQUE
AZVR85135161881683,GB95URAP17054870000917,5/17/2016,4510.07,100001,Y,Entertainment,MI,POS,Dr,21:31:53,25:38:37,12/24/2016,39001283,249.04,7,Reality campaign police interest affect. Score along game sound key officer fact.,23:52:54,DD
AZVR85135161881683,GB95URAP17054870000917,5/17/2016,4541.29,100001,N,Credited,MI,POS,Cr,8:02:26,9:09:29,12/31/2016,84030450,31.22,5,Election after again tell himself travel development standard. Agree perhaps view paper view close show man.,8:36:12,CARDS
AZVR85135161881683,GB95URAP17054870000917,5/17/2016,4572.51,100001,N,Credited,FF,PC,Cr,12:22:24,15:33:35,12/31/2016,44215224,31.22,6,Current subject data energy. Site bank up remain day. He another while allow wait news side.,13:16:19,CHEQUE
AZVR85135161881683,GB95URAP17054870000917,5/17/2016,4541.29,100001,Y,Online Shopping,OPERA,MOBILE,Dr,13:15:13,16:47:01,12/31/2016,62783545,31.22,5,"Long week career. Past you court soon region large.
Civil focus rule instead. Raise end within see.",15:23:25,CARDS
AZVR85135161881683,GB95URAP17054870000917,5/17/2016,4510.07,100001,Y,Entertainment,IE,MOBILE,Dr,19:23:43,23:23:17,12/31/2016,5627707,31.22,5,Study economic chair TV trial mouth every strong. Stock determine approach produce. Opportunity free offer ten.,21:26:33,CARDS
AZVR85135161881683,GB95URAP17054870000917,5/17/2016,6339.97,100001,N,Credited,MI,POS,Cr,5:05:58,7:04:17,1/6/2017,80972907,1829.9,7,"Food day capital boy strong hair a. Couple choice Democrat rock. Prove color attack must.
Close figure without plan building team administration. Treatment everything hour sure notice.",6:11:59,DD
AZVR85135161881683,GB95URAP17054870000917,5/17/2016,4510.07,100001,Y,Dining,EDGE,PC,Dr,10:01:45,13:07:24,1/6/2017,21828980,1829.9,5,"Young stock card onto close doctor. Story item put serve woman. Dream range artist economy.
A that despite cause particular along. Still travel police purpose.",11:29:49,CARDS
AZVR85135161881683,GB95URAP17054870000917,5/17/2016,2680.17,100001,Y,Online Shopping,SAFARI,POS,Dr,13:50:54,17:12:08,1/6/2017,72552049,1829.9,3,"Build summer actually from. Ten she leg effort anything. Floor east poor rich.
Fund where many idea forward. Hot test blue floor instead my large health.
Order range visit vote science.",14:58:56,RTGS
AZVR85135161881683,GB95URAP17054870000917,5/17/2016,850.27,100001,Y,Dining,EDGE,POS,Dr,19:31:32,24:00:26,1/6/2017,82634315,1829.9,4,Once win day much attention arm window. West college compare still various whose focus. Property worker prepare.,21:41:15,UPI
AZVR85135161881683,GB95URAP17054870000917,5/17/2016,2354.23,100001,N,Credited,FF,MOBILE,Cr,8:52:30,12:48:02,1/22/2017,75024123,1503.96,3,"Along medical so turn special place strong mention. Nor left seek. Guy throughout really your upon.
Beat system green system. Military us somebody significant discussion.",10:45:07,RTGS
AZVR85135161881683,GB95URAP17054870000917,5/17/2016,3858.19,100001,N,Credited,SAFARI,MOBILE,Cr,16:40:45,20:37:02,1/22/2017,3976548,1503.96,2,"Song nor set decade against eight full certainly. It treatment play pick argue carry.
In author none able kind strategy. Religious program fly money investment even road. Plant attention tree yes.",17:50:11,IMPS
AZVR85135161881683,GB95URAP17054870000917,5/17/2016,2354.23,100001,Y,Utilities,CHROME,PC,Dr,20:17:00,25:44:30,1/22/2017,10230541,1503.96,2,"Four quality late amount. Magazine go ahead group. Work part industry notice believe customer.
Source today music.",22:57:46,IMPS
AZVR85135161881683,GB95URAP17054870000917,5/17/2016,4146.66,100001,N,Credited,EDGE,POS,Cr,9:19:42,13:50:37,2/3/2017,53648471,1792.43,2,Daughter four represent natural seem conference piece. Fund direction artist baby into writer role. Instead leg school nation move what list put.,11:28:56,IMPS
AZVR85135161881683,GB95URAP17054870000917,5/17/2016,5939.09,100001,N,Credited,MI,MOBILE,Cr,11:50:55,14:58:24,2/3/2017,55630511,1792.43,6,Possible arrive data party. Appear though control. Thank fall just term who. During minute day order line member positive.,12:47:26,CHEQUE
AZVR85135161881683,GB95URAP17054870000917,5/17/2016,4146.66,100001,Y,Household Consumables,OPERA,POS,Dr,19:43:14,24:27:02,2/3/2017,84952578,1792.43,4,Get world reality and establish television different. Beyond state art perhaps check. Race present short day mother.,22:29:01,UPI
AZVR85135161881683,GB95URAP17054870000917,5/17/2016,3378.97,100001,Y,Utilities,SAFARI,MOBILE,Dr,8:21:59,12:20:43,2/10/2017,52741623,767.69,4,"Card property option. Late medical stage difficult task.
Finish her leave. Through investment executive.
Human building us cold. The health factor bit water head feel.",10:15:33,UPI
AZVR85135161881683,GB95URAP17054870000917,5/17/2016,2611.28,100001,Y,Household Consumables,IE,POS,Dr,17:08:42,21:22:08,2/10/2017,99920180,767.69,1,"Treatment reason professor rise. Mouth pay could property through ever floor.
Impact perform house each. Picture ahead improve stay her.
Chance feeling case long. Well even program.",18:30:22,NEFT
AZVR85135161881683,GB95URAP17054870000917,5/17/2016,1847.71,100001,Y,Insurance,EDGE,MOBILE,Dr,7:26:16,12:40:40,2/13/2017,89770672,763.57,6,"Talk she role three leave born television machine. Relate force north. Another late local team them.
Window few memory no.
Idea save after threat. Simple cell forward order reveal.",10:26:13,CHEQUE
AZVR85135161881683,GB95URAP17054870000917,5/17/2016,2611.28,100001,N,Credited,CHROME,POS,Cr,15:04:57,19:48:02,2/13/2017,59957508,763.57,3,Heart one environmental. Also continue total market ever should. Ever your rock.,16:51:29,RTGS
AZVR85135161881683,GB95URAP17054870000917,5/17/2016,1847.71,100001,Y,Online Shopping,MI,MOBILE,Dr,17:08:23,21:54:40,2/13/2017,32201376,763.57,7,"Kitchen ask seven. Sometimes on rock exactly much. School character worker difficult maybe occur and.
Class shoulder down former. Soldier right ahead fire yard well analysis.",19:09:56,DD
AZVR85135161881683,GB95URAP17054870000917,5/17/2016,3566.38,100001,N,Credited,IE,PC,Cr,8:34:01,12:12:30,2/28/2017,94339659,1718.67,6,"Evidence friend find task. Include imagine each line best building buy.
Rule consider drive resource affect even car. Describe radio gas.
Perhaps structure perform have less development free make.",11:18:14,CHEQUE
AZVR85135161881683,GB95URAP17054870000917,5/17/2016,5285.05,100001,N,Credited,SAFARI,PC,Cr,16:25:48,18:32:21,2/28/2017,26006079,1718.67,3,"Stop avoid only ago brother meeting idea. Pattern sea make war hot artist.
Marriage fast audience sometimes data try. Step walk while pressure become.",17:15:44,RTGS
AZVR85135161881683,GB95URAP17054870000917,5/17/2016,7003.72,100001,N,Credited,MI,PC,Cr,20:54:36,24:45:52,2/28/2017,24306744,1718.67,3,"Project thank use recognize eye nor. Seek ok anything time item.
East budget matter issue wish. Us million model appear he know TV.",22:18:37,RTGS
AZVR85135161881683,GB95URAP17054870000917,5/17/2016,6820.78,100001,Y,Dining,MI,POS,Dr,5:14:15,7:21:40,3/5/2017,70079371,182.94,7,"Style girl see require become. Opportunity by piece institution. Company beat like deep teacher imagine.
Necessary away watch training land mean protect. Deep turn three approach.",6:43:11,DD
AZVR85135161881683,GB95URAP17054870000917,5/17/2016,6637.84,100001,Y,Insurance,IE,PC,Dr,12:23:35,15:40:32,3/5/2017,99578763,182.94,1,"Key painting a office view cover stop.
Almost class although view be chance. Million heavy focus against nor opportunity sit concern. Focus run argue performance network.",14:02:04,NEFT
AZVR85135161881683,GB95URAP17054870000917,5/17/2016,6454.9,100001,Y,Rent,EDGE,MOBILE,Dr,19:13:07,23:41:13,3/5/2017,4382355,182.94,1,"Wish yeah mention child prevent difficult dream.
Can learn decade serve today realize receive. Admit walk likely century bit class. Second south team give success practice with skin.",21:12:24,NEFT
AZVR85135161881683,GB95URAP17054870000917,5/17/2016,7981.49,100001,N,Credited,MI,PC,Cr,10:19:17,16:31:18,3/6/2017,66210535,1526.59,1,Together significant project heart goal hold perform. Arrive involve everybody also within size. Success must series tell hot deal bring.,12:49:48,NEFT
AZVR85135161881683,GB95URAP17054870000917,5/17/2016,6454.9,100001,Y,Entertainment,SAFARI,MOBILE,Dr,17:55:58,21:13:46,3/6/2017,78614888,1526.59,7,"Country page single despite protect scene walk to. Full still finish tax between large necessary.
Pretty sound realize think. Field news water. Grow success society approach try appear what my.",19:48:16,DD
AZVR85135161881683,GB95URAP17054870000917,5/17/2016,8319.07,100001,N,Credited,SAFARI,PC,Cr,8:09:46,12:08:55,3/7/2017,58305164,1864.17,1,"Traditional huge pattern sometimes partner.
Drive police agency. You class heavy top every body would individual.",11:01:03,NEFT
AZVR85135161881683,GB95URAP17054870000917,5/17/2016,6454.9,100001,Y,Rent,CHROME,PC,Dr,18:57:08,23:31:57,3/7/2017,92923171,1864.17,7,Process then leader Congress bad low company however. This yes they current.,21:18:35,DD
AZVR85135161881683,GB95URAP17054870000917,5/17/2016,7554.85,100001,N,Credited,FF,PC,Cr,4:27:48,7:25:14,3/10/2017,69280016,1099.95,5,North write though half long interest information order. First her her development any. Billion employee according design hair.,6:10:38,CARDS
AZVR85135161881683,GB95URAP17054870000917,5/17/2016,6454.9,100001,Y,Transportation,OPERA,POS,Dr,7:36:23,9:18:25,3/10/2017,48534154,1099.95,4,Provide four pressure. Throw window answer office couple dark.,8:18:56,UPI
AZVR85135161881683,GB95URAP17054870000917,5/17/2016,5354.95,100001,Y,Transportation,FF,POS,Dr,13:08:58,15:23:35,3/10/2017,13288075,1099.95,3,Yard Democrat feel economic. Lead technology better agreement save decision would. Some natural enter attorney help break clearly.,13:50:25,RTGS
AZVR85135161881683,GB95URAP17054870000917,5/17/2016,6454.9,100001,N,Credited,FF,POS,Cr,18:46:28,21:10:00,3/10/2017,69972812,1099.95,6,Nice guess always radio. Kind author newspaper visit.,19:49:41,CHEQUE
AZVR85135161881683,GB95URAP17054870000917,5/17/2016,7554.85,100001,N,Credited,CHROME,POS,Cr,19:28:22,21:03:56,3/10/2017,46363374,1099.95,5,Market drive help citizen serious no. A sport goal growth perhaps economic smile. Change mission control forget television listen kind.,20:17:42,CARDS
AZVR85135161881683,GB95URAP17054870000917,5/17/2016,7459.37,100001,Y,Dining,FF,MOBILE,Dr,6:14:59,8:55:45,4/3/2017,17153638,95.48,3,Cell miss student focus describe. Measure white itself similar check. Voice structure then tax nation different store others.,7:04:20,RTGS
AZVR85135161881683,GB95URAP17054870000917,5/17/2016,7554.85,100001,N,Credited,EDGE,MOBILE,Cr,8:17:04,11:09:18,4/3/2017,24861885,95.48,2,"Also process serve claim.
Style project rest perhaps may.
After drive feel. His medical executive spend provide increase move. Someone truth tax.",9:30:11,IMPS
AZVR85135161881683,GB95URAP17054870000917,5/17/2016,7459.37,100001,Y,Online Shopping,SAFARI,PC,Dr,14:25:52,16:37:19,4/3/2017,35690603,95.48,3,Accept great read notice tree purpose. Himself finish according outside realize site. Sure catch many simple light parent themselves.,15:30:00,RTGS
AZVR85135161881683,GB95URAP17054870000917,5/17/2016,7363.89,100001,Y,Personal Care,MI,MOBILE,Dr,17:12:58,18:14:21,4/3/2017,78250000,95.48,2,Fact on back each bring anything force campaign. Blood politics research feel husband answer floor. Cell which call kitchen next dog.,17:50:20,IMPS
AZVR85135161881683,GB95URAP17054870000917,5/17/2016,7268.41,100001,Y,Transportation,IE,POS,Dr,21:42:51,24:30:27,4/3/2017,24372756,95.48,7,"Laugh discussion she his rich. Arrive stop factor without.
Machine certainly candidate. Off bad how old of.",22:52:28,DD
AZVR85135161881683,GB95URAP17054870000917,5/17/2016,6027.56,100001,Y,Rent,MI,PC,Dr,14:37:18,23:46:54,4/17/2017,3775066,1240.85,2,Figure often develop either laugh allow. Last reduce almost take wide assume. Arrive six education certainly.,20:31:19,IMPS
AZVR85135161881683,GB95URAP17054870000917,5/17/2016,6639.09,100001,N,Credited,EDGE,MOBILE,Cr,5:43:45,8:42:19,4/23/2017,5395712,611.53,1,"Reality hard hold happy. Talk class whole join strong.
Fly affect whether degree during issue majority. Glass whom office treat always no.
Information create exactly in. Bill either where check.",7:44:48,NEFT
AZVR85135161881683,GB95URAP17054870000917,5/17/2016,6027.56,100001,Y,Utilities,FF,PC,Dr,10:00:08,12:36:56,4/23/2017,27654101,611.53,6,"Man pass bad card lead. Each us act others. Any population full those woman.
During training response public affect.",10:51:25,CHEQUE
AZVR85135161881683,GB95URAP17054870000917,5/17/2016,5416.03,100001,Y,Transportation,SAFARI,MOBILE,Dr,15:58:34,17:43:07,4/23/2017,93247276,611.53,7,"Any itself candidate trouble. Part impact staff event finish mention environmental natural.
Remain environmental actually instead travel.",16:37:05,DD
AZVR85135161881683,GB95URAP17054870000917,5/17/2016,4804.5,100001,Y,Personal Care,IE,POS,Dr,20:37:03,23:23:54,4/23/2017,84308337,611.53,1,Pm paper certainly music. Ten campaign much picture save near. Movie deep movie road majority.,22:07:06,NEFT
AZVR85135161881683,GB95URAP17054870000917,5/17/2016,5440.23,100001,N,Credited,CHROME,PC,Cr,10:25:02,14:10:27,4/24/2017,46731562,635.73,3,"Into management fact culture really simple become. Take evidence stage nothing news. Newspaper like per budget.
Body recently floor dinner my. Season ever wrong special.",12:34:13,RTGS
AZVR85135161881683,GB95URAP17054870000917,5/17/2016,6075.96,100001,N,Credited,IE,PC,Cr,17:13:44,21:49:50,4/24/2017,17580717,635.73,7,"Off check individual among. Policy sign policy most our career.
Matter expect red car how production mind. Strategy suggest mind everyone strategy ok usually.",18:42:02,DD
AZVR85135161881683,GB95URAP17054870000917,5/17/2016,7106.04,100001,N,Credited,FF,MOBILE,Cr,10:26:33,13:36:40,4/28/2017,129770,1030.08,2,Year culture sell administration score image place. Source medical father especially eye attention. Occur other movement read mouth bed million improve.,11:30:42,IMPS
AZVR85135161881683,GB95URAP17054870000917,5/17/2016,6075.96,100001,Y,Dining,IE,POS,Dr,11:19:25,14:46:02,4/28/2017,48308809,1030.08,3,"International throw main leg stuff find. Word forward discussion first rule.
Nation resource prove speak than agency. Computer job military head western help industry.",12:03:25,RTGS
AZVR85135161881683,GB95URAP17054870000917,5/17/2016,5045.88,100001,Y,Transportation,EDGE,POS,Dr,15:44:02,19:19:15,4/28/2017,33805405,1030.08,4,"Similar discussion east. Too drop product training go style talk sure.
Report leave break us. World rather teach stage. Movement than live contain cover.
Action evening assume travel effort.",18:28:21,UPI
AZVR85135161881683,GB95URAP17054870000917,5/17/2016,4549.24,100001,Y,Dining,IE,PC,Dr,2:18:00,5:34:47,4/30/2017,12428700,496.64,5,"Really face section trip. Before cup budget family television. Off form different.
Grow mind recent citizen fast by should. Consider that likely interview.",4:13:45,CARDS
AZVR85135161881683,GB95URAP17054870000917,5/17/2016,4052.6,100001,Y,Household Consumables,CHROME,PC,Dr,6:42:41,8:58:07,4/30/2017,32386608,496.64,1,"You yes probably speak. Mind exactly skill amount. Her close three visit fact pick common.
Can summer police example until draw hope space. Word a give worry. Major turn event look within bar.",8:32:40,NEFT
AZVR85135161881683,GB95URAP17054870000917,5/17/2016,4549.24,100001,N,Credited,MI,MOBILE,Cr,11:23:30,13:25:05,4/30/2017,10586488,496.64,5,"Value future tell long. Event upon degree sign.
Few policy culture billion current ground cell community. Let support entire left anyone party. Road main son guess event over budget if.",12:13:30,CARDS
AZVR85135161881683,GB95URAP17054870000917,5/17/2016,5045.88,100001,N,Credited,SAFARI,MOBILE,Cr,15:34:45,18:16:25,4/30/2017,22773883,496.64,4,Office couple leader level probably foot another. Finally almost someone behind science quality.,16:43:47,UPI
AZVR85135161881683,GB95URAP17054870000917,5/17/2016,4549.24,100001,Y,Transportation,MI,MOBILE,Dr,20:54:03,24:41:18,4/30/2017,69891816,496.64,7,"Floor carry difference. Group quickly very school.
Claim first fill someone believe. Among test treat many management radio protect somebody. Later project any two.",22:49:26,DD
AZVR85135161881683,GB95URAP17054870000917,5/17/2016,4861.45,100001,N,Credited,IE,PC,Cr,17:22:05,23:51:22,5/2/2017,61459403,312.21,2,Where treat throughout reveal sure your continue read. House after cultural away single government community. Decide science physical new.,18:36:51,IMPS
AZVR85135161881683,GB95URAP17054870000917,5/17/2016,6129.11,100001,N,Credited,MI,PC,Cr,6:10:07,7:54:04,5/5/2017,59408529,1267.66,2,Bed popular affect I perhaps pull. Forget from research. Together focus bill produce less effect.,7:05:56,IMPS
AZVR85135161881683,GB95URAP17054870000917,5/17/2016,7396.77,100001,N,Credited,IE,PC,Cr,7:00:18,8:49:45,5/5/2017,87866377,1267.66,6,"Treat ready item sport society when human model. Four civil single pattern box current difference professor. Pretty control value leave star live.
Of real country state. Position out medical set.",8:10:47,CHEQUE
AZVR85135161881683,GB95URAP17054870000917,5/17/2016,8664.43,100001,N,Credited,IE,POS,Cr,11:42:24,13:14:02,5/5/2017,84049056,1267.66,7,Degree fly fill popular most will our purpose. Anyone receive lead personal. Large store election another soon wonder above.,12:43:55,DD
AZVR85135161881683,GB95URAP17054870000917,5/17/2016,9932.09,100001,N,Credited,OPERA,PC,Cr,15:37:52,18:14:08,5/5/2017,66972440,1267.66,5,Fast work political certainly include. Very especially watch first score. Capital off heart buy through although.,16:23:50,CARDS
AZVR85135161881683,GB95URAP17054870000917,5/17/2016,11199.75,100001,N,Credited,OPERA,POS,Cr,18:38:20,20:59:00,5/5/2017,41292778,1267.66,2,Three conference explain agency out. Suddenly forward seek. Himself green alone though really speech. Whether word prove clearly hope.,20:07:56,IMPS
AZVR85135161881683,GB95URAP17054870000917,5/17/2016,12536.28,100001,N,Credited,EDGE,PC,Cr,9:12:20,14:16:39,5/18/2017,56966626,1336.53,1,"Carry clearly nothing amount live. Life small thought tend employee field rest. Choice training himself you whom.
Describe high across sure Democrat. Authority knowledge suffer whole could.",12:42:12,NEFT
AZVR85135161881683,GB95URAP17054870000917,5/17/2016,13872.81,100001,N,Credited,OPERA,MOBILE,Cr,19:31:03,26:50:56,5/18/2017,19388748,1336.53,2,Time democratic suggest imagine ready. Though end hospital dark foreign.,23:30:05,IMPS
AZVR85135161881683,GB95URAP17054870000917,5/17/2016,15021.73,100001,N,Credited,EDGE,PC,Cr,15:14:02,24:31:12,5/30/2017,39693747,1148.92,1,"White president TV whatever tend pay. Floor boy stuff third us.
Loss may she firm knowledge single close. Bad task much upon. Leave decade follow than television sign.",20:41:50,NEFT
AZVR85135161881683,GB95URAP17054870000917,5/17/2016,14966.63,100001,Y,Entertainment,OPERA,PC,Dr,9:33:00,13:14:02,5/31/2017,63579680,55.1,3,Believe job build catch actually four. Tend Congress hear soldier. A audience happen fine money hard. Road should fear vote during physical.,11:25:49,RTGS
AZVR85135161881683,GB95URAP17054870000917,5/17/2016,14911.53,100001,Y,Transportation,MI,POS,Dr,20:15:12,22:30:13,5/31/2017,96681756,55.1,1,"Act responsibility speech number to specific.
Majority leg crime today coach growth hospital.
Hit trade way explain go. Soldier agent magazine nor adult professor heavy.",21:24:15,NEFT
AZVR85135161881683,GB95URAP17054870000917,5/17/2016,14082.53,100001,Y,Transportation,IE,MOBILE,Dr,10:41:58,13:57:56,6/5/2017,84439789,829,3,"Blue result clear country hard land personal. Energy assume good significant. My member cover reflect race subject onto.
Industry cover relate behind tend. Home reveal business a.",13:01:11,RTGS
AZVR85135161881683,GB95URAP17054870000917,5/17/2016,13253.53,100001,Y,Transportation,SAFARI,MOBILE,Dr,21:15:04,26:26:30,6/5/2017,40156149,829,2,Find capital option. Quite bag walk assume. Song goal event sense. Then personal language benefit send.,23:30:25,IMPS
AZVR85135161881683,GB95URAP17054870000917,5/17/2016,13989.1,100001,N,Credited,IE,MOBILE,Cr,12:15:23,18:11:45,6/7/2017,39891945,735.57,6,"Environment next full college foot. Here wish stage high. Language stage foot.
Despite standard simple final picture style always can. Must onto as make audience national system.",14:15:19,CHEQUE
AZVR85135161881683,GB95URAP17054870000917,5/17/2016,14864.45,100001,N,Credited,FF,MOBILE,Cr,7:04:54,10:07:57,6/10/2017,41610138,875.35,6,"Ground yard city month these long garden. Stock lot care painting sort.
Six world strategy certain. Sure style through dog race military.",9:27:17,CHEQUE
AZVR85135161881683,GB95URAP17054870000917,5/17/2016,13989.1,100001,Y,Personal Care,CHROME,PC,Dr,11:09:08,14:56:29,6/10/2017,85041646,875.35,2,Operation sell employee structure allow. Statement success do but every keep change.,12:35:33,IMPS
AZVR85135161881683,GB95URAP17054870000917,5/17/2016,13113.75,100001,Y,Utilities,FF,PC,Dr,17:03:47,21:03:46,6/10/2017,55904377,875.35,2,"Teach budget analysis. Hold community follow each nature use.
Pm item cup avoid memory. Hear dark senior day. Itself head audience different white condition. Million economic brother hear especially.",18:27:29,IMPS
AZVR85135161881683,GB95URAP17054870000917,5/17/2016,13865.65,100001,N,Credited,MI,PC,Cr,9:54:53,18:01:03,6/14/2017,60800442,751.9,4,"Standard much nothing car group. Success growth treatment wait. Respond determine choose prepare.
Rise grow loss position method whatever. Fill I seven realize assume.",14:57:15,UPI
AZVR85135161881683,GB95URAP17054870000917,5/17/2016,14138.71,100001,N,Credited,CHROME,MOBILE,Cr,10:03:33,12:48:23,6/25/2017,15753557,273.06,4,Low pattern skin friend pass each born. Occur stay scientist alone quality. Better word front eight prove lawyer.,11:10:22,UPI
AZVR85135161881683,GB95URAP17054870000917,5/17/2016,14411.77,100001,N,Credited,OPERA,MOBILE,Cr,14:03:24,17:39:24,6/25/2017,42849223,273.06,5,"Reflect of heavy space large. Television better at Republican energy media discussion.
Stand improve air your ok. Property produce next see.
So our such sing Democrat personal.",16:46:30,CARDS
AZVR85135161881683,GB95URAP17054870000917,5/17/2016,13495.72,100001,Y,Groceries,MI,POS,Dr,6:32:17,12:30:46,6/26/2017,65916025,916.05,1,Create blue this especially people security. Skill discuss spring democratic activity difficult hundred year. Everything represent food fast pass.,10:29:02,NEFT
AZVR85135161881683,GB95URAP17054870000917,5/17/2016,14411.77,100001,N,Credited,EDGE,PC,Cr,16:31:03,22:28:10,6/26/2017,36642359,916.05,6,"Event because party magazine culture. Health second seven despite nation off exist citizen.
Wait support somebody. Wish on mother movie way no. School newspaper morning able individual up.",18:51:07,CHEQUE
AZVR85135161881683,GB95URAP17054870000917,5/17/2016,13024.69,100001,Y,Rent,FF,PC,Dr,4:52:29,12:00:20,7/1/2017,71264035,1387.08,4,According new read teach include family. Pm improve support card ask either situation. Game seem teach hear number.,8:39:21,UPI
AZVR85135161881683,GB95URAP17054870000917,5/17/2016,11637.61,100001,Y,Dining,EDGE,MOBILE,Dr,20:28:21,26:18:48,7/1/2017,56676495,1387.08,7,Wall stuff protect future including impact. Instead drive specific leave. Everyone ask Republican run.,22:29:42,DD
AZVR85135161881683,GB95URAP17054870000917,5/17/2016,12871.75,100001,N,Credited,EDGE,MOBILE,Cr,7:47:12,10:12:46,7/6/2017,21507168,1234.14,6,"Dream because reach night top.
It trade away fly nation. Few nor ago us candidate contain open want. Ok place bring.",8:48:43,CHEQUE
AZVR85135161881683,GB95URAP17054870000917,5/17/2016,14105.89,100001,N,Credited,MI,POS,Cr,12:32:11,15:14:00,7/6/2017,92449442,1234.14,1,"Indeed officer unit particular change. History war job green wish. Establish of be his positive ten environment. Tv then machine left street.
Baby into door cut forward. Television yard blood road.",14:19:05,NEFT
AZVR85135161881683,GB95URAP17054870000917,5/17/2016,15340.03,100001,N,Credited,MI,POS,Cr,17:37:27,19:59:27,7/6/2017,77253477,1234.14,7,"Picture watch draw.
Guess wonder what kind institution. Four up nothing window. Election one music.
Police beautiful make heart social computer. Thousand receive see produce.",19:00:34,DD
AZVR85135161881683,GB95URAP17054870000917,5/17/2016,16574.17,100001,N,Credited,IE,MOBILE,Cr,20:22:06,24:22:37,7/6/2017,29014378,1234.14,6,"Performance vote between mind voice.
Like open as here field. Suddenly practice detail make effort.
Dinner attention white maybe pay. International special information radio face season.",21:59:47,CHEQUE
AZVR85135161881683,GB95URAP17054870000917,5/17/2016,18541.4,100001,N,Credited,OPERA,PC,Cr,5:33:12,7:16:57,7/7/2017,82344696,1967.23,4,"Weight rock if stock whole. Likely college education treat seat discuss reveal.
Everything this full PM kitchen. Interesting style even town science where.",6:41:39,UPI
AZVR85135161881683,GB95URAP17054870000917,5/17/2016,20508.63,100001,N,Credited,CHROME,POS,Cr,7:56:44,11:15:47,7/7/2017,80141983,1967.23,1,"Pretty glass trouble now.
Loss yourself old tree light instead rate. Such maybe inside. Who order recognize hotel.
Nearly floor night. Give drop third help effect long.",10:00:31,NEFT
AZVR85135161881683,GB95URAP17054870000917,5/17/2016,22475.86,100001,N,Credited,MI,PC,Cr,16:57:35,19:35:38,7/7/2017,92840973,1967.23,4,Alone many on bank law. Despite west growth drive civil.,17:44:20,UPI
AZVR85135161881683,GB95URAP17054870000917,5/17/2016,20508.63,100001,Y,Transportation,FF,POS,Dr,20:44:55,22:33:01,7/7/2017,35699019,1967.23,6,"Clear history wind away hair. Develop ball area.
Republican day think color likely new herself. Customer doctor difference heart term hear bring.",21:36:48,CHEQUE
AZVR85135161881683,GB95URAP17054870000917,5/17/2016,18597.55,100001,Y,Groceries,OPERA,MOBILE,Dr,6:43:22,11:40:15,7/8/2017,84680242,1911.08,1,"Some only raise and specific. Word lay wind west. Teach born notice anything thousand.
Room option mean certainly. Community author pass million.",10:30:28,NEFT
AZVR85135161881683,GB95URAP17054870000917,5/17/2016,20508.63,100001,N,Credited,EDGE,POS,Cr,17:41:09,21:01:39,7/8/2017,60984654,1911.08,7,Bad spend war serious three piece. Condition town particular together. Treat crime capital defense any past society join.,20:09:51,DD
AZVR85135161881683,GB95URAP17054870000917,5/17/2016,18519.19,100001,Y,Entertainment,SAFARI,MOBILE,Dr,9:03:10,13:54:24,7/9/2017,99995324,1989.44,1,"Indeed true arrive represent. Pull be total war under.
Seven as challenge benefit memory seek.",11:11:32,NEFT
AZVR85135161881683,GB95URAP17054870000917,5/17/2016,20508.63,100001,N,Credited,IE,PC,Cr,10:09:34,13:47:08,7/9/2017,56530759,1989.44,1,Camera explain house read score everybody seven. Way sell recent wife.,12:40:27,NEFT
AZVR85135161881683,GB95URAP17054870000917,5/17/2016,22498.07,100001,N,Credited,OPERA,POS,Cr,18:43:14,20:51:58,7/9/2017,23705616,1989.44,3,"Country tonight level drive. Bring word stop three stop process.
Exist card parent face professional. Raise computer major. Show product college officer.",19:46:13,RTGS
AZVR85135161881683,GB95URAP17054870000917,5/17/2016,24164.94,100001,N,Credited,MI,MOBILE,Cr,7:17:20,10:41:54,7/12/2017,20346379,1666.87,3,"Day first relate level involve father.
Determine seem sport soldier final hold. Week citizen forget defense bag international.",9:25:48,RTGS
AZVR85135161881683,GB95URAP17054870000917,5/17/2016,22498.07,100001,Y,Insurance,OPERA,PC,Dr,9:52:10,12:36:43,7/12/2017,55137102,1666.87,2,Collection actually early scientist. Toward technology true thought newspaper. Lose sometimes institution ahead want speech.,11:19:46,IMPS
AZVR85135161881683,GB95URAP17054870000917,5/17/2016,20831.2,100001,Y,Rent,EDGE,PC,Dr,14:53:30,17:36:38,7/12/2017,90020629,1666.87,4,Possible ball become TV show official. Ago number let Congress write upon. Force during investment next risk song president.,16:56:45,UPI
AZVR85135161881683,GB95URAP17054870000917,5/17/2016,19164.33,100001,Y,Dining,EDGE,POS,Dr,21:08:50,22:54:13,7/12/2017,54816565,1666.87,3,"Be let toward figure likely shoulder. Bar discuss tax effect.
Back get use brother. Wind soon memory Democrat phone challenge resource like. Field significant TV.",22:05:35,RTGS
AZVR85135161881683,GB95URAP17054870000917,5/17/2016,21089.59,100001,N,Credited,CHROME,MOBILE,Cr,5:27:08,10:42:45,7/15/2017,82572143,1925.26,7,"Table any inside senior source. National what second middle.
Eight involve focus significant street including. Much laugh open garden.",8:42:57,DD
AZVR85135161881683,GB95URAP17054870000917,5/17/2016,19164.33,100001,Y,Entertainment,CHROME,POS,Dr,13:55:24,20:05:53,7/15/2017,82822217,1925.26,3,Road possible get him hair. Way certain worry space green. Catch somebody girl yourself kind law ok.,16:35:28,RTGS
AZVR85135161881683,GB95URAP17054870000917,5/17/2016,20085.03,100001,N,Credited,OPERA,MOBILE,Cr,17:49:12,25:57:02,7/16/2017,88602905,920.7,2,"Human fine with mind growth religious mention. Forget important fill prevent performance.
Where forward expert themselves western sense quite. Box eye identify to.",20:31:06,IMPS
AZVR85135161881683,GB95URAP17054870000917,5/17/2016,19005.67,100001,Y,Medicals,OPERA,POS,Dr,14:56:29,19:21:44,7/17/2017,60361639,1079.36,2,"There soldier if who positive six inside leg. Sort later same.
Run new bar maintain professional quite ready year. Your sea score.
Ball west option admit born. Mrs fight true wide.",16:25:47,IMPS
AZVR85135161881683,GB95URAP17054870000917,5/17/2016,17882.12,100001,Y,Medicals,OPERA,MOBILE,Dr,6:33:57,13:49:23,7/23/2017,45345616,1123.55,1,"A generation forget send page economic. Modern ago term kind food unit trouble.
Indeed concern situation. Audience still role address. Role find exist true money boy reduce.",10:10:20,NEFT
AZVR85135161881683,GB95URAP17054870000917,5/17/2016,19005.67,100001,N,Credited,SAFARI,POS,Cr,20:33:10,23:28:04,7/23/2017,10472101,1123.55,5,"Team west Congress agent along. Task seem floor somebody when continue rest. Mention sense decide fire really.
They west article paper that. Attention so cost still. Dog majority course behavior.",21:40:18,CARDS
AZVR85135161881683,GB95URAP17054870000917,5/17/2016,20504.33,100001,N,Credited,MI,PC,Cr,4:24:21,8:05:41,7/30/2017,2940458,1498.66,1,"Tree bit concern maybe. Scene drop pay item.
Modern activity actually plant everything subject performance recognize. Congress consider already story remember garden reduce mission.",5:42:36,NEFT
AZVR85135161881683,GB95URAP17054870000917,5/17/2016,19005.67,100001,Y,Transportation,IE,POS,Dr,9:23:36,11:55:02,7/30/2017,60747853,1498.66,3,"Anyone laugh eat blood. Few management great education.
Put list receive whom cover many again. Crime experience similar stock month.",10:36:38,RTGS
AZVR85135161881683,GB95URAP17054870000917,5/17/2016,20504.33,100001,N,Credited,EDGE,MOBILE,Cr,17:09:38,19:45:35,7/30/2017,25792218,1498.66,7,Discuss skin although bank common. Husband able open special machine scene. Green TV five. Something sell represent.,18:37:25,DD
AZVR85135161881683,GB95URAP17054870000917,5/17/2016,22002.99,100001,N,Credited,OPERA,POS,Cr,18:26:11,22:43:42,7/30/2017,92229006,1498.66,7,Person pressure despite positive prevent can. Court section more image become list quite. End play increase avoid look sing laugh here.,20:46:40,DD
AZVR85135161881683,GB95URAP17054870000917,5/17/2016,22159.66,100001,N,Credited,EDGE,PC,Cr,6:12:30,9:49:13,8/12/2017,32433296,156.67,7,"Different with audience east. Space first bad mission leave people.
Find natural officer put peace need. Public law listen sure sister may. Piece ok give at agency find.
Article foreign since.",7:29:18,DD
AZVR85135161881683,GB95URAP17054870000917,5/17/2016,22316.33,100001,N,Credited,FF,PC,Cr,13:13:44,15:29:05,8/12/2017,28281085,156.67,2,"Morning president defense grow whose of production drug. Reason feeling yourself seven. Father this fly team.
Raise already manager especially.",14:04:26,IMPS
AZVR85135161881683,GB95URAP17054870000917,5/17/2016,22473,100001,N,Credited,IE,POS,Cr,21:29:57,24:59:15,8/12/2017,10036235,156.67,1,Should play education both. Seven fill evidence husband likely industry.,23:21:00,NEFT
AZVR85135161881683,GB95URAP17054870000917,5/17/2016,22156.16,100001,Y,Dining,FF,PC,Dr,6:45:54,9:54:26,8/20/2017,22211293,316.84,6,Matter chance explain here probably class. Spring activity president answer summer ground professional. Then strong likely store boy late kitchen.,8:57:15,CHEQUE
AZVR85135161881683,GB95URAP17054870000917,5/17/2016,21839.32,100001,Y,Rent,OPERA,MOBILE,Dr,15:25:44,17:19:30,8/20/2017,75251086,316.84,1,Economy everything south true thought wrong. Out to indicate on gas thing. Decision store move. At support prevent nation physical class.,16:02:34,NEFT
AZVR85135161881683,GB95URAP17054870000917,5/17/2016,21522.48,100001,Y,Transportation,MI,MOBILE,Dr,20:46:04,25:38:58,8/20/2017,92588912,316.84,3,"Down wait sit two once professional against campaign. Seven perhaps feel right most. Human task suffer sense.
Next guy early shoulder. Industry citizen throughout short natural.",23:30:16,RTGS
AZVR85135161881683,GB95URAP17054870000917,5/17/2016,20113.72,100001,Y,Utilities,OPERA,POS,Dr,5:54:34,7:57:50,8/27/2017,2474168,1408.76,1,"Hit of argue beat person until such. Relate prepare least western energy program pay. Lot trouble trade sea people.
Reveal find hard result. Believe country seek. Politics else brother apply.",7:17:17,NEFT
AZVR85135161881683,GB95URAP17054870000917,5/17/2016,18704.96,100001,Y,Rent,OPERA,POS,Dr,9:54:05,13:22:09,8/27/2017,11603092,1408.76,2,Admit give view today treatment between leave. Modern education draw specific professor account. Adult type air.,11:24:45,IMPS
AZVR85135161881683,GB95URAP17054870000917,5/17/2016,20113.72,100001,N,Credited,CHROME,PC,Cr,11:41:28,13:39:39,8/27/2017,80915812,1408.76,1,Option off determine it chance system model. Peace assume early ahead. Prove understand thousand. Free hand bit throw.,12:19:19,NEFT
AZVR85135161881683,GB95URAP17054870000917,5/17/2016,21522.48,100001,N,Credited,OPERA,PC,Cr,14:45:46,17:28:49,8/27/2017,99769734,1408.76,1,"Close out live behind organization. Lay two yard because. Child goal service soldier product relationship.
War employee public could southern send. Discuss reality source main us understand.",16:00:50,NEFT
AZVR85135161881683,GB95URAP17054870000917,5/17/2016,22931.24,100001,N,Credited,FF,POS,Cr,22:30:38,24:43:26,8/27/2017,47252226,1408.76,3,Its beautiful which authority. Continue vote similar knowledge recent put. Buy service letter challenge point individual. Garden but pattern station field poor.,23:57:21,RTGS
AZVR85135161881683,GB95URAP17054870000917,5/17/2016,23933,100001,N,Credited,OPERA,PC,Cr,7:06:20,9:39:18,9/2/2017,9574045,1001.76,7,"Material before whatever red half cup find property. Wrong north wear yes blood production.
Less rise reveal direction save house choose process. Notice station know police personal entire bill.",8:07:13,DD
AZVR85135161881683,GB95URAP17054870000917,5/17/2016,22931.24,100001,Y,Online Shopping,OPERA,PC,Dr,17:30:40,20:05:34,9/2/2017,47780842,1001.76,5,Individual expert happy side key unit authority short. Answer list set able culture customer. Act want court enter professional.,19:12:15,CARDS
AZVR85135161881683,GB95URAP17054870000917,5/17/2016,21676.63,100001,Y,Utilities,IE,PC,Dr,10:54:52,17:00:34,9/8/2017,26471563,1254.61,2,Along range live at full relationship. Office effort way deal table customer pass as. Way arm grow office.,14:37:09,IMPS
AZVR85135161881683,GB95URAP17054870000917,5/17/2016,20422.02,100001,Y,Personal Care,MI,POS,Dr,15:46:25,19:35:54,9/8/2017,90866401,1254.61,3,Figure expert could film production worker great. Same despite pass power whole before affect.,18:44:34,RTGS
AZVR85135161881683,GB95URAP17054870000917,5/17/2016,20929.8,100001,N,Credited,IE,POS,Cr,4:28:45,6:50:15,9/9/2017,51982867,507.78,6,"Under safe audience development. Edge cultural end protect break.
Herself traditional side person too.
Side science new just. Tend light hour a which.
Top born thousand generation.",6:07:40,CHEQUE
AZVR85135161881683,GB95URAP17054870000917,5/17/2016,20422.02,100001,Y,Groceries,CHROME,MOBILE,Dr,9:33:45,12:05:12,9/9/2017,73706199,507.78,2,"Edge adult tree environment. Everything city good listen around lose.
Decade more hit western house next be. Sign glass tree area. Project act easy return.",11:13:17,IMPS
AZVR85135161881683,GB95URAP17054870000917,5/17/2016,20929.8,100001,N,Credited,EDGE,POS,Cr,13:17:29,15:32:58,9/9/2017,97908234,507.78,3,Investment one agent center sit sport society. Expect study behind cultural. Paper series woman general. Father discover do collection.,14:33:45,RTGS
AZVR85135161881683,GB95URAP17054870000917,5/17/2016,21437.58,100001,N,Credited,EDGE,POS,Cr,19:36:31,23:30:43,9/9/2017,79827270,507.78,6,Contain dinner side care. Least face pass where film pay simple. Remember body before late eight be change.,21:36:12,CHEQUE
AZVR85135161881683,GB95URAP17054870000917,5/17/2016,20006.83,100001,Y,Online Shopping,EDGE,MOBILE,Dr,8:22:55,12:18:36,9/10/2017,1265637,1430.75,4,Visit purpose alone central cover however. Contain once blue democratic during. Tell experience event.,9:21:45,UPI
AZVR85135161881683,GB95URAP17054870000917,5/17/2016,18576.08,100001,Y,Online Shopping,IE,POS,Dr,15:08:41,17:00:39,9/10/2017,47462250,1430.75,5,Friend represent whom system light history. Visit point ahead item life push nature. Fall at them.,15:53:22,CARDS
AZVR85135161881683,GB95URAP17054870000917,5/17/2016,20006.83,100001,N,Credited,IE,MOBILE,Cr,21:05:50,26:13:07,9/10/2017,9598676,1430.75,5,"People amount those focus girl heavy baby TV. Its much put score with speech.
Gun thank evening magazine sing amount activity. Foot at card industry type number weight.",23:28:42,CARDS
AZVR85135161881683,GB95URAP17054870000917,5/17/2016,18314.15,100001,Y,Household Consumables,OPERA,PC,Dr,19:56:01,26:44:30,9/20/2017,93629218,1692.68,5,"Bank it center sister some up police foot.
Over hear energy wear. Program probably often cost them than forward. After free simply act include information service goal.",21:43:24,CARDS
AZVR85135161881683,GB95URAP17054870000917,5/17/2016,16477.69,100001,Y,Insurance,CHROME,POS,Dr,8:34:04,13:37:01,9/26/2017,69868146,1836.46,4,"Cup thought remain activity. Challenge whole they create attorney.
Actually coach best question key approach. Nation guy hotel southern.",11:14:09,UPI
AZVR85135161881683,GB95URAP17054870000917,5/17/2016,14641.23,100001,Y,Dining,EDGE,POS,Dr,15:46:39,18:40:41,9/26/2017,9256699,1836.46,5,"Will budget manage point. Hair possible available impact dark. Place remember simply benefit dinner party list.
Tell bad his full party study card. Beat girl wrong machine.
Pass story avoid.",17:10:48,CARDS
AZVR85135161881683,GB95URAP17054870000917,5/17/2016,16477.69,100001,N,Credited,FF,PC,Cr,21:05:54,24:10:11,9/26/2017,21969010,1836.46,3,Book energy throw wife according option. Believe unit keep machine everything. We single language card animal happen. One together candidate thank price.,22:48:57,RTGS
AZVR85135161881683,GB95URAP17054870000917,5/17/2016,15015.64,100001,Y,Household Consumables,CHROME,MOBILE,Dr,5:45:14,8:21:53,10/1/2017,48319485,1462.05,1,Center condition sometimes wide central reveal impact. Five case specific safe middle movie how. Fire cost great cup special social sure over.,6:51:51,NEFT
AZVR85135161881683,GB95URAP17054870000917,5/17/2016,13553.59,100001,Y,Household Consumables,CHROME,PC,Dr,9:38:58,12:15:03,10/1/2017,69295331,1462.05,1,"Take think song occur try friend.
Rich to human campaign side. Late policy dinner fear although yard magazine.
Color smile collection sit my entire yard.",11:06:02,NEFT
AZVR85135161881683,GB95URAP17054870000917,5/17/2016,15015.64,100001,N,Credited,MI,MOBILE,Cr,14:54:20,17:42:29,10/1/2017,94329575,1462.05,1,Group entire former cut hundred. Parent next deep school traditional. Market year technology religious street town owner.,15:56:37,NEFT
AZVR85135161881683,GB95URAP17054870000917,5/17/2016,13553.59,100001,Y,Transportation,IE,POS,Dr,20:12:32,23:50:52,10/1/2017,37395872,1462.05,7,Bring hospital study sing red suggest between. Series final whatever member second realize movie.,21:53:18,DD
AZVR85135161881683,GB95URAP17054870000917,5/17/2016,13994.22,100001,N,Credited,EDGE,PC,Cr,10:53:06,17:49:54,10/4/2017,60072863,440.63,1,"Him price physical century man. Consider control western board change something from buy.
Government part charge watch inside soon wide.",14:33:23,NEFT
AZVR85135161881683,GB95URAP17054870000917,5/17/2016,15220.37,100001,N,Credited,EDGE,POS,Cr,5:35:56,9:52:54,10/5/2017,5700776,1226.15,5,"Between crime consumer none interview list sister what. Wife coach perform respond book. Sense billion brother speak.
These serve player dog century. Son see trip. Design let area peace west.",7:00:00,CARDS
AZVR85135161881683,GB95URAP17054870000917,5/17/2016,13994.22,100001,Y,Insurance,OPERA,PC,Dr,14:39:14,18:47:32,10/5/2017,81098231,1226.15,2,"Pay write miss poor quickly book.
Why skill try several. Next thousand pattern expert agency friend.",16:52:39,IMPS
AZVR85135161881683,GB95URAP17054870000917,5/17/2016,12768.07,100001,Y,Medicals,OPERA,POS,Dr,21:02:02,25:32:38,10/5/2017,4207849,1226.15,7,"Rise mean question fact society. Why stop little within yes back meeting. Child thing Congress language.
Investment happen Congress clear.",23:07:45,DD
AZVR85135161881683,GB95URAP17054870000917,5/17/2016,13997.74,100001,N,Credited,SAFARI,MOBILE,Cr,8:19:19,10:47:48,10/10/2017,63796087,1229.67,6,Provide lawyer ground this guess building. Live protect happen scene concern. Artist information law usually themselves. Worker school heavy heavy close employee whose.,9:14:36,CHEQUE
AZVR85135161881683,GB95URAP17054870000917,5/17/2016,15227.41,100001,N,Credited,SAFARI,POS,Cr,11:47:26,14:30:30,10/10/2017,80306351,1229.67,1,"Herself deep sign fear card. Capital include clearly establish glass art fly.
Suggest walk she case onto ask. Great enjoy second it.",12:29:26,NEFT
AZVR85135161881683,GB95URAP17054870000917,5/17/2016,13997.74,100001,Y,Medicals,EDGE,POS,Dr,12:37:32,16:43:56,10/10/2017,14346842,1229.67,1,"Career more heavy respond deep. Find economy usually score animal nation. Science perhaps energy once.
Lose the natural central project throw she. Note none something how. Sure upon get star ten.",14:59:22,NEFT
AZVR85135161881683,GB95URAP17054870000917,5/17/2016,15227.41,100001,N,Credited,MI,PC,Cr,18:15:14,22:13:56,10/10/2017,34786550,1229.67,3,"Expect real summer. Main outside camera how child. Keep home least explain.
Western difficult mouth leader another drop. Simply manage everybody piece. Camera company quite wonder reveal assume past.",20:11:50,RTGS
AZVR85135161881683,GB95URAP17054870000917,5/17/2016,16793.92,100001,N,Credited,OPERA,PC,Cr,9:57:44,14:42:08,10/18/2017,6183462,1566.51,4,"Prepare consider party. Draw thousand perhaps president friend art. Fall partner page place property. Pm administration all cell.
Necessary find finish quickly family people drop. Ask care city fire.",12:02:53,UPI
AZVR85135161881683,GB95URAP17054870000917,5/17/2016,18360.43,100001,N,Credited,CHROME,PC,Cr,13:04:45,16:58:52,10/18/2017,94075014,1566.51,3,"Time kitchen push size. Newspaper girl month.
Sound case low. Tonight important any.
Number on add friend appear learn down. Police wonder understand perform. Gas structure tend professional.",16:08:09,RTGS
AZVR85135161881683,GB95URAP17054870000917,5/17/2016,19546.44,100001,N,Credited,SAFARI,MOBILE,Cr,16:19:27,23:42:37,10/21/2017,12096435,1186.01,3,"Per hit both city price. May support moment rather. Fish nor plan wear great rate stop. Certain environmental seven beyond.
Class because reality office while. Ten upon take apply return hot.",22:05:19,RTGS
AZVR85135161881683,GB95URAP17054870000917,5/17/2016,20679.44,100001,N,Credited,IE,MOBILE,Cr,7:54:55,12:13:42,10/22/2017,56972719,1133,6,Focus continue summer Democrat. Those include life board option large. Way build today above.,9:45:29,CHEQUE
AZVR85135161881683,GB95URAP17054870000917,5/17/2016,19546.44,100001,Y,Online Shopping,IE,POS,Dr,15:07:24,18:36:30,10/22/2017,77312150,1133,5,Process price behavior fund answer understand hope. Source herself remember. Goal among tree pick research.,16:22:56,CARDS
AZVR85135161881683,GB95URAP17054870000917,5/17/2016,20679.44,100001,N,Credited,SAFARI,PC,Cr,20:15:50,24:25:05,10/22/2017,93745208,1133,6,Suffer too get newspaper gun treat. Reveal agreement bit. Become opportunity cover turn. Raise western your their apply.,22:33:24,CHEQUE
AZVR85135161881683,GB95URAP17054870000917,5/17/2016,18749.34,100001,Y,Rent,SAFARI,PC,Dr,13:39:34,19:12:43,11/9/2017,95253190,1930.1,4,Tv cultural run let avoid represent under prepare. Financial goal issue explain account leave run speak. Realize test relationship set well person.,15:38:15,UPI
AZVR85135161881683,GB95URAP17054870000917,5/17/2016,16819.24,100001,Y,Household Consumables,SAFARI,MOBILE,Dr,17:36:46,21:12:38,11/9/2017,85529724,1930.1,5,House ground rich soldier red four PM. Hour figure store less future ground. Source including sea carry. How concern least particularly certain.,19:24:14,CARDS
AZVR85135161881683,GB95URAP17054870000917,5/17/2016,18452.53,100001,N,Credited,EDGE,POS,Cr,6:20:00,9:51:18,11/12/2017,80713814,1633.29,6,Drop industry window now truth agree. Much through group fish they today. Campaign military sit if everyone watch though.,7:04:28,CHEQUE
AZVR85135161881683,GB95URAP17054870000917,5/17/2016,20085.82,100001,N,Credited,SAFARI,POS,Cr,12:02:50,16:43:42,11/12/2017,83427572,1633.29,1,"Woman deal right soon wonder agree society. That staff step usually machine method. Much share best back think benefit.
Future position material value understand she foreign. Trade run color school.",14:08:13,NEFT
AZVR85135161881683,GB95URAP17054870000917,5/17/2016,18452.53,100001,Y,Dining,EDGE,MOBILE,Dr,20:46:35,24:19:52,11/12/2017,81219285,1633.29,7,"Ago thousand easy debate PM. Fire would sea bar lose million.
Performance dog drop Mr. Former exactly happy question kid institution together its. Support personal up thought treatment their little.",23:03:47,DD
AZVR85135161881683,GB95URAP17054870000917,5/17/2016,18353.53,100001,Y,Household Consumables,OPERA,POS,Dr,16:25:25,25:43:18,11/19/2017,46923332,99,4,"Along view stand easy particular. Garden up grow.
Stage but occur painting need. Thing upon stay style many also. Avoid Republican road our property million sense thing.
Ever anyone chance enough.",20:50:05,UPI
AZVR85135161881683,GB95URAP17054870000917,5/17/2016,17214.95,100001,Y,Insurance,EDGE,POS,Dr,9:16:06,12:35:58,11/25/2017,20841539,1138.58,7,Responsibility traditional throughout however ball listen decision. Staff audience traditional political make. Left wish development like rise practice.,11:11:20,DD
AZVR85135161881683,GB95URAP17054870000917,5/17/2016,16076.37,100001,Y,Utilities,IE,MOBILE,Dr,19:26:44,23:27:48,11/25/2017,52479953,1138.58,2,Card that brother as picture. Administration smile paper vote soldier write remain. Study break police magazine garden professional suffer.,20:16:27,IMPS
AZVR85135161881683,GB95URAP17054870000917,5/17/2016,15317.64,100001,Y,Entertainment,MI,MOBILE,Dr,4:17:10,9:04:49,11/27/2017,44131067,758.73,1,Develop represent get always. System few focus top law wide change.,7:02:21,NEFT
AZVR85135161881683,GB95URAP17054870000917,5/17/2016,16076.37,100001,N,Credited,CHROME,PC,Cr,11:01:08,14:26:14,11/27/2017,9574557,758.73,3,Follow whatever land tonight. Land job medical increase.,13:16:56,RTGS
AZVR85135161881683,GB95URAP17054870000917,5/17/2016,15317.64,100001,Y,Rent,MI,MOBILE,Dr,18:49:55,22:28:50,11/27/2017,76731518,758.73,3,Even big skill act blood push. Page hear when these knowledge budget fact. Late Congress generation though century. Friend series deal site.,21:43:42,RTGS
AZVR85135161881683,GB95URAP17054870000917,5/17/2016,14938.02,100001,Y,Online Shopping,OPERA,POS,Dr,8:14:01,17:27:03,11/28/2017,25284744,379.62,4,"Light read visit yes. Arrive today officer magazine. Physical feel finish ahead.
Institution country them just whole if partner. Message against country key.",12:24:42,UPI
AZVR85135161881683,GB95URAP17054870000917,5/17/2016,13826.22,100001,Y,Household Consumables,FF,POS,Dr,9:43:08,13:53:42,11/30/2017,93458146,1111.8,6,"Sure sound both remain. Early Congress him.
Order cause happen rather pay political. Six finally eat admit significant.",12:55:46,CHEQUE
AZVR85135161881683,GB95URAP17054870000917,5/17/2016,12714.42,100001,Y,Rent,SAFARI,POS,Dr,15:06:06,20:51:41,11/30/2017,7057939,1111.8,5,"Cause place knowledge decide. Lay year act quite. Beautiful around two act such.
Mouth fire hear career explain put. Night task fire expert outside wife. Movie son record.",17:32:19,CARDS
AZVR85135161881683,GB95URAP17054870000917,5/17/2016,10820.16,100001,Y,Groceries,FF,POS,Dr,6:25:07,9:52:26,12/2/2017,30443907,1894.26,1,Keep few too care probably wear lay. Within itself fish whatever clear. Begin west minute just government change thought.,7:46:36,NEFT
AZVR85135161881683,GB95URAP17054870000917,5/17/2016,12714.42,100001,N,Credited,OPERA,MOBILE,Cr,11:35:16,16:58:59,12/2/2017,4576143,1894.26,4,"Rich white during degree dark hot. Interest thousand population child already cost beat finish.
Serious start within actually campaign tonight mission. Travel free parent hotel.",14:19:29,UPI
AZVR85135161881683,GB95URAP17054870000917,5/17/2016,10820.16,100001,Y,Personal Care,SAFARI,MOBILE,Dr,17:28:04,22:58:33,12/2/2017,34065990,1894.26,5,"Yes theory memory best leader message. Ago region ground church go six together. Speak recently firm before population.
Tend into agency cut process. Entire property oil policy.",20:13:44,CARDS
AZVR85135161881683,GB95URAP17054870000917,5/17/2016,9254.99,100001,Y,Insurance,SAFARI,MOBILE,Dr,6:20:52,12:09:18,12/12/2017,12266210,1565.17,3,"Especially describe right fact light. Rise only question night international.
Region traditional week surface. Never you speak writer. Here return indicate soldier.",9:16:00,RTGS
AZVR85135161881683,GB95URAP17054870000917,5/17/2016,10820.16,100001,N,Credited,MI,MOBILE,Cr,11:15:31,15:22:29,12/12/2017,14264603,1565.17,6,"By wife offer expect recent him many. Sort provide positive just.
Operation training less. Product end debate. Unit general particularly while international force.",13:44:22,CHEQUE
AZVR85135161881683,GB95URAP17054870000917,5/17/2016,12385.33,100001,N,Credited,OPERA,PC,Cr,22:02:03,25:35:39,12/12/2017,41229927,1565.17,6,"Name between store sea price. Real lose when generation nor live present ahead.
Place management ahead beautiful would goal. Discuss show remember. Apply civil early simple.",23:39:18,CHEQUE
AZVR85135161881683,GB95URAP17054870000917,5/17/2016,10746.13,100001,Y,Online Shopping,FF,MOBILE,Dr,9:47:06,13:23:32,12/13/2017,46437341,1639.2,6,"You issue position travel outside. Girl experience reveal human important blue huge. Stand smile baby daughter accept want.
Yes discuss around. Turn child kind employee.",10:28:35,CHEQUE
AZVR85135161881683,GB95URAP17054870000917,5/17/2016,9106.93,100001,Y,Personal Care,IE,MOBILE,Dr,12:34:44,16:45:56,12/13/2017,10284407,1639.2,7,"Nature material hope any process above. Beautiful determine home.
These card side support tree American administration. We yeah PM hair remain brother society. Next check share.",15:26:56,DD
AZVR85135161881683,GB95URAP17054870000917,5/17/2016,7467.73,100001,Y,Online Shopping,CHROME,MOBILE,Dr,17:32:54,20:56:50,12/13/2017,9204508,1639.2,2,"Discuss the realize son all ready per. Record federal information company vote.
Design recognize her simply debate. Computer on child.
Late population strategy party.",19:50:38,IMPS
AZVR85135161881683,GB95URAP17054870000917,5/17/2016,9069.62,100001,N,Credited,OPERA,MOBILE,Cr,7:41:05,11:41:50,12/19/2017,6352097,1601.89,5,Career also foreign through machine special after. According own keep name see almost author.,10:08:09,CARDS
AZVR85135161881683,GB95URAP17054870000917,5/17/2016,7467.73,100001,Y,Transportation,FF,POS,Dr,15:57:53,21:04:04,12/19/2017,67034536,1601.89,2,Art common this decision thousand television. Too interview process base so offer her. Teacher strong like about eight their.,19:16:10,IMPS
AZVR85135161881683,GB95URAP17054870000917,5/17/2016,7731.31,100001,N,Credited,FF,MOBILE,Cr,13:56:44,23:45:33,12/24/2017,54116863,263.58,5,Democratic late force likely yet television month. Rate system cost window. Arm late meet century despite.,18:55:26,CARDS
AZVR85135161881683,GB95URAP17054870000917,5/17/2016,7233.99,100001,Y,Rent,FF,MOBILE,Dr,5:43:45,10:38:41,12/27/2017,48280921,497.32,1,"Require soon page meeting check common deal. Possible series person glass benefit necessary remain.
Arm day idea laugh society interview want. Whom particularly street plan central standard realize.",8:39:32,NEFT
AZVR85135161881683,GB95URAP17054870000917,5/17/2016,7731.31,100001,N,Credited,FF,MOBILE,Cr,12:48:40,15:20:21,12/27/2017,53937261,497.32,1,"Look must turn month factor. Significant economic energy half section voice. College billion require tax art church truth.
Pull who particularly. Figure economic response receive.",14:07:38,NEFT
AZVR85135161881683,GB95URAP17054870000917,5/17/2016,7233.99,100001,Y,Insurance,MI,PC,Dr,17:40:43,22:39:07,12/27/2017,18611946,497.32,2,"Apply he article themselves since seat why. From month if similar.
Message figure as three base nothing. Mission expert until compare investment six general. Pull might executive his fall.",20:15:05,IMPS
AZVR85135161881683,GB95URAP17054870000917,5/17/2016,5941.88,100001,Y,Online Shopping,MI,PC,Dr,3:06:17,5:25:44,12/28/2017,59047124,1292.11,5,"Find forward world guess miss capital not.
Wrong factor expert peace carry. Life evening more today. Stop ever deep special himself event.",4:34:23,CARDS
AZVR85135161881683,GB95URAP17054870000917,5/17/2016,4649.77,100001,Y,Entertainment,EDGE,PC,Dr,9:31:31,12:21:07,12/28/2017,40371092,1292.11,3,"Girl city chair process design. Line get where arrive.
Day responsibility successful tell also. Letter indicate plant less class attack sort. Game town along bad expert.",10:28:54,RTGS
AZVR85135161881683,GB95URAP17054870000917,5/17/2016,3357.66,100001,Y,Groceries,SAFARI,POS,Dr,14:08:14,16:30:53,12/28/2017,95056296,1292.11,6,"Prevent drive north structure effort. Responsibility the article.
Series improve believe mind. Your young enough evening develop population white black.",14:57:19,CHEQUE
AZVR85135161881683,GB95URAP17054870000917,5/17/2016,2065.55,100001,Y,Groceries,OPERA,POS,Dr,16:40:38,18:34:30,12/28/2017,36678068,1292.11,3,Special region agency crime. Picture professional against once there sign.,18:07:42,RTGS
AZVR85135161881683,GB95URAP17054870000917,5/17/2016,773.44,100001,Y,Transportation,EDGE,POS,Dr,21:53:20,23:51:53,12/28/2017,47086715,1292.11,2,"So who director act miss. Recent speech attack leg. Kind base sister option site.
Official hear report then water. Others bed while wait authority she training.",22:31:39,IMPS
AZVR85135161881683,GB95URAP17054870000917,5/17/2016,2166.11,100001,N,Credited,MI,MOBILE,Cr,8:33:09,11:36:35,12/29/2017,99725990,1392.67,3,Research image effect stand concern owner. Simple player when majority choose culture. Impact discussion so environmental over.,10:20:23,RTGS
AZVR85135161881683,GB95URAP17054870000917,5/17/2016,773.44,100001,Y,Insurance,MI,POS,Dr,17:17:47,19:16:10,12/29/2017,40711300,1392.67,6,"Attention arrive wrong other line address. True fall population yourself try.
Wrong class industry poor attorney ball serious stuff. Find address avoid around available individual board suggest.",18:03:54,CHEQUE
AZVR85135161881683,GB95URAP17054870000917,5/17/2016,1115.46,100001,N,Credited,IE,POS,Cr,17:04:57,22:43:53,1/3/2018,56731491,342.02,7,Top green consider able middle social. Nor color determine population set everything generation. Significant popular guess hour.,19:34:34,DD
AZVR85135161881683,GB95URAP17054870000917,5/17/2016,1409.74,100001,N,Credited,FF,MOBILE,Cr,12:07:38,14:30:08,1/10/2018,15081872,294.28,4,Kitchen newspaper everything there Democrat. Movement senior example music bar we control population.,13:22:49,UPI
AZVR85135161881683,GB95URAP17054870000917,5/17/2016,1115.46,100001,Y,Utilities,MI,POS,Dr,18:18:58,23:03:16,1/10/2018,62991742,294.28,6,"Way listen anything team reduce throw though team. Kitchen model tax perform effort.
Until market tell population part. Lose mind scene film indicate strong. This baby better challenge.",20:57:47,CHEQUE
AZVR85135161881683,GB95URAP17054870000917,5/17/2016,3041.43,100001,N,Credited,CHROME,POS,Cr,15:33:01,21:33:47,1/11/2018,50076413,1925.97,4,"Per region marriage exist form. Her green together nearly ahead late. Not white interview debate news.
That room firm ability rate type. Process tough special line style federal.",17:40:08,UPI
AZVR85135161881683,GB95URAP17054870000917,5/17/2016,3633.41,100001,N,Credited,IE,MOBILE,Cr,3:56:34,7:09:29,1/17/2018,35495239,591.98,2,Operation such smile nation green left western. Believe ball husband thus realize. Moment short ability son policy power.,5:31:42,IMPS
AZVR85135161881683,GB95URAP17054870000917,5/17/2016,4225.39,100001,N,Credited,FF,MOBILE,Cr,10:43:17,12:52:34,1/17/2018,76125089,591.98,2,Game culture yourself store cut today form. Appear story total say since half. Hold card end will local fund buy.,11:12:12,IMPS
AZVR85135161881683,GB95URAP17054870000917,5/17/2016,4817.37,100001,N,Credited,EDGE,POS,Cr,13:09:23,16:46:42,1/17/2018,30496538,591.98,1,"The authority not go mother knowledge process.
Chance suggest boy successful raise fight. Seat middle national before recently. Consumer early always one message.",14:34:48,NEFT
AZVR85135161881683,GB95URAP17054870000917,5/17/2016,4225.39,100001,Y,Online Shopping,IE,POS,Dr,22:55:51,25:14:53,1/17/2018,59036470,591.98,6,Stay religious performance under popular. Herself money participant four create the four. Morning hot across number statement religious.,23:47:00,CHEQUE
AZVR85135161881683,GB95URAP17054870000917,5/17/2016,3434.52,100001,Y,Dining,SAFARI,MOBILE,Dr,5:27:29,8:06:08,1/19/2018,55010740,790.87,1,Name cover commercial they physical thank Mr. Space your charge benefit your however. Great term late generation final opportunity spend.,6:27:17,NEFT
AZVR85135161881683,GB95URAP17054870000917,5/17/2016,4225.39,100001,N,Credited,CHROME,PC,Cr,6:24:14,9:29:54,1/19/2018,29475230,790.87,5,Section meet long green. Quite let like practice range main common. Certainly go concern ahead home fine leg.,8:07:35,CARDS
AZVR85135161881683,GB95URAP17054870000917,5/17/2016,3434.52,100001,Y,Transportation,FF,PC,Dr,13:33:01,15:16:00,1/19/2018,56273397,790.87,6,"Finish deal friend. Suggest travel stay particular building.
Director sort attack now team. Forget develop reality moment commercial sometimes expert.",14:35:10,CHEQUE
AZVR85135161881683,GB95URAP17054870000917,5/17/2016,4225.39,100001,N,Credited,CHROME,POS,Cr,16:41:26,19:30:41,1/19/2018,95874852,790.87,1,Drive start poor visit section kid lay. All blood positive important during. Class far learn sell better however their.,18:05:52,NEFT
AZVR85135161881683,GB95URAP17054870000917,5/17/2016,5016.26,100001,N,Credited,FF,POS,Cr,22:33:12,24:52:44,1/19/2018,52079313,790.87,7,"Likely play adult personal effect. Party address notice phone. Themselves lot read friend truth society.
Prevent win story bring trade.
War executive environment beyond. Worker serve across budget.",23:43:31,DD
AZVR85135161881683,GB95URAP17054870000917,5/17/2016,3231.99,100001,Y,Entertainment,CHROME,PC,Dr,12:58:36,17:41:44,1/20/2018,92535077,1784.27,2,"Tv character represent local long economy. Computer whether natural factor.
They light yeah alone wish. Which find music some model kind table player. Red exist resource quite face.",14:55:44,IMPS
AZVR85135161881683,GB95URAP17054870000917,5/17/2016,5016.26,100001,N,Credited,SAFARI,POS,Cr,17:29:50,23:13:07,1/20/2018,35515623,1784.27,6,Last wall billion picture fear. Pay home feel job.,20:45:42,CHEQUE
AZVR85135161881683,GB95URAP17054870000917,5/17/2016,5517.47,100001,N,Credited,MI,POS,Cr,16:09:08,25:31:47,1/23/2018,25514872,501.21,1,Little company though dog choice own. History kitchen avoid talk road kind. Both event surface respond eye effect most. Paper black bar letter section fill.,19:40:00,NEFT
AZVR85135161881683,GB95URAP17054870000917,5/17/2016,5726.09,100001,N,Credited,MI,PC,Cr,10:09:04,16:56:25,2/7/2018,27092484,208.62,4,Interview say catch student field. Expert worker determine our special myself run. Media people music poor thank thank natural.,14:02:51,UPI
AZVR85135161881683,GB95URAP17054870000917,5/17/2016,7363.94,100001,N,Credited,FF,POS,Cr,3:15:34,4:56:38,2/8/2018,5056767,1637.85,4,"Lawyer rest high soon war treatment modern. Test place hundred possible fear foreign benefit.
Culture newspaper development wall this movie purpose. Mouth school size provide say.",4:09:53,UPI
AZVR85135161881683,GB95URAP17054870000917,5/17/2016,5726.09,100001,Y,Rent,OPERA,POS,Dr,10:08:51,12:33:30,2/8/2018,2192017,1637.85,5,"Leader cell maybe once. Area word practice arm trial realize whether role.
Impact simply much sister TV. With community first door teach. After impact couple debate. Information use perhaps theory.",11:45:14,CARDS
AZVR85135161881683,GB95URAP17054870000917,5/17/2016,7363.94,100001,N,Credited,FF,PC,Cr,10:28:17,13:51:19,2/8/2018,9297852,1637.85,4,"Hotel win budget. Writer ever game understand fight.
Community data far look. Between behind difference task civil Congress. Son about along degree loss how respond unit.",12:08:33,UPI
AZVR85135161881683,GB95URAP17054870000917,5/17/2016,9001.79,100001,N,Credited,FF,POS,Cr,16:19:26,17:59:16,2/8/2018,58839157,1637.85,4,"Lay smile ok huge. Tonight behind group indicate. Detail professor particularly space.
Forget suffer effort again or better subject. Safe until only. Reveal represent discuss nearly account.",17:33:21,UPI
AZVR85135161881683,GB95URAP17054870000917,5/17/2016,10639.64,100001,N,Credited,MI,PC,Cr,22:51:51,24:13:05,2/8/2018,70097177,1637.85,2,"Land break environment member. Sometimes year article onto authority agree action nearly.
Issue reality remain performance everybody however memory degree. Claim say other way.",23:36:20,IMPS
AZVR85135161881683,GB95URAP17054870000917,5/17/2016,11770.67,100001,N,Credited,CHROME,MOBILE,Cr,4:55:52,8:34:59,2/22/2018,38486142,1131.03,6,"Air third meeting modern miss. Reach parent information occur place.
Face role along hot person. Fact window write movement political.",6:51:29,CHEQUE
AZVR85135161881683,GB95URAP17054870000917,5/17/2016,10639.64,100001,Y,Transportation,IE,PC,Dr,7:55:38,10:14:03,2/22/2018,16563926,1131.03,1,"Success air middle friend. Kitchen energy coach tonight if fly student. Appear week popular believe poor style.
Business human walk who food. Force experience great those often then.",8:33:20,NEFT
AZVR85135161881683,GB95URAP17054870000917,5/17/2016,11770.67,100001,N,Credited,EDGE,PC,Cr,11:17:55,12:44:27,2/22/2018,35835561,1131.03,4,"Idea TV within son stay. Side dog technology environmental. Traditional finally rather number certainly.
Stand think the unit expert drug. Nothing team commercial power nature appear some indicate.",12:14:39,UPI
AZVR85135161881683,GB95URAP17054870000917,5/17/2016,12901.7,100001,N,Credited,OPERA,MOBILE,Cr,17:00:21,18:33:47,2/22/2018,56237955,1131.03,7,"Part marriage themselves story interest. Their news environmental inside. Friend success join wind.
Admit recently word skin. Town laugh ask forward.",17:38:28,DD
AZVR85135161881683,GB95URAP17054870000917,5/17/2016,11770.67,100001,Y,Rent,SAFARI,POS,Dr,20:24:34,23:27:29,2/22/2018,17360838,1131.03,2,Past cover government catch according most pay. Such another drop get send move. Pull lawyer player community.,21:50:50,IMPS
AZVR85135161881683,GB95URAP17054870000917,5/17/2016,11209.27,100001,Y,Insurance,FF,POS,Dr,6:23:29,8:15:38,2/26/2018,34544518,561.4,5,Cost between yeah enjoy. Religious of you lawyer bar turn. Sometimes true friend item when hear herself.,7:12:09,CARDS
AZVR85135161881683,GB95URAP17054870000917,5/17/2016,11770.67,100001,N,Credited,EDGE,MOBILE,Cr,9:04:04,11:27:13,2/26/2018,16584037,561.4,4,"Series hundred popular seem detail few fire. Drop wind health set same will. Few final music. Dog face your various girl team.
Environmental serious particular including direction positive or.",10:52:36,UPI
AZVR85135161881683,GB95URAP17054870000917,5/17/2016,12332.07,100001,N,Credited,OPERA,POS,Cr,13:22:29,16:19:36,2/26/2018,77027023,561.4,6,View so simple clear. Series positive forward moment. Want either meet event.,15:09:49,CHEQUE
AZVR85135161881683,GB95URAP17054870000917,5/17/2016,11770.67,100001,Y,Dining,FF,MOBILE,Dr,17:08:48,19:56:27,2/26/2018,66074854,561.4,4,"Ten system for matter prepare truth. Likely defense record employee.
Keep west difference hotel than. Mind suffer remain information. Unit travel resource respond.",18:36:15,UPI
AZVR85135161881683,GB95URAP17054870000917,5/17/2016,11209.27,100001,Y,Insurance,IE,PC,Dr,18:43:23,22:08:44,2/26/2018,35874577,561.4,6,Special than dark baby. Each go bring section good decide individual.,20:12:32,CHEQUE
AZVR85135161881683,GB95URAP17054870000917,5/17/2016,11500.29,100001,N,Credited,FF,POS,Cr,8:32:54,12:32:16,3/20/2018,55927185,291.02,6,"Owner these bit pattern. Course model democratic win oil final.
Story teach race article message ahead generation. Risk miss I money consider look actually body. Design fear trade improve nice own.",10:00:55,CHEQUE
AZVR85135161881683,GB95URAP17054870000917,5/17/2016,11791.31,100001,N,Credited,CHROME,MOBILE,Cr,14:49:01,19:24:09,3/20/2018,40704227,291.02,3,"Discover people conference culture camera. Race nature return year social financial hand according.
Truth analysis whom investment bed later event. Seat close believe.",16:50:03,RTGS
AZVR85135161881683,GB95URAP17054870000917,5/17/2016,11500.29,100001,Y,Transportation,FF,MOBILE,Dr,17:17:29,21:31:56,3/20/2018,58365434,291.02,5,"Involve event nearly hard less. Arm kitchen onto theory young lead. Individual next buy drug be.
Reflect chair necessary somebody. Record product expect alone very hard.",18:50:39,CARDS
AZVR85135161881683,GB95URAP17054870000917,5/17/2016,12583.81,100001,N,Credited,SAFARI,POS,Cr,6:12:02,10:13:34,3/21/2018,19190211,1083.52,3,"Another age very reduce role perform task. Cover speech south condition station or compare.
Daughter minute writer. Majority theory agent describe group.",8:35:03,RTGS
AZVR85135161881683,GB95URAP17054870000917,5/17/2016,13667.33,100001,N,Credited,SAFARI,POS,Cr,10:56:56,13:36:07,3/21/2018,18421262,1083.52,1,"Lot seven compare word degree authority interview seat. Likely off church response take. Get history today level customer.
Growth develop couple campaign. Process plan part account political.",12:27:11,NEFT
AZVR85135161881683,GB95URAP17054870000917,5/17/2016,12583.81,100001,Y,Transportation,MI,MOBILE,Dr,17:50:30,20:55:45,3/21/2018,74879267,1083.52,7,Full stand give. Attorney wonder consider forward. Before black try security. Hundred support instead under medical radio same poor.,18:59:26,DD
AZVR85135161881683,GB95URAP17054870000917,5/17/2016,13667.33,100001,N,Credited,CHROME,POS,Cr,19:40:57,22:23:19,3/21/2018,91412089,1083.52,6,"Their central reveal customer return while. Hair accept fill reach purpose few resource.
More again understand official writer involve from. Cup matter recent different reality region response.",21:17:28,CHEQUE
AZVR85135161881683,GB95URAP17054870000917,5/17/2016,13920.79,100001,N,Credited,EDGE,PC,Cr,9:13:13,14:05:01,3/22/2018,61956629,253.46,4,"People fish hold dinner. Goal article particularly fish evening around wide behavior.
Attack where late event according conference. Team true every.",11:38:50,UPI
AZVR85135161881683,GB95URAP17054870000917,5/17/2016,14174.25,100001,N,Credited,IE,PC,Cr,10:24:07,14:49:09,3/22/2018,35112297,253.46,5,During fear response outside manage. Over sport on fast value me. Fight trade example.,13:12:28,CARDS
AZVR85135161881683,GB95URAP17054870000917,5/17/2016,14427.71,100001,N,Credited,CHROME,PC,Cr,16:12:43,21:29:59,3/22/2018,26109848,253.46,6,"Trouble together serious skin day. Beat network reason edge could see food color.
Politics standard term black TV cost light appear. Show couple finish not.",18:45:55,CHEQUE
AZVR85135161881683,GB95URAP17054870000917,5/17/2016,13947.15,100001,Y,Rent,CHROME,PC,Dr,7:05:22,11:58:22,3/24/2018,9968714,480.56,5,"Sister he system source music cost direction.
Eye garden enough hotel positive research. Finally letter pressure.
Prepare employee world structure toward action. Film bill trouble fill would.",10:15:48,CARDS
AZVR85135161881683,GB95URAP17054870000917,5/17/2016,13466.59,100001,Y,Personal Care,SAFARI,MOBILE,Dr,20:39:21,24:25:12,3/24/2018,79107419,480.56,4,Together four world like away industry own. Subject act effect try fund newspaper visit. Best task six run. Type hear theory run best effect.,23:01:26,UPI
AZVR85135161881683,GB95URAP17054870000917,5/17/2016,11747.24,100001,Y,Online Shopping,CHROME,POS,Dr,10:24:50,14:52:02,3/26/2018,4925729,1719.35,3,"Simply memory officer. Week day each thus I sure many. Receive allow alone truth.
Newspaper read forget least lead home. Force per away dog.",13:16:55,RTGS
AZVR85135161881683,GB95URAP17054870000917,5/17/2016,12103.32,100001,N,Credited,CHROME,PC,Cr,7:15:46,10:24:49,3/27/2018,42328025,356.08,2,"Final area run defense. Include know cultural control.
Guess trouble century experience figure quality seat. Campaign time subject test. Force pay foot either. Manage position general mean.",9:31:32,IMPS
AZVR85135161881683,GB95URAP17054870000917,5/17/2016,12459.4,100001,N,Credited,MI,POS,Cr,14:30:08,18:25:45,3/27/2018,46980502,356.08,3,"Time tax also.
Son build build five along hard. Tell effect phone identify west.
Debate need central. Arm reality crime project past at. Image reveal record special both federal.",16:22:58,RTGS
AZVR85135161881683,GB95URAP17054870000917,5/17/2016,14077.77,100001,N,Credited,MI,POS,Cr,12:18:11,16:53:56,3/28/2018,19666709,1618.37,2,"Rate ground international economy study think reality. Blue medical state weight perform.
To head now raise her write. Seek together price upon forget study really.",13:46:22,IMPS
AZVR85135161881683,GB95URAP17054870000917,5/17/2016,12459.4,100001,Y,Utilities,IE,MOBILE,Dr,16:00:08,21:35:37,3/28/2018,7327131,1618.37,7,Effort field whether under community. Course military know guess beyond time role. Partner win throw world.,18:56:21,DD
AZVR85135161881683,GB95URAP17054870000917,5/17/2016,13165.64,100001,N,Credited,IE,MOBILE,Cr,6:39:01,10:04:43,4/3/2018,70401721,706.24,1,"Morning particular standard cost. Behavior provide practice southern. Important Democrat girl itself.
Interesting pattern girl structure sell cover. Challenge condition realize.",9:08:40,NEFT
AZVR85135161881683,GB95URAP17054870000917,5/17/2016,13871.88,100001,N,Credited,IE,MOBILE,Cr,11:47:05,15:15:01,4/3/2018,19534671,706.24,7,"Her onto strategy same case drop open wrong. Run rock none choice.
Risk skill economy seven as. Street line agency above. Star less north.",12:29:24,DD
AZVR85135161881683,GB95URAP17054870000917,5/17/2016,14578.12,100001,N,Credited,SAFARI,PC,Cr,19:52:13,22:56:06,4/3/2018,28185796,706.24,2,Including rather difference should. Industry usually store moment smile. Garden series move page. Participant politics attention score.,21:41:56,IMPS
AZVR85135161881683,GB95URAP17054870000917,5/17/2016,16251.94,100001,N,Credited,FF,POS,Cr,6:26:59,10:02:11,4/7/2018,63210,1673.82,6,"Blue once raise picture town outside go.
Social name work. Minute teach evening Mr recently.
Trial feeling country buy. Your fire party parent threat decide range.",8:09:25,CHEQUE
AZVR85135161881683,GB95URAP17054870000917,5/17/2016,14578.12,100001,Y,Online Shopping,EDGE,PC,Dr,13:07:05,17:05:10,4/7/2018,48552974,1673.82,7,Structure already property international church continue. Blood artist go skill lose work.,15:38:04,DD
AZVR85135161881683,GB95URAP17054870000917,5/17/2016,12904.3,100001,Y,Insurance,IE,PC,Dr,16:41:47,21:29:09,4/7/2018,44534820,1673.82,6,"Leave citizen serious plan.
Education national all Democrat send natural task. Huge because morning most likely can what.",19:02:07,CHEQUE
AZVR85135161881683,GB95URAP17054870000917,5/17/2016,13776.55,100001,N,Credited,EDGE,PC,Cr,6:03:27,8:26:51,4/10/2018,10950043,872.25,2,"Might age quickly local. Campaign growth president former.
Require section inside skin create mouth. Everybody everybody however soldier. Increase hot force mouth go few result.",7:29:59,IMPS
AZVR85135161881683,GB95URAP17054870000917,5/17/2016,12904.3,100001,Y,Dining,OPERA,PC,Dr,10:26:14,13:18:38,4/10/2018,81926022,872.25,5,"Capital force lawyer each heart. Just act four every parent family material. Test edge up teach.
Age certainly ready detail strategy under. Peace candidate perform lawyer carry trade while.",12:46:12,CARDS
AZVR85135161881683,GB95URAP17054870000917,5/17/2016,12032.05,100001,Y,Rent,SAFARI,POS,Dr,15:32:40,17:20:38,4/10/2018,90490071,872.25,7,"Apply born occur into man myself. Dark office fast commercial start cup. Reduce this around avoid.
Away choose building. Less myself develop. Story room simply.",16:15:42,DD
AZVR85135161881683,GB95URAP17054870000917,5/17/2016,11159.8,100001,Y,Groceries,IE,PC,Dr,18:52:20,22:06:06,4/10/2018,16491328,872.25,7,"Media far add rate such to.
But per because student five either. Attack as yeah mean. More including she forget cultural.",20:45:58,DD
AZVR85135161881683,GB95URAP17054870000917,5/17/2016,10440.52,100001,Y,Utilities,EDGE,MOBILE,Dr,7:23:43,10:59:36,4/13/2018,989039,719.28,4,"Price factor skill head professor. Which summer minute style present economic. Student my project new them oil against begin.
Team shoulder line control student society.",9:24:09,UPI
AZVR85135161881683,GB95URAP17054870000917,5/17/2016,9721.24,100001,Y,Rent,IE,MOBILE,Dr,12:36:33,16:17:05,4/13/2018,16910195,719.28,3,"Drug plant fish can plant data.
Owner friend and rock finally. Rate manage design blue pretty.",14:04:34,RTGS
AZVR85135161881683,GB95URAP17054870000917,5/17/2016,9001.96,100001,Y,Dining,MI,PC,Dr,17:14:12,19:51:28,4/13/2018,72993149,719.28,7,Read bank account western four concern yet. Say officer care style physical. Soon tough everybody expect myself development. Senior know carry president.,18:28:30,DD
AZVR85135161881683,GB95URAP17054870000917,5/17/2016,9721.24,100001,N,Credited,MI,MOBILE,Cr,21:00:10,23:37:46,4/13/2018,83365911,719.28,2,Us similar already including food. Amount scene work carry drive natural know of. Kind turn politics service too.,22:37:03,IMPS
AZVR85135161881683,GB95URAP17054870000917,5/17/2016,7850.69,100001,Y,Entertainment,EDGE,POS,Dr,5:46:38,8:34:04,4/14/2018,84256775,1870.55,3,White focus son. Fly detail television stop appear right. Check film right office least.,7:08:36,RTGS
AZVR85135161881683,GB95URAP17054870000917,5/17/2016,5980.14,100001,Y,Entertainment,FF,POS,Dr,7:54:29,10:46:29,4/14/2018,36939374,1870.55,2,Conference girl able protect. Project available clear marriage hair attorney officer. Movement late around room create option often.,9:03:17,IMPS
AZVR85135161881683,GB95URAP17054870000917,5/17/2016,4109.59,100001,Y,Groceries,FF,PC,Dr,11:43:59,12:53:46,4/14/2018,19731940,1870.55,2,"Style give bring south hundred air. Yourself later growth tell.
I top may. Eight talk which look water human brother.",12:12:06,IMPS
AZVR85135161881683,GB95URAP17054870000917,5/17/2016,5980.14,100001,N,Credited,MI,PC,Cr,17:05:59,19:14:30,4/14/2018,91536310,1870.55,6,"Hospital administration church right. End research conference use. Other hot many.
Live realize easy plant let away. Space hear cell. Out part book case knowledge room.",17:47:21,CHEQUE
AZVR85135161881683,GB95URAP17054870000917,5/17/2016,7850.69,100001,N,Credited,IE,MOBILE,Cr,22:33:40,23:56:43,4/14/2018,2626468,1870.55,2,"Remain maybe price beat responsibility he. Film table Democrat Mr.
Community if traditional cup difference. Beyond day step save. Southern music attorney civil.",23:22:39,IMPS
AZVR85135161881683,GB95URAP17054870000917,5/17/2016,7362.04,100001,Y,Entertainment,FF,PC,Dr,7:13:11,9:33:03,4/15/2018,14960420,488.65,5,At follow talk. Education by brother into. Adult light movement really good everything.,8:27:45,CARDS
AZVR85135161881683,GB95URAP17054870000917,5/17/2016,7850.69,100001,N,Credited,MI,MOBILE,Cr,13:08:28,15:30:49,4/15/2018,62155311,488.65,4,Sort relate chair sort until fill anyone. Enough see at our weight rich yes team.,14:04:01,UPI
AZVR85135161881683,GB95URAP17054870000917,5/17/2016,8339.34,100001,N,Credited,IE,PC,Cr,15:15:08,17:10:22,4/15/2018,21595370,488.65,6,"Set any available issue under lose indeed. Talk your within machine really over.
Possible kitchen environment detail house report. Glass fly at include care join.",16:08:04,CHEQUE
AZVR85135161881683,GB95URAP17054870000917,5/17/2016,7850.69,100001,Y,Insurance,IE,POS,Dr,22:07:58,25:04:17,4/15/2018,22090553,488.65,1,"Support one any customer expect. Believe blue light probably watch. Nothing watch other if leg guy.
Professor detail art. Together simple everybody explain marriage better fire.",22:52:16,NEFT
AZVR85135161881683,GB95URAP17054870000917,5/17/2016,8705.74,100001,N,Credited,MI,MOBILE,Cr,15:39:05,25:17:19,4/17/2018,58110454,855.05,5,"Modern must area seem manager about would. Tax during series.
Probably build up boy according. Maybe tree son modern billion but try.",19:19:00,CARDS
AZVR85135161881683,GB95URAP17054870000917,5/17/2016,9885.95,100001,N,Credited,FF,PC,Cr,18:59:53,27:41:02,5/20/2018,22988638,1180.21,5,Way chair media quality. Him product mention technology the friend. Stage general see main stock.,21:44:09,CARDS
AZVR85135161881683,GB95URAP17054870000917,5/17/2016,11734.17,100001,N,Credited,MI,PC,Cr,7:25:38,10:32:13,5/21/2018,12994274,1848.22,1,"Would administration free industry fine form maintain. Who serious over away.
Hospital agent summer summer subject keep yard. Send sign environmental enjoy could.",8:29:44,NEFT
AZVR85135161881683,GB95URAP17054870000917,5/17/2016,13582.39,100001,N,Credited,EDGE,PC,Cr,15:19:44,20:22:36,5/21/2018,20217556,1848.22,6,"Other reflect become yard same ten. Parent Republican and strong.
International few magazine give whatever fire hope. Red interview glass concern deep as fact. Notice scientist war occur.",17:27:30,CHEQUE
AZVR85135161881683,GB95URAP17054870000917,5/17/2016,11734.17,100001,Y,Dining,FF,PC,Dr,16:39:12,20:14:08,5/21/2018,56102802,1848.22,3,Information sign tell toward method. Break their outside dream action. Notice Congress person serious face political.,18:18:34,RTGS
AZVR85135161881683,GB95URAP17054870000917,5/17/2016,11159.87,100001,Y,Groceries,IE,MOBILE,Dr,3:30:56,5:48:20,5/23/2018,59855088,574.3,1,Likely card write entire military. Candidate might commercial modern son student sea left. Unit with school wall wish need offer.,4:50:21,NEFT
AZVR85135161881683,GB95URAP17054870000917,5/17/2016,10585.57,100001,Y,Insurance,OPERA,POS,Dr,8:26:21,10:01:42,5/23/2018,40704975,574.3,7,His all prove memory. Among far add far community store nation need. Statement government market yet.,9:19:29,DD
AZVR85135161881683,GB95URAP17054870000917,5/17/2016,11159.87,100001,N,Credited,OPERA,PC,Cr,12:40:06,14:22:33,5/23/2018,43359936,574.3,2,But those notice art let road tonight. With tonight director operation ability world successful author. Eat spend even hard customer medical past.,13:51:44,IMPS
AZVR85135161881683,GB95URAP17054870000917,5/17/2016,10585.57,100001,Y,Personal Care,CHROME,POS,Dr,16:12:43,19:32:24,5/23/2018,92617018,574.3,3,Approach table parent economy church better onto skin. Develop treatment whether without cost hope cause international. Its common stop artist now subject energy gun.,17:40:00,RTGS
AZVR85135161881683,GB95URAP17054870000917,5/17/2016,10011.27,100001,Y,Rent,MI,MOBILE,Dr,19:47:40,21:13:39,5/23/2018,23165779,574.3,2,Will within page fly answer foreign. Son help happy party. Beautiful position those true enough soon successful. Own write hit build assume.,20:29:31,IMPS
AZVR85135161881683,GB95URAP17054870000917,5/17/2016,11478.41,100001,N,Credited,OPERA,PC,Cr,6:47:39,9:31:30,5/27/2018,8430045,1467.14,1,"High reduce next room floor technology cause understand. Cause upon step new.
Reach company note state. Entire institution here book compare girl my.",7:53:16,NEFT
AZVR85135161881683,GB95URAP17054870000917,5/17/2016,10011.27,100001,Y,Personal Care,FF,PC,Dr,13:30:43,17:03:07,5/27/2018,9718555,1467.14,4,From guess total best. Perhaps the bar party film above fund. To admit land sport big perform.,15:44:46,UPI
AZVR85135161881683,GB95URAP17054870000917,5/17/2016,8544.13,100001,Y,Medicals,CHROME,MOBILE,Dr,19:24:33,22:23:01,5/27/2018,61704008,1467.14,1,Less sit return sense keep if performance. Perhaps build anyone party audience perform daughter. Arrive apply say system.,20:54:14,NEFT
AZVR85135161881683,GB95URAP17054870000917,5/17/2016,8706.19,100001,N,Credited,SAFARI,POS,Cr,8:10:40,10:54:40,6/4/2018,12744534,162.06,5,World structure building role natural also wonder history. Deep far development star in cultural already surface. Interest sometimes top next.,9:31:51,CARDS
AZVR85135161881683,GB95URAP17054870000917,5/17/2016,8868.25,100001,N,Credited,CHROME,MOBILE,Cr,14:48:23,20:32:43,6/4/2018,75817688,162.06,6,Leave cultural cost green experience medical. Appear bar themselves artist day only. Thus administration event recent meeting.,17:43:23,CHEQUE
AZVR85135161881683,GB95URAP17054870000917,5/17/2016,8706.19,100001,Y,Personal Care,CHROME,PC,Dr,21:37:54,24:24:47,6/4/2018,43013340,162.06,3,"Teacher per season themselves future.
Understand standard than professional main. Hope staff former real commercial. Series main performance.",23:12:56,RTGS
AZVR85135161881683,GB95URAP17054870000917,5/17/2016,8690.46,100001,Y,Personal Care,SAFARI,POS,Dr,6:14:24,8:28:39,6/9/2018,29465675,15.73,3,Arrive skill answer dark. Listen whether safe important maintain. News art leader get social near.,7:14:20,RTGS
AZVR85135161881683,GB95URAP17054870000917,5/17/2016,8706.19,100001,N,Credited,CHROME,PC,Cr,11:35:07,13:07:56,6/9/2018,15904751,15.73,1,"Town institution very wife.
Dark management hand action study red. Trial election after similar score movement.",12:31:04,NEFT
AZVR85135161881683,GB95URAP17054870000917,5/17/2016,8690.46,100001,Y,Groceries,IE,MOBILE,Dr,15:55:27,18:27:14,6/9/2018,8156204,15.73,5,"Soon effect business newspaper there character. General ground smile safe according scientist list.
Trial the buy development so black. Approach power surface weight.",16:43:24,CARDS
AZVR85135161881683,GB95URAP17054870000917,5/17/2016,8674.73,100001,Y,Insurance,CHROME,PC,Dr,21:53:41,24:22:34,6/9/2018,79808729,15.73,3,"City cut remember try help manager. Stop media than prove will. Material continue physical region current.
Through step southern rich which just. Front individual glass down.",23:38:54,RTGS
AZVR85135161881683,GB95URAP17054870000917,5/17/2016,7637.35,100001,Y,Insurance,CHROME,PC,Dr,8:35:11,12:55:27,6/10/2018,62982054,1037.38,7,"Well trip bag imagine push management whatever. Year list manager find education sell. Movie under too leave education.
Authority rate capital ever relationship own almost. Five have service.",11:44:59,DD
AZVR85135161881683,GB95URAP17054870000917,5/17/2016,6599.97,100001,Y,Utilities,FF,PC,Dr,22:44:50,26:43:10,6/10/2018,13223304,1037.38,1,Shake have show plant ground respond time. Agency quickly base investment moment possible. Control dinner party pattern head very.,23:49:04,NEFT
AZVR85135161881683,GB95URAP17054870000917,5/17/2016,7406.07,100001,N,Credited,CHROME,POS,Cr,11:13:47,17:44:24,6/21/2018,26642642,806.1,3,"Responsibility close institution everyone arm. Foreign second main create than wish ground.
Not he put then per. Decade reflect start free consumer fund.",14:22:23,RTGS
AZVR85135161881683,GB95URAP17054870000917,5/17/2016,8212.17,100001,N,Credited,CHROME,PC,Cr,20:59:55,24:25:54,6/21/2018,94086010,806.1,4,Because action look community production pull plan. Become program mention national week. Join customer interesting spring.,22:52:20,UPI
AZVR85135161881683,GB95URAP17054870000917,5/17/2016,6740.37,100001,Y,Personal Care,MI,MOBILE,Dr,19:03:46,22:32:15,6/22/2018,11966357,1471.8,2,"Name wear address form per professional. Serve art subject cup. Truth story join either find.
Believe analysis condition season. Born character management must.",21:07:14,IMPS
AZVR85135161881683,GB95URAP17054870000917,5/17/2016,7193.95,100001,N,Credited,OPERA,POS,Cr,15:08:55,24:18:12,7/5/2018,71550688,453.58,1,Certainly tree energy throughout. Yes you religious anyone age support.,21:00:41,NEFT
AZVR85135161881683,GB95URAP17054870000917,5/17/2016,9031.56,100001,N,Credited,FF,POS,Cr,18:46:29,27:06:33,7/7/2018,41814970,1837.61,4,Bit western word reflect. Spend wish always son find than. Lay wrong experience once likely provide sort.,23:59:56,UPI
AZVR85135161881683,GB95URAP17054870000917,5/17/2016,7680.16,100001,Y,Groceries,CHROME,POS,Dr,6:34:31,10:44:50,7/8/2018,99188344,1351.4,2,"Stage information station cover clear. Nice keep group art.
Seek maintain recent prepare. Sense good treatment.",8:32:20,IMPS
AZVR85135161881683,GB95URAP17054870000917,5/17/2016,9031.56,100001,N,Credited,OPERA,MOBILE,Cr,14:32:10,17:49:48,7/8/2018,22437808,1351.4,1,Happen dog seek either its staff. Third example production experience human. Make eat man value.,16:11:25,NEFT
AZVR85135161881683,GB95URAP17054870000917,5/17/2016,7680.16,100001,Y,Utilities,IE,MOBILE,Dr,18:00:43,21:35:48,7/8/2018,95695990,1351.4,1,"On imagine good some dream. Conference inside agency move big space. Floor present say business bag card.
Able society test ask decade. Drive chance according strategy score watch eye.",19:00:04,NEFT
AZVR85135161881683,GB95URAP17054870000917,5/17/2016,6103.98,100001,Y,Transportation,FF,PC,Dr,8:05:34,11:52:17,7/22/2018,26135922,1576.18,3,Middle subject listen member second later hot. Management be very road nothing pretty huge. Low figure once wrong statement.,10:19:37,RTGS
AZVR85135161881683,GB95URAP17054870000917,5/17/2016,4527.8,100001,Y,Household Consumables,IE,MOBILE,Dr,15:46:01,20:10:40,7/22/2018,96937617,1576.18,2,"Instead play model plant know price gas know. Meet voice surface different pretty.
Ability simply ago become toward decide series. Song home including.",17:44:24,IMPS
AZVR85135161881683,GB95URAP17054870000917,5/17/2016,6103.98,100001,N,Credited,MI,PC,Cr,16:56:24,21:27:13,7/22/2018,24158251,1576.18,7,Responsibility wall put beat. Late network three sit these must get. Reflect board floor else. Single radio director article the back.,18:36:09,DD
AZVR85135161881683,GB95URAP17054870000917,5/17/2016,4759.19,100001,Y,Household Consumables,FF,POS,Dr,6:57:09,8:32:47,8/18/2018,10909638,1344.79,4,"Unit range receive its sound consider positive. Relate dream authority service.
Federal similar public west. Bring store owner think.",7:38:16,UPI
AZVR85135161881683,GB95URAP17054870000917,5/17/2016,6103.98,100001,N,Credited,EDGE,MOBILE,Cr,11:24:52,14:42:38,8/18/2018,28585435,1344.79,1,"Family floor easy senior. Upon continue century work guess heavy.
Player trade billion employee dark sense. Official eat hair describe be produce.",13:48:10,NEFT
AZVR85135161881683,GB95URAP17054870000917,5/17/2016,7448.77,100001,N,Credited,EDGE,MOBILE,Cr,15:10:37,18:39:21,8/18/2018,11961949,1344.79,6,"Such sort PM member property draw each. Health evening physical hotel detail real recently.
Name kid fill couple response. Start loss even expert. Since power health commercial.",17:06:15,CHEQUE
AZVR85135161881683,GB95URAP17054870000917,5/17/2016,6103.98,100001,Y,Household Consumables,FF,POS,Dr,21:07:29,24:57:28,8/18/2018,58851036,1344.79,1,"Arm not staff. American be exist film way she trade have.
Prevent key product hold I either. Put share attention law big too option development.",22:59:59,NEFT
AZVR85135161881683,GB95URAP17054870000917,5/17/2016,6412.02,100001,N,Credited,FF,POS,Cr,6:54:34,12:20:05,8/23/2018,36436651,308.04,6,Investment candidate almost Mr this memory. Full believe perhaps watch thing company.,8:55:34,CHEQUE
AZVR85135161881683,GB95URAP17054870000917,5/17/2016,6720.06,100001,N,Credited,IE,POS,Cr,13:27:27,19:16:17,8/23/2018,81453009,308.04,3,Season wish statement. Reduce thus if them kind attention force everybody.,17:14:37,RTGS
AZVR85135161881683,GB95URAP17054870000917,5/17/2016,6853.64,100001,N,Credited,CHROME,MOBILE,Cr,6:41:18,9:47:14,9/3/2018,90787836,133.58,7,"Form enough agent. Factor whose star Congress a field drop seek. Way decision trouble require guess.
A total past reflect. Build require series break.",8:37:17,DD
AZVR85135161881683,GB95URAP17054870000917,5/17/2016,6720.06,100001,Y,Utilities,EDGE,POS,Dr,14:13:30,16:24:03,9/3/2018,72121405,133.58,2,"Resource argue operation now. Share join similar glass quickly.
Already piece for important painting return could. Walk red memory build.",15:03:00,IMPS
AZVR85135161881683,GB95URAP17054870000917,5/17/2016,6853.64,100001,N,Credited,SAFARI,POS,Cr,17:34:47,21:12:23,9/3/2018,73175186,133.58,7,"Back high from provide commercial. Staff painting forward wind media you fire.
National think begin less performance. Evening high third increase majority.",20:32:40,DD
AZVR85135161881683,GB95URAP17054870000917,5/17/2016,8031.61,100001,N,Credited,MI,MOBILE,Cr,5:06:19,8:31:34,9/5/2018,77290526,1177.97,2,"Study set question.
Course early activity protect. Hotel star police plant nature pattern author. Degree perhaps glass loss store direction.",7:16:33,IMPS
AZVR85135161881683,GB95URAP17054870000917,5/17/2016,9209.58,100001,N,Credited,MI,POS,Cr,11:55:14,17:36:29,9/5/2018,80148784,1177.97,3,"Network interview north choose financial everybody. Citizen someone general sit.
Act fast hundred point. Bag activity capital value.",14:46:06,RTGS
AZVR85135161881683,GB95URAP17054870000917,5/17/2016,8031.61,100001,Y,Entertainment,IE,PC,Dr,17:56:32,20:33:52,9/5/2018,45339158,1177.97,4,"Coach all will network determine suddenly staff indeed. Board town everything majority experience next. Medical you size human very.
Top hope culture expert fall fire. War design control.",19:05:32,UPI
AZVR85135161881683,GB95URAP17054870000917,5/17/2016,7886.99,100001,Y,Insurance,IE,PC,Dr,8:57:31,14:14:19,9/6/2018,21859199,144.62,4,"Street hour land. Character what television response.
New less law until. Air activity end with control. On likely food exactly standard.",11:45:03,UPI
AZVR85135161881683,GB95URAP17054870000917,5/17/2016,7742.37,100001,Y,Utilities,MI,PC,Dr,19:02:16,25:26:05,9/6/2018,51708429,144.62,2,Against visit defense budget wonder ahead. Check share yeah build. Recognize situation strong.,22:50:06,IMPS
AZVR85135161881683,GB95URAP17054870000917,5/17/2016,9203.71,100001,N,Credited,MI,MOBILE,Cr,5:21:49,9:12:09,9/12/2018,93265768,1461.34,1,"Future old cold office form court space. Station section enough investment final window leave. Turn sister big short subject close staff.
Pattern focus everything threat miss. Bed agency hear.",6:51:21,NEFT
AZVR85135161881683,GB95URAP17054870000917,5/17/2016,10665.05,100001,N,Credited,EDGE,PC,Cr,10:50:23,16:17:02,9/12/2018,24194303,1461.34,5,"Structure speak campaign college alone. Institution focus fund whether child statement test.
Either yeah positive her against American since. What simply campaign feeling decade impact.",13:17:53,CARDS
AZVR85135161881683,GB95URAP17054870000917,5/17/2016,9203.71,100001,Y,Utilities,IE,PC,Dr,19:44:22,22:45:30,9/12/2018,94279801,1461.34,7,Baby general simple weight sometimes point. Worker upon side style single. Rise even cell create member fill once.,21:14:16,DD
AZVR85135161881683,GB95URAP17054870000917,5/17/2016,10297.82,100001,N,Credited,OPERA,PC,Cr,4:35:15,6:54:35,9/13/2018,13145705,1094.11,7,"Special consider deep month matter.
Event meet man blood lay practice. Attorney gas capital each just particularly. Office far find phone place.",5:22:24,DD
AZVR85135161881683,GB95URAP17054870000917,5/17/2016,9203.71,100001,Y,Entertainment,EDGE,PC,Dr,9:08:24,10:24:00,9/13/2018,49156201,1094.11,2,"Radio camera employee follow thousand. Wear raise peace join already itself morning. Here control position tell argue third star room.
Total fact will half.",9:49:43,IMPS
AZVR85135161881683,GB95URAP17054870000917,5/17/2016,8109.6,100001,Y,Medicals,FF,POS,Dr,14:58:40,17:03:41,9/13/2018,19423883,1094.11,6,Blood specific wait expert hit industry exist step. On hold ten.,15:39:15,CHEQUE
AZVR85135161881683,GB95URAP17054870000917,5/17/2016,7015.49,100001,Y,Online Shopping,MI,MOBILE,Dr,16:30:02,17:53:51,9/13/2018,74835881,1094.11,3,View keep sister either free go during. Glass weight hear nation can few. Animal position still development system. Debate check activity.,17:06:58,RTGS
AZVR85135161881683,GB95URAP17054870000917,5/17/2016,8109.6,100001,N,Credited,MI,PC,Cr,21:55:34,24:09:31,9/13/2018,24020107,1094.11,3,Certainly quality force responsibility seem deep she. List while religious pull kind college.,22:22:11,RTGS
AZVR85135161881683,GB95URAP17054870000917,5/17/2016,9048.14,100001,N,Credited,FF,PC,Cr,9:06:00,17:51:44,10/2/2018,38560750,938.54,2,"Easy someone a small. There many how stand whether finally wonder form.
Government particularly number try enough. Follow maybe matter another water. Fight case back detail detail.",12:11:06,IMPS
AZVR85135161881683,GB95URAP17054870000917,5/17/2016,8373.16,100001,Y,Groceries,EDGE,POS,Dr,5:07:29,9:53:20,10/5/2018,44803704,674.98,2,Sing upon to general believe rather blue. Thousand chance behavior government arrive. Effort wide middle strong a represent great concern.,8:26:04,IMPS
AZVR85135161881683,GB95URAP17054870000917,5/17/2016,7698.18,100001,Y,Household Consumables,CHROME,POS,Dr,21:16:55,25:37:24,10/5/2018,56080889,674.98,7,"Base former financial arrive speech wrong. Number anyone weight either.
Police day try whether still. Listen candidate force. Management almost simple Democrat game new. Which state information who.",22:23:27,DD
AZVR85135161881683,GB95URAP17054870000917,5/17/2016,5710.48,100001,Y,Rent,FF,MOBILE,Dr,8:22:44,13:04:21,10/21/2018,10380857,1987.7,6,"Employee particular guy organization term run middle. Manage accept raise. Carry tree color address support.
Attack agree because use better mean.
National view dog as hour.",10:46:11,CHEQUE
AZVR85135161881683,GB95URAP17054870000917,5/17/2016,3722.78,100001,Y,Medicals,FF,MOBILE,Dr,12:35:05,14:41:35,10/21/2018,75045883,1987.7,6,"Wrong billion current. Choose least part represent you create.
Go nice ahead west no popular hotel. But think could health local discuss large. Lead again anything administration interest day.",13:18:40,CHEQUE
AZVR85135161881683,GB95URAP17054870000917,5/17/2016,5710.48,100001,N,Credited,OPERA,POS,Cr,18:33:05,20:58:38,10/21/2018,94053678,1987.7,4,Degree step seven century various run herself. Fight firm on image wall wall democratic fly. Show nor smile public imagine candidate.,19:47:56,UPI
AZVR85135161881683,GB95URAP17054870000917,5/17/2016,4166.17,100001,Y,Personal Care,FF,PC,Dr,3:56:37,6:41:37,11/3/2018,55395182,1544.31,2,"Site school movie election project image. Positive language establish else black series force though. Everybody more soon strong. Language control quality.
Station represent food look.",4:53:03,IMPS
AZVR85135161881683,GB95URAP17054870000917,5/17/2016,5710.48,100001,N,Credited,SAFARI,POS,Cr,11:05:18,14:26:49,11/3/2018,21819537,1544.31,3,"Relate section themselves audience child. Talk cup nation store detail. Media director kid yard candidate.
Scientist already speak last development window black specific. Leg fund doctor personal.",13:26:39,RTGS
AZVR85135161881683,GB95URAP17054870000917,5/17/2016,7254.79,100001,N,Credited,SAFARI,POS,Cr,13:21:22,16:52:44,11/3/2018,35289722,1544.31,4,"Important war sea.
Memory attention seek next many happy. Page beat third top force strong goal.
Goal green fact ok sit east. Road week forward be spend score address structure.",14:59:41,UPI
AZVR85135161881683,GB95URAP17054870000917,5/17/2016,5710.48,100001,Y,Rent,EDGE,POS,Dr,17:52:47,20:34:32,11/3/2018,53074300,1544.31,4,"Represent focus size industry lay final. Nor pretty step place.
Market little very lose develop. After seek majority series.",19:58:00,UPI
AZVR85135161881683,GB95URAP17054870000917,5/17/2016,4518.85,100001,Y,Utilities,SAFARI,MOBILE,Dr,4:32:15,7:43:30,11/19/2018,451123,1191.63,4,"Democratic charge professional owner. Moment impact order rather.
Receive claim turn most. Address explain class race occur. Never arrive live as argue wife. Discussion wind good hand meet free.",7:05:20,UPI
AZVR85135161881683,GB95URAP17054870000917,5/17/2016,3327.22,100001,Y,Online Shopping,OPERA,POS,Dr,10:12:25,15:42:46,11/19/2018,57472867,1191.63,3,"Require everything garden voice tend figure. Record president fine stay but despite. Couple necessary around oil.
Two military get pretty result. Age fast production move set.",13:05:07,RTGS
AZVR85135161881683,GB95URAP17054870000917,5/17/2016,2135.59,100001,Y,Household Consumables,FF,POS,Dr,19:28:56,24:26:36,11/19/2018,28827054,1191.63,5,"Simply play happy blue how pressure ground. Small and continue push way. Box program likely run turn structure successful.
Relationship drug born oil collection. Sell study or.",22:08:35,CARDS
AZVR85135161881683,GB95URAP17054870000917,5/17/2016,2992.14,100001,N,Credited,IE,PC,Cr,13:00:56,18:19:51,11/20/2018,43183449,856.55,3,Himself degree resource talk now low leave. Several month so good industry.,14:22:26,RTGS
AZVR85135161881683,GB95URAP17054870000917,5/17/2016,2135.59,100001,Y,Transportation,MI,POS,Dr,17:23:08,20:59:38,11/20/2018,87083873,856.55,7,Live each purpose major guy subject professional. Make brother could turn meeting later style. Base car teacher bar deep worry.,19:50:30,DD
AZVR85135161881683,GB95URAP17054870000917,5/17/2016,4005.42,100001,N,Credited,IE,PC,Cr,7:47:38,16:27:08,11/21/2018,57904139,1869.83,1,American discover threat tree one since. Themselves itself start painting soon minute someone. After cold my employee.,12:00:28,NEFT
AZVR85135161881683,GB95URAP17054870000917,5/17/2016,4200.34,100001,N,Credited,IE,POS,Cr,6:12:45,8:43:54,11/26/2018,86501385,194.92,7,"Would court class consumer deep tough beautiful. Product figure nation arm increase not.
Color free area young. Few write argue thank marriage surface theory.",7:27:57,DD
AZVR85135161881683,GB95URAP17054870000917,5/17/2016,4005.42,100001,Y,Household Consumables,CHROME,PC,Dr,9:32:27,12:19:05,11/26/2018,29076857,194.92,4,"Special decide carry late firm. Get anything hard maintain consumer loss.
Player picture stock gun surface defense media agreement.",11:25:52,UPI
AZVR85135161881683,GB95URAP17054870000917,5/17/2016,4200.34,100001,N,Credited,SAFARI,MOBILE,Cr,16:29:09,17:39:01,11/26/2018,69103308,194.92,2,"Smile coach relate water write. Road others evidence physical traditional break.
According just space on especially player.",17:08:15,IMPS
AZVR85135161881683,GB95URAP17054870000917,5/17/2016,4005.42,100001,Y,Dining,EDGE,POS,Dr,22:42:10,25:26:54,11/26/2018,81426522,194.92,2,"Step official hard break perhaps about. Include fight person avoid.
So job focus style defense. Several Democrat good investment health stop for. Edge play out party join other policy.",23:39:47,IMPS
AZVR85135161881683,GB95URAP17054870000917,5/17/2016,4142.92,100001,N,Credited,CHROME,PC,Cr,14:00:51,20:17:45,11/28/2018,34388877,137.5,3,Book available cell operation she car our better. Ability you up can. Front allow show book relate only.,15:53:35,RTGS
AZVR85135161881683,GB95URAP17054870000917,5/17/2016,2910.22,100001,Y,Rent,SAFARI,POS,Dr,10:46:34,14:13:42,12/2/2018,61657236,1232.7,2,Kitchen center end several case phone at. Standard effect politics process third team.,11:56:57,IMPS
AZVR85135161881683,GB95URAP17054870000917,5/17/2016,4142.92,100001,N,Credited,EDGE,POS,Cr,11:20:11,14:41:50,12/2/2018,28561026,1232.7,4,Suffer party option pay movement child. Feeling environment case media support yeah hit. Line share drop nature past push.,13:42:43,UPI
AZVR85135161881683,GB95URAP17054870000917,5/17/2016,2910.22,100001,Y,Groceries,EDGE,MOBILE,Dr,20:46:37,24:12:48,12/2/2018,86949828,1232.7,3,Exist grow former current control. Garden history model image.,21:54:21,RTGS
AZVR85135161881683,GB95URAP17054870000917,5/17/2016,2206.27,100001,Y,Transportation,SAFARI,MOBILE,Dr,5:46:01,8:42:48,12/19/2018,35156550,703.95,6,Into authority billion cold as decision. Race impact appear. Natural term reason enjoy.,6:44:55,CHEQUE
AZVR85135161881683,GB95URAP17054870000917,5/17/2016,2910.22,100001,N,Credited,MI,PC,Cr,8:36:53,10:05:05,12/19/2018,34324387,703.95,7,Blue owner dark heavy court. Boy reduce at every we. True use fish let behind important.,9:20:24,DD
AZVR85135161881683,GB95URAP17054870000917,5/17/2016,2206.27,100001,Y,Personal Care,IE,PC,Dr,13:03:13,16:35:32,12/19/2018,13326524,703.95,7,Test change bit one. Attorney seek front couple ball. Major do large lot.,14:39:41,DD
AZVR85135161881683,GB95URAP17054870000917,5/17/2016,1502.32,100001,Y,Entertainment,MI,PC,Dr,18:14:26,20:23:19,12/19/2018,69059056,703.95,7,"Theory away area leg theory act sometimes. Talk black as. Federal government hot common.
Father nothing deep begin. Total step wide word sea.",19:50:02,DD
AZVR85135161881683,GB95URAP17054870000917,5/17/2016,798.37,100001,Y,Utilities,CHROME,PC,Dr,20:03:13,21:40:01,12/19/2018,29051311,703.95,7,"Must lead good. Protect across such. Read air record. Show movement response sometimes.
Agent never wonder hospital poor glass. Seat painting without large student capital four.",20:59:45,DD
AZVR85135161881683,GB95URAP17054870000917,5/17/2016,2137.12,100001,N,Credited,EDGE,POS,Cr,12:08:47,18:48:39,1/7/2019,51170271,1338.75,6,"Bag mention history toward. Election perform north left serve word. Whether peace hour people.
Growth worry will hear suffer recently difficult impact. Relationship add fish building.",15:26:08,CHEQUE
AZVR85135161881683,GB95URAP17054870000917,5/17/2016,868.47,100001,Y,Personal Care,SAFARI,MOBILE,Dr,6:05:25,8:11:04,1/16/2019,80422,1268.65,7,"Measure film number arm nor follow debate. Here than reveal section. Huge what yeah.
Seat site attack few compare. Dream score officer maybe show where similar. Tonight own from government.",6:39:43,DD
AZVR85135161881683,GB95URAP17054870000917,5/17/2016,2137.12,100001,N,Credited,SAFARI,PC,Cr,18:15:22,20:13:50,1/16/2019,47210127,1268.65,3,"Factor quality tough brother onto everybody. His close wind morning teach charge political. Easy pass none learn animal.
Against product soldier quality they first message.",18:50:36,RTGS
AZVR85135161881683,GB95URAP17054870000917,5/17/2016,3405.77,100001,N,Credited,IE,POS,Cr,21:05:16,24:46:41,1/16/2019,59659785,1268.65,6,"Even situation hotel card suddenly suggest. Born simple audience push meet little. Cut material less indeed happen.
Computer like since. Technology consider once pass method community.",22:59:44,CHEQUE
AZVR85135161881683,GB95URAP17054870000917,5/17/2016,2727.62,100001,Y,Utilities,SAFARI,MOBILE,Dr,4:44:08,6:33:09,1/27/2019,90969058,678.15,4,"Similar budget let risk. Seem walk available seem would.
Stage various follow five case debate audience where.",5:25:33,UPI
AZVR85135161881683,GB95URAP17054870000917,5/17/2016,3405.77,100001,N,Credited,EDGE,PC,Cr,11:06:32,14:05:00,1/27/2019,60127396,678.15,1,"Sister PM assume trip know north. Act pay your. Seem southern hold home set interesting.
Animal avoid language owner still other result wide. Side be heavy sport. Push do begin change him.",12:49:15,NEFT
AZVR85135161881683,GB95URAP17054870000917,5/17/2016,2727.62,100001,Y,Insurance,CHROME,MOBILE,Dr,17:05:31,19:41:28,1/27/2019,96723739,678.15,2,"Must thought around item enjoy.
Chair recently establish act. Health drop board drop.
Against general song peace into. Play time whether single society every.",17:34:47,IMPS
AZVR85135161881683,GB95URAP17054870000917,5/17/2016,3405.77,100001,N,Credited,FF,MOBILE,Cr,19:00:32,23:01:47,1/27/2019,58561928,678.15,2,Behind air author chance. Still see certain final media goal since. Factor many take role.,20:50:59,IMPS
AZVR85135161881683,GB95URAP17054870000917,5/17/2016,2072.72,100001,Y,Transportation,IE,PC,Dr,4:21:14,7:03:47,1/28/2019,38811302,1333.05,6,"Happen state left cut statement girl. Congress yourself hold article.
Into least technology risk eye. Face current offer instead class it.",4:53:53,CHEQUE
AZVR85135161881683,GB95URAP17054870000917,5/17/2016,739.67,100001,Y,Utilities,MI,PC,Dr,8:23:54,11:19:03,1/28/2019,2240923,1333.05,3,"Major wrong young glass particular. Other window determine former least decade.
Arrive security Mrs few late rich. Human hit world situation economy. Eight its scientist.",9:45:00,RTGS
AZVR85135161881683,GB95URAP17054870000917,5/17/2016,2072.72,100001,N,Credited,SAFARI,POS,Cr,17:27:14,20:19:08,1/28/2019,44810924,1333.05,2,"Arm kitchen full. Hair nothing bed learn civil check.
No tonight attorney over study analysis. Boy world stage around improve. Current make field we add.",19:04:36,IMPS
AZVR85135161881683,GB95URAP17054870000917,5/17/2016,3405.77,100001,N,Credited,OPERA,MOBILE,Cr,20:54:04,23:18:18,1/28/2019,19003399,1333.05,6,"Cost off opportunity itself get every. Hard investment appear understand.
Program cultural force improve marriage generation. Network minute sound identify from.",22:01:27,CHEQUE
AZVR85135161881683,GB95URAP17054870000917,5/17/2016,2879.89,100001,Y,Household Consumables,IE,MOBILE,Dr,3:08:41,6:21:22,1/29/2019,21497025,525.88,3,Message Congress TV imagine. Long short current create today direction professional learn. Culture firm recent.,4:50:38,RTGS
AZVR85135161881683,GB95URAP17054870000917,5/17/2016,3405.77,100001,N,Credited,EDGE,POS,Cr,7:34:29,9:30:19,1/29/2019,54274129,525.88,5,"Treat house learn line. Or bad exist large decision. Oil nearly involve mean computer ask eye. Decision air reason artist decide.
Share campaign live among. Democratic media animal kitchen positive.",8:14:36,CARDS
AZVR85135161881683,GB95URAP17054870000917,5/17/2016,2879.89,100001,Y,Insurance,FF,PC,Dr,12:13:12,15:11:21,1/29/2019,1891645,525.88,6,Either message music television executive recognize idea. Coach tell claim day rest. Challenge open six later community one car.,14:05:24,CHEQUE
AZVR85135161881683,GB95URAP17054870000917,5/17/2016,3405.77,100001,N,Credited,IE,POS,Cr,16:59:26,19:25:16,1/29/2019,82476717,525.88,6,"Design arm paper doctor almost music. Fine trade smile relationship probably.
Agent into effort two soon what happen. Production agent discuss create high.",18:46:54,CHEQUE
AZVR85135161881683,GB95URAP17054870000917,5/17/2016,3931.65,100001,N,Credited,FF,POS,Cr,20:14:47,21:51:32,1/29/2019,80957928,525.88,2,"All wear ground mouth art. List order cell yet prepare glass ok song.
Happen onto again claim stop low. Position simple special fear late number.",20:52:39,IMPS
AZVR85135161881683,GB95URAP17054870000917,5/17/2016,4512.17,100001,N,Credited,EDGE,POS,Cr,6:04:27,8:03:40,2/8/2019,50012688,580.52,1,Yourself price herself with ever value network. Sing call those site social story include usually. Sense or hour girl again poor.,6:40:38,NEFT
AZVR85135161881683,GB95URAP17054870000917,5/17/2016,5092.69,100001,N,Credited,IE,PC,Cr,8:19:34,9:44:25,2/8/2019,97294498,580.52,1,Question light seek of mouth interview. Remember early write TV worry message no either. Cold series of situation late begin within.,9:15:06,NEFT
AZVR85135161881683,GB95URAP17054870000917,5/17/2016,5673.21,100001,N,Credited,MI,PC,Cr,14:00:12,16:32:13,2/8/2019,51623784,580.52,6,"Mission chance agree discover number. Senior kid recently opportunity government section.
Beyond hope thought much item. Federal look fire lose response history.",15:16:52,CHEQUE
AZVR85135161881683,GB95URAP17054870000917,5/17/2016,6253.73,100001,N,Credited,SAFARI,MOBILE,Cr,17:17:45,19:31:35,2/8/2019,43628124,580.52,3,Activity work respond main today deal. Must keep his method.,17:58:31,RTGS
AZVR85135161881683,GB95URAP17054870000917,5/17/2016,5673.21,100001,Y,Dining,OPERA,POS,Dr,19:33:18,21:25:33,2/8/2019,66168195,580.52,5,At dream likely seem charge everyone child. Cold new too bar. Try environmental oil job. Tv kid population focus.,20:57:28,CARDS
AZVR85135161881683,GB95URAP17054870000917,5/17/2016,4804.42,100001,Y,Personal Care,MI,POS,Dr,13:14:03,18:02:17,2/17/2019,5727353,868.79,2,"Wait lot or result. Often admit after attorney very. Brother Democrat next fall its. Report follow democratic newspaper something.
Hour ability off.
Better step instead painting they.",15:04:15,IMPS
AZVR85135161881683,GB95URAP17054870000917,5/17/2016,3935.63,100001,Y,Insurance,EDGE,PC,Dr,18:49:58,23:51:28,2/17/2019,84805287,868.79,3,"Section our people himself save yet. Close appear direction after sign catch want.
Present suggest change kid actually. Difficult want modern guy. Learn plan no wall lay defense single.",20:22:01,RTGS
AZVR85135161881683,GB95URAP17054870000917,5/17/2016,4747.52,100001,N,Credited,MI,POS,Cr,4:23:25,7:47:53,2/18/2019,27189986,811.89,3,Partner sound be professional food democratic indicate. Exactly enjoy about during skin none her. Network only step painting loss Mr.,6:19:14,RTGS
AZVR85135161881683,GB95URAP17054870000917,5/17/2016,3935.63,100001,Y,Entertainment,CHROME,PC,Dr,6:51:16,10:16:49,2/18/2019,55058933,811.89,1,"Seven heart newspaper either yes sea try thank. True play card may.
Fill same lot case site eat. Onto although particular use reality sit minute.",8:33:50,NEFT
AZVR85135161881683,GB95URAP17054870000917,5/17/2016,3123.74,100001,Y,Rent,MI,POS,Dr,12:55:07,15:27:32,2/18/2019,99878306,811.89,2,"Every to position thing game culture. Decision type process level.
Professor since wrong energy same. Produce color major safe writer. Against anything thing.",14:49:23,IMPS
AZVR85135161881683,GB95URAP17054870000917,5/17/2016,3935.63,100001,N,Credited,EDGE,PC,Cr,15:35:06,18:02:01,2/18/2019,5640652,811.89,4,"Professor thousand letter ever. Society two road.
Door glass what sport. Minute speech once hotel within bit everything. Including here with bill then early.",16:40:01,UPI
AZVR85135161881683,GB95URAP17054870000917,5/17/2016,4747.52,100001,N,Credited,CHROME,MOBILE,Cr,19:34:15,21:57:38,2/18/2019,52353352,811.89,6,Include join notice nearly spend nor. Economy require cover police Mr all. Usually better level young whether five perform enough.,20:33:54,CHEQUE
AZVR85135161881683,GB95URAP17054870000917,5/17/2016,5264.03,100001,N,Credited,OPERA,POS,Cr,8:07:15,10:53:43,2/26/2019,95526218,516.51,3,Western decade at citizen know whether when action. Build role he resource international drug he it. Industry television manager join.,10:16:37,RTGS
AZVR85135161881683,GB95URAP17054870000917,5/17/2016,5780.54,100001,N,Credited,SAFARI,POS,Cr,12:46:01,16:58:15,2/26/2019,89348833,516.51,7,"Tough political design building. Over trip American sense heavy. Born remember decade name.
Near drug above marriage skill fact. Recent number career do president own mission.",14:41:41,DD
AZVR85135161881683,GB95URAP17054870000917,5/17/2016,6297.05,100001,N,Credited,CHROME,POS,Cr,18:49:39,22:54:56,2/26/2019,90423710,516.51,4,"Far scene race now Republican wall three reveal. Option go by main.
Could reason kitchen fast production standard. Prove strategy everything on major.",20:33:53,UPI
AZVR85135161881683,GB95URAP17054870000917,5/17/2016,6198.63,100001,Y,Medicals,OPERA,PC,Dr,8:00:09,11:41:26,3/3/2019,49537659,98.42,5,"Technology surface executive after. Party fish government population network not member. Best drug system keep dark.
Society fear wife throughout.",9:51:57,CARDS
AZVR85135161881683,GB95URAP17054870000917,5/17/2016,6297.05,100001,N,Credited,IE,POS,Cr,15:56:06,18:26:19,3/3/2019,48982184,98.42,3,"Bring particular official will nice. Feel success all. Church side see protect attorney.
Hotel number example yard pretty.",17:46:38,RTGS
AZVR85135161881683,GB95URAP17054870000917,5/17/2016,6198.63,100001,Y,Insurance,EDGE,PC,Dr,17:49:08,20:16:19,3/3/2019,99709716,98.42,7,"Stay political car though.
Main rock fact fear dream can. Case personal tell somebody paper. Rate direction quite here.",18:31:25,DD
AZVR85135161881683,GB95URAP17054870000917,5/17/2016,6099.73,100001,Y,Entertainment,CHROME,MOBILE,Dr,6:06:41,9:22:24,3/5/2019,3841068,98.9,1,"Star cover decade she which study. Wonder as all.
Finally health oil. Sell particular quickly individual wonder window town. Argue network region.",6:59:33,NEFT
AZVR85135161881683,GB95URAP17054870000917,5/17/2016,6000.83,100001,Y,Dining,SAFARI,PC,Dr,11:36:41,14:17:57,3/5/2019,78013582,98.9,1,Federal yourself blue practice along individual realize should. Hotel so between north property. Clear whether region statement wide peace thus.,13:26:37,NEFT
AZVR85135161881683,GB95URAP17054870000917,5/17/2016,6099.73,100001,N,Credited,EDGE,POS,Cr,17:14:10,21:39:11,3/5/2019,51853280,98.9,5,Mr huge thus where story continue. Let blood amount board imagine have.,19:39:31,CARDS
AZVR85135161881683,GB95URAP17054870000917,5/17/2016,6596.56,100001,N,Credited,FF,POS,Cr,6:20:07,10:23:50,3/6/2019,60281456,496.83,4,"Sense field beat nearly score listen. Alone level soon.
Not him evening. Page identify social amount. Good glass quality out painting could.",8:22:42,UPI
AZVR85135161881683,GB95URAP17054870000917,5/17/2016,7093.39,100001,N,Credited,MI,PC,Cr,11:56:45,13:38:53,3/6/2019,65194324,496.83,5,"Rich choose stock throughout. Discover everybody treat. Federal water sea identify reveal history represent.
Commercial former represent according case analysis stay. Risk always head until.",13:03:27,CARDS
AZVR85135161881683,GB95URAP17054870000917,5/17/2016,7590.22,100001,N,Credited,EDGE,POS,Cr,14:57:38,17:24:45,3/6/2019,51889425,496.83,7,"Growth ago safe policy official. School number cover month. None social high else back.
Everyone check worry guy those.
View local black actually visit my. Meeting short ground.",16:43:14,DD
AZVR85135161881683,GB95URAP17054870000917,5/17/2016,8087.05,100001,N,Credited,CHROME,MOBILE,Cr,20:30:38,22:41:07,3/6/2019,95958583,496.83,7,Whose important benefit son risk social. Its prevent size soon education police approach north. Son describe another yeah drop.,22:09:41,DD
AZVR85135161881683,GB95URAP17054870000917,5/17/2016,7162.53,100001,Y,Personal Care,SAFARI,POS,Dr,7:00:58,9:33:34,3/8/2019,80117070,924.52,3,"Figure successful left piece important about. Economy authority if keep. Certainly support foreign out maybe record.
Order three all unit. Seven peace toward represent.",8:20:29,RTGS
AZVR85135161881683,GB95URAP17054870000917,5/17/2016,8087.05,100001,N,Credited,OPERA,POS,Cr,13:55:21,16:51:43,3/8/2019,85147744,924.52,1,Month threat section certain. Mouth law friend character truth course group answer. Field throughout occur police.,14:47:30,NEFT
AZVR85135161881683,GB95URAP17054870000917,5/17/2016,9011.57,100001,N,Credited,OPERA,MOBILE,Cr,19:41:17,22:47:08,3/8/2019,62906913,924.52,7,"Space grow one. Certainly vote prevent official.
Everyone particular seek prevent series sing. Everybody friend open figure ten billion hundred lose. Return add take great.",21:26:19,DD
AZVR85135161881683,GB95URAP17054870000917,5/17/2016,10689.43,100001,N,Credited,FF,POS,Cr,16:23:13,26:11:54,3/10/2019,8838148,1677.86,2,"Trouble truth across try. Skill magazine thing yard he Mrs tree ball.
Model increase miss plant run bar glass one. Just quality tend artist war stand number. Up baby human.",21:26:49,IMPS
AZVR85135161881683,GB95URAP17054870000917,5/17/2016,10537.79,100001,Y,Entertainment,OPERA,PC,Dr,6:37:22,9:27:10,3/21/2019,98907540,151.64,6,"Him store human face. Term but happy who. Unit despite exist top operation performance decision than.
Nothing hair together visit field usually. Truth time determine wish when also involve.",8:06:02,CHEQUE
AZVR85135161881683,GB95URAP17054870000917,5/17/2016,10386.15,100001,Y,Medicals,EDGE,MOBILE,Dr,9:46:31,12:40:30,3/21/2019,30371866,151.64,4,"Power vote including ok want national. Under class send always everybody.
Dream apply sense idea wonder. Together pressure PM.
These clear fear. Wonder successful group program property argue.",11:38:59,UPI
AZVR85135161881683,GB95URAP17054870000917,5/17/2016,10537.79,100001,N,Credited,SAFARI,MOBILE,Cr,14:42:48,18:01:37,3/21/2019,5535156,151.64,7,"Million event impact grow important.
Much painting beat yeah water take. Commercial leader how environment. Old capital away front author toward drive.
Budget make past grow. Feeling imagine order.",16:15:06,DD
AZVR85135161881683,GB95URAP17054870000917,5/17/2016,10689.43,100001,N,Credited,IE,MOBILE,Cr,18:55:29,20:38:10,3/21/2019,14676642,151.64,2,Heart financial knowledge. Choice town call. Successful prevent identify hear call loss.,19:53:50,IMPS
AZVR85135161881683,GB95URAP17054870000917,5/17/2016,12075.64,100001,N,Credited,EDGE,MOBILE,Cr,7:54:56,9:31:56,3/23/2019,68859862,1386.21,5,Policy step true. Think remember education discuss card some rather.,8:37:52,CARDS
AZVR85135161881683,GB95URAP17054870000917,5/17/2016,13461.85,100001,N,Credited,OPERA,MOBILE,Cr,9:55:52,11:11:39,3/23/2019,49559781,1386.21,5,Choice research able include study never pick. Production grow hard clearly.,10:39:16,CARDS
AZVR85135161881683,GB95URAP17054870000917,5/17/2016,12075.64,100001,Y,Medicals,CHROME,MOBILE,Dr,18:23:13,20:15:21,3/23/2019,47966505,1386.21,4,"Us across as contain wide. Effort main already plant.
Party address during. Rise one various figure.",18:57:27,UPI
AZVR85135161881683,GB95URAP17054870000917,5/17/2016,13461.85,100001,N,Credited,SAFARI,PC,Cr,18:00:53,21:40:46,3/23/2019,70987270,1386.21,6,Citizen article even anyone. Identify agree apply quality right bag. Once way here thing perhaps available song.,20:02:32,CHEQUE
AZVR85135161881683,GB95URAP17054870000917,5/17/2016,14607.11,100001,N,Credited,MI,POS,Cr,15:26:04,21:40:51,3/25/2019,2204307,1145.26,6,"Think thank road discover fight. Toward place clear common. Agency once western last change.
Player oil knowledge compare simple hit. Military its though left.",20:20:45,CHEQUE
AZVR85135161881683,GB95URAP17054870000917,5/17/2016,15900.08,100001,N,Credited,EDGE,POS,Cr,5:09:52,8:52:23,3/30/2019,81513970,1292.97,1,"Long any pressure. Pick glass what seek.
Middle nature question item sound. Me story camera wide down phone result.
Realize on type of star deal name home. Notice oil generation return.",7:01:59,NEFT
AZVR85135161881683,GB95URAP17054870000917,5/17/2016,14607.11,100001,Y,Entertainment,FF,POS,Dr,12:00:57,15:31:35,3/30/2019,85913769,1292.97,6,"Wife week night movie their they bank. Source relate new nice subject senior campaign.
Reduce PM agree indeed. When few sister reason sister he.",14:51:42,CHEQUE
AZVR85135161881683,GB95URAP17054870000917,5/17/2016,15900.08,100001,N,Credited,MI,PC,Cr,20:44:03,23:33:58,3/30/2019,15982032,1292.97,6,Eight instead early well attorney continue since high. Service beat lot future save. Ahead item more area. Security recent establish together describe daughter approach current.,22:16:03,CHEQUE
AZVR85135161881683,GB95URAP17054870000917,5/17/2016,16557.79,100001,N,Credited,IE,POS,Cr,21:14:27,24:27:03,4/2/2019,8416322,657.71,3,"Kid health capital about response. Sell such can whatever quite thought fight.
Join choose only yourself. All top why should win.
Standard another for force. Dinner soldier business world computer.",23:00:24,RTGS
AZVR85135161881683,GB95URAP17054870000917,5/17/2016,16278.11,100001,Y,Groceries,IE,PC,Dr,8:05:23,10:38:37,4/24/2019,75212438,279.68,2,"Available its weight. Good similar size but success protect.
Military why unit or whatever. Imagine little prepare gun attorney hundred finish. Follow cell under night call base experience.",9:32:02,IMPS
AZVR85135161881683,GB95URAP17054870000917,5/17/2016,15998.43,100001,Y,Dining,CHROME,MOBILE,Dr,19:43:14,25:38:17,4/24/2019,74695560,279.68,7,"Animal avoid small exactly allow budget. Parent note Democrat.
Technology hope operation answer. State cold ten you speech remember.
Often crime whole however. Include reveal eight or training.",22:11:19,DD
AZVR85135161881683,GB95URAP17054870000917,5/17/2016,16346.17,100001,N,Credited,OPERA,MOBILE,Cr,7:00:51,8:33:35,5/1/2019,85192010,347.74,6,Population best far author. Floor challenge fish peace.,7:51:49,CHEQUE
AZVR85135161881683,GB95URAP17054870000917,5/17/2016,15998.43,100001,Y,Medicals,IE,MOBILE,Dr,10:44:58,13:07:23,5/1/2019,41522462,347.74,4,"Age speech six involve word practice already.
Box message consumer drug case until throughout. Politics question animal small white. History fear two identify question system back.",12:16:56,UPI
AZVR85135161881683,GB95URAP17054870000917,5/17/2016,15650.69,100001,Y,Entertainment,SAFARI,PC,Dr,15:00:52,18:14:21,5/1/2019,25123029,347.74,6,"Yeah design such degree name doctor you interesting. Believe beyond production side fine.
House condition chair impact present me end blue.",16:38:16,CHEQUE
AZVR85135161881683,GB95URAP17054870000917,5/17/2016,15998.43,100001,N,Credited,SAFARI,PC,Cr,22:29:35,24:32:43,5/1/2019,46759030,347.74,2,"What so artist. Beyond administration appear officer. Part ability capital moment throw positive.
Far while else worker. Officer space field glass sell else night.",23:49:36,IMPS
AZVR85135161881683,GB95URAP17054870000917,5/17/2016,17609.63,100001,N,Credited,FF,PC,Cr,4:27:26,6:41:30,5/5/2019,91653277,1611.2,7,Page response executive road party result. Southern low eight. Artist whatever get whose more Mr.,6:08:06,DD
AZVR85135161881683,GB95URAP17054870000917,5/17/2016,19220.83,100001,N,Credited,CHROME,MOBILE,Cr,8:19:31,10:23:19,5/5/2019,79638647,1611.2,4,"Opportunity idea population often property. Order increase chair. Shake just stay interest I.
Street lead Mr create turn age save. Local want imagine nearly.",9:58:40,UPI
AZVR85135161881683,GB95URAP17054870000917,5/17/2016,17609.63,100001,Y,Insurance,SAFARI,POS,Dr,11:51:50,14:22:25,5/5/2019,17724159,1611.2,1,Study sit any affect project themselves nation. Into article must recognize door participant main. Serious more each point.,13:03:46,NEFT
AZVR85135161881683,GB95URAP17054870000917,5/17/2016,19220.83,100001,N,Credited,OPERA,PC,Cr,16:53:55,19:13:02,5/5/2019,27705292,1611.2,7,"Heart sing everybody west or. School budget two after soldier. Choose power ability mouth.
Environment concern wall wear evening just among officer. Only make this word.",17:49:58,DD
AZVR85135161881683,GB95URAP17054870000917,5/17/2016,20832.03,100001,N,Credited,OPERA,PC,Cr,19:15:11,22:45:20,5/5/2019,20744724,1611.2,2,Soldier future together three almost measure other. Either situation bit eye. Plant also administration behavior performance mention lay. Poor those home according end check challenge bit.,21:15:09,IMPS
AZVR85135161881683,GB95URAP17054870000917,5/17/2016,21917.79,100001,N,Credited,IE,MOBILE,Cr,8:20:48,12:59:16,5/11/2019,88497129,1085.76,2,Investment recognize affect shoulder sea message cover green. First push author guy enjoy. Report whole across report model.,9:10:42,IMPS
AZVR85135161881683,GB95URAP17054870000917,5/17/2016,23003.55,100001,N,Credited,EDGE,MOBILE,Cr,18:01:39,24:01:11,5/11/2019,55382175,1085.76,1,"Production forget simple similar. Road end and month run listen suddenly. Pick second me draw executive doctor.
Mention leave assume possible. Any imagine level magazine simple imagine together.",20:44:56,NEFT
AZVR85135161881683,GB95URAP17054870000917,5/17/2016,21930.59,100001,Y,Dining,EDGE,MOBILE,Dr,4:07:34,7:27:15,5/13/2019,3436233,1072.96,4,"Though from shake.
They cultural executive democratic way consider. Tonight mission bit account crime wife police. Role physical do certainly open.",5:51:05,UPI
AZVR85135161881683,GB95URAP17054870000917,5/17/2016,23003.55,100001,N,Credited,SAFARI,POS,Cr,9:54:12,12:39:04,5/13/2019,26295626,1072.96,2,Make perform happy the believe decide water. Soon heart close person.,11:12:43,IMPS
AZVR85135161881683,GB95URAP17054870000917,5/17/2016,24076.51,100001,N,Credited,IE,PC,Cr,12:37:47,14:47:57,5/13/2019,12055364,1072.96,3,"Eye yet TV though. Summer challenge very parent political theory. Possible different sport shoulder where television others.
Around if become movie hot type. Continue appear buy we during success.",14:17:36,RTGS
AZVR85135161881683,GB95URAP17054870000917,5/17/2016,25149.47,100001,N,Credited,OPERA,POS,Cr,17:11:19,20:49:53,5/13/2019,11816287,1072.96,3,"Out reveal project middle.
Special staff card also seek inside usually. Sea best among draw matter. Option perform himself quickly.",19:05:09,RTGS
AZVR85135161881683,GB95URAP17054870000917,5/17/2016,24076.51,100001,Y,Medicals,CHROME,PC,Dr,20:04:42,21:32:49,5/13/2019,92892774,1072.96,7,"Whatever garden project article. Table social commercial indicate. Safe rich picture evening.
Service rock before water head. Never soon yet.",20:38:02,DD
AZVR85135161881683,GB95URAP17054870000917,5/17/2016,25947.01,100001,N,Credited,CHROME,MOBILE,Cr,4:20:30,7:04:16,6/2/2019,83799051,1870.5,5,Eight central station person agree science he government. Well discuss both teacher. Sell part age realize far significant live.,5:39:28,CARDS
AZVR85135161881683,GB95URAP17054870000917,5/17/2016,24076.51,100001,Y,Entertainment,IE,MOBILE,Dr,13:03:31,16:03:00,6/2/2019,83433177,1870.5,4,Prepare common remain two mouth decide inside movement. East ahead analysis consider factor add into interview.,13:40:51,UPI
AZVR85135161881683,GB95URAP17054870000917,5/17/2016,22206.01,100001,Y,Household Consumables,FF,POS,Dr,16:35:27,20:34:49,6/2/2019,51905392,1870.5,1,Own event interview book event site bar. Inside program he daughter anyone use despite. Area door exactly medical nation value take realize.,18:16:24,NEFT
AZVR85135161881683,GB95URAP17054870000917,5/17/2016,20335.51,100001,Y,Personal Care,OPERA,POS,Dr,18:03:34,20:10:55,6/2/2019,48307352,1870.5,5,"Wait he wrong street put. Life recent body. Your professional store against article either view.
Of simply customer visit single. Central hair quite. Sometimes family week hear approach various up.",19:28:20,CARDS
AZVR85135161881683,GB95URAP17054870000917,5/17/2016,19863.55,100001,Y,Insurance,FF,PC,Dr,5:54:15,9:07:56,6/8/2019,36348374,471.96,2,"Term join too discuss group. Who really though require religious.
Focus beautiful certain issue early. Appear just send measure fund. College then reflect lawyer style they.",7:22:50,IMPS
AZVR85135161881683,GB95URAP17054870000917,5/17/2016,19391.59,100001,Y,Rent,SAFARI,PC,Dr,8:18:48,11:16:56,6/8/2019,84123800,471.96,7,Produce indeed unit start worker environment challenge pass. Bad whose up. Impact eye chance check voice shoulder yeah. Change computer market medical forward wide safe.,9:49:50,DD
AZVR85135161881683,GB95URAP17054870000917,5/17/2016,19863.55,100001,N,Credited,FF,PC,Cr,13:43:28,15:21:42,6/8/2019,86784887,471.96,5,"Beat others play determine PM. Expert she really everything compare.
Whole billion various according. Certainly again decade truth town purpose time.",14:25:11,CARDS
AZVR85135161881683,GB95URAP17054870000917,5/17/2016,20335.51,100001,N,Credited,SAFARI,POS,Cr,17:10:58,19:48:06,6/8/2019,1861518,471.96,7,"Fly no account event address.
Hear suggest reveal then defense deep focus. Recent less own leave. A process more add style return.",19:05:20,DD
AZVR85135161881683,GB95URAP17054870000917,5/17/2016,20807.47,100001,N,Credited,IE,POS,Cr,21:59:09,25:03:03,6/8/2019,72143094,471.96,3,"Whether may successful task Democrat data. Hit thousand option music assume mouth spend. Where kind reason section PM.
Per what speech language none. Early government more to establish beyond.",23:52:26,RTGS
AZVR85135161881683,GB95URAP17054870000917,5/17/2016,20334.37,100001,Y,Household Consumables,CHROME,POS,Dr,21:05:36,26:11:07,6/11/2019,37978433,473.1,7,Usually at total with several address single. Detail analysis civil. Ok picture focus suddenly risk. Stand relationship face.,23:53:00,DD
AZVR85135161881683,GB95URAP17054870000917,5/17/2016,19125.32,100001,Y,Medicals,FF,MOBILE,Dr,10:34:19,13:11:48,7/8/2019,28749967,1209.05,2,"Nor adult suddenly wish understand citizen address. Democrat mention year staff. Sister democratic half. Tonight I dog her rise truth.
Contain record maybe including process.",12:14:20,IMPS
AZVR85135161881683,GB95URAP17054870000917,5/17/2016,20334.37,100001,N,Credited,FF,POS,Cr,19:52:38,26:39:04,7/8/2019,53168986,1209.05,2,"Term vote few discover impact no. Population available car eat season really. Recent rise development society.
Stage might head enter. Air success life individual all. Home whole or much.",23:18:31,IMPS
AZVR85135161881683,GB95URAP17054870000917,5/17/2016,21895.28,100001,N,Credited,SAFARI,MOBILE,Cr,6:07:53,12:50:02,7/12/2019,2980997,1560.91,6,"Least cover fly culture firm. Local itself itself out Congress paper low. Watch know every by southern.
Skill young beyond foreign cut never best. Piece his instead president every statement.",9:40:33,CHEQUE
AZVR85135161881683,GB95URAP17054870000917,5/17/2016,20334.37,100001,Y,Personal Care,SAFARI,MOBILE,Dr,16:53:19,20:54:26,7/12/2019,761819,1560.91,3,"Style skin fast someone. Strategy win why space require speech here. Fast big show heart.
Like enjoy to hour important young. Without fast opportunity worry way join better bring.",17:55:40,RTGS
AZVR85135161881683,GB95URAP17054870000917,5/17/2016,21989.63,100001,N,Credited,SAFARI,POS,Cr,7:49:08,10:15:43,7/13/2019,31949699,1655.26,3,Yourself or tree board investment herself management detail. Economy quality participant dream keep little. Tell hand arrive then even agree.,9:22:08,RTGS
AZVR85135161881683,GB95URAP17054870000917,5/17/2016,20334.37,100001,Y,Utilities,MI,MOBILE,Dr,11:43:00,14:02:27,7/13/2019,92042162,1655.26,3,"More move traditional happen stand. Professor sort attention rise.
Must hand such. Consumer before next low itself itself pass.
Bank sure tend view Mr. Response rise scene reflect fill public.",13:15:20,RTGS
AZVR85135161881683,GB95URAP17054870000917,5/17/2016,18679.11,100001,Y,Medicals,FF,POS,Dr,16:29:46,19:01:08,7/13/2019,7755743,1655.26,7,Government billion sport daughter. I morning especially loss usually.,18:01:14,DD
AZVR85135161881683,GB95URAP17054870000917,5/17/2016,17023.85,100001,Y,Dining,OPERA,POS,Dr,19:36:14,22:37:32,7/13/2019,22360472,1655.26,6,"Else since production bill. Them mean support management.
Grow citizen recent. Fall later light foreign coach. This thus drug become billion voice focus.",21:52:41,CHEQUE
AZVR85135161881683,GB95URAP17054870000917,5/17/2016,16110.05,100001,Y,Utilities,EDGE,MOBILE,Dr,18:01:43,23:56:31,7/14/2019,58585870,913.8,7,"Scientist conference indeed around piece performance. And easy win or relate.
Know ground present look follow. Available model skin cost.",22:12:40,DD
AZVR85135161881683,GB95URAP17054870000917,5/17/2016,16446.52,100001,N,Credited,OPERA,POS,Cr,9:09:12,15:47:56,7/28/2019,30090866,336.47,4,Image little strong husband. Past main claim serious everyone. Agency fill reduce security total management sign. Prove garden successful contain else each.,11:48:36,UPI
AZVR85135161881683,GB95URAP17054870000917,5/17/2016,16782.99,100001,N,Credited,IE,POS,Cr,22:18:27,26:28:02,7/28/2019,51054441,336.47,2,Note camera local. Expect official center show total family nice. Seven eye reason certain sell all religious. Represent stock especially week second.,23:14:49,IMPS
AZVR85135161881683,GB95URAP17054870000917,5/17/2016,14963.7,100001,Y,Dining,SAFARI,PC,Dr,3:31:24,6:36:11,8/12/2019,63632583,1819.29,3,"Increase president trouble sell modern environment. At radio social hard.
Apply take make carry seat he project pretty. Law building material subject test authority make more.",5:10:30,RTGS
AZVR85135161881683,GB95URAP17054870000917,5/17/2016,13144.41,100001,Y,Entertainment,OPERA,POS,Dr,8:48:16,11:38:08,8/12/2019,87477504,1819.29,7,Support spring myself our. South person here federal everything respond run throughout. None sign college change final western full. Actually light group thing campaign.,10:24:01,DD
AZVR85135161881683,GB95URAP17054870000917,5/17/2016,14963.7,100001,N,Credited,FF,MOBILE,Cr,14:03:35,15:56:39,8/12/2019,49007367,1819.29,1,"Far morning though middle difficult officer realize. Manage there writer exist. Live team from wide.
Attention bed month institution time article. Big see sound adult.",15:08:43,NEFT
AZVR85135161881683,GB95URAP17054870000917,5/17/2016,16782.99,100001,N,Credited,FF,POS,Cr,17:47:34,20:07:12,8/12/2019,78654273,1819.29,7,"Or include performance officer others forget next. Rich all heart old loss politics catch.
Admit moment door move relationship. On leave discover ever a describe oil.",18:26:07,DD
AZVR85135161881683,GB95URAP17054870000917,5/17/2016,14963.7,100001,Y,Household Consumables,IE,MOBILE,Dr,20:36:14,24:14:22,8/12/2019,69931154,1819.29,5,General her explain probably occur push question wife. Wish reason these. Budget value perhaps president opportunity.,22:33:34,CARDS
AZVR85135161881683,GB95URAP17054870000917,5/17/2016,16920.77,100001,N,Credited,FF,MOBILE,Cr,2:46:37,6:24:33,8/17/2019,43647392,1957.07,1,"Authority probably talk will mention play. Relationship plant people create. Former hand recently expect hair benefit forward.
Mission long outside fly. Spring spend now thing finish analysis.",4:57:44,NEFT
AZVR85135161881683,GB95URAP17054870000917,5/17/2016,14963.7,100001,Y,Household Consumables,FF,MOBILE,Dr,13:11:58,14:42:37,8/17/2019,36386116,1957.07,3,"Former yeah type. Allow course next may out. Smile set street power without.
Always source leader hot decision production discuss. South begin meet me table. Car sure back music no issue.",14:06:18,RTGS
AZVR85135161881683,GB95URAP17054870000917,5/17/2016,16920.77,100001,N,Credited,OPERA,MOBILE,Cr,14:45:03,19:16:21,8/17/2019,24465090,1957.07,1,Accept too knowledge once identify play. Section consumer speech game career. Strategy product country thought material relate.,17:01:02,NEFT
AZVR85135161881683,GB95URAP17054870000917,5/17/2016,18877.84,100001,N,Credited,OPERA,POS,Cr,20:46:46,24:03:10,8/17/2019,36641123,1957.07,6,Form somebody company state if. Run on why rate. Society event practice before.,23:03:52,CHEQUE
AZVR85135161881683,GB95URAP17054870000917,5/17/2016,18470.37,100001,Y,Household Consumables,OPERA,POS,Dr,13:53:39,19:43:33,8/21/2019,46870568,407.47,6,"Away magazine coach ahead. Less food be window pay. Old through protect she.
Who miss something public fly someone. News where team development dog include.",16:59:38,CHEQUE
AZVR85135161881683,GB95URAP17054870000917,5/17/2016,17641,100001,Y,Personal Care,MI,MOBILE,Dr,4:27:10,6:27:34,8/23/2019,29533732,829.37,4,Product computer recognize former. Into pass author life rock throughout begin. Senior course go record daughter parent model.,5:47:08,UPI
AZVR85135161881683,GB95URAP17054870000917,5/17/2016,18470.37,100001,N,Credited,EDGE,POS,Cr,11:55:55,14:35:05,8/23/2019,3251317,829.37,4,"Deep three room exactly. Future among worker front police per.
Business early hotel drive beyond both support. Couple six worker water ten conference.",12:54:47,UPI
AZVR85135161881683,GB95URAP17054870000917,5/17/2016,17641,100001,Y,Dining,IE,MOBILE,Dr,13:35:41,16:18:21,8/23/2019,63361346,829.37,3,"Score gas training can. Suddenly continue imagine behavior herself purpose free.
Improve my table field not.",14:56:13,RTGS
AZVR85135161881683,GB95URAP17054870000917,5/17/2016,16811.63,100001,Y,Utilities,MI,POS,Dr,21:04:34,24:32:26,8/23/2019,46258793,829.37,6,"Spend care minute window want effort specific. Cover throughout watch.
Structure wait majority friend throughout budget. Position happen if future culture smile. Explain magazine process coach cold.",22:51:36,CHEQUE
AZVR85135161881683,GB95URAP17054870000917,5/17/2016,16904.83,100001,N,Credited,MI,POS,Cr,16:04:18,26:14:09,9/9/2019,29393343,93.2,2,Long speak reason argue different before bit. Simple rule event student true person.,21:28:02,IMPS
AZVR85135161881683,GB95URAP17054870000917,5/17/2016,16523.28,100001,Y,Household Consumables,SAFARI,MOBILE,Dr,10:30:41,14:40:34,9/10/2019,37714048,381.55,2,"Three since less reach involve argue carry. Idea remember improve then son stage. Way enough subject boy.
Popular should other something own model security. Heart policy become level.",11:56:48,IMPS
AZVR85135161881683,GB95URAP17054870000917,5/17/2016,16141.73,100001,Y,Groceries,SAFARI,PC,Dr,14:32:40,18:05:22,9/10/2019,24609463,381.55,5,"Today call letter sea cold news boy. Show institution join lot.
Participant tough daughter career property job key. Identify within organization ask movie. Where sometimes girl brother.",16:31:34,CARDS
AZVR85135161881683,GB95URAP17054870000917,5/17/2016,16523.28,100001,N,Credited,FF,POS,Cr,20:08:13,22:18:21,9/10/2019,72391402,381.55,3,Finally fine of focus. Door hit discover former another senior detail. Tax interview subject evidence focus carry soldier. Travel show perform free time upon.,20:45:23,RTGS
AZVR85135161881683,GB95URAP17054870000917,5/17/2016,17238.26,100001,N,Credited,OPERA,POS,Cr,12:25:41,15:12:59,9/22/2019,17189804,714.98,2,"Yard series with manager. Movie speak sometimes our increase me. Several structure price natural.
Begin impact during marriage off coach. Treat fish population up.",14:22:51,IMPS
AZVR85135161881683,GB95URAP17054870000917,5/17/2016,17953.24,100001,N,Credited,MI,PC,Cr,13:33:58,19:31:39,9/22/2019,57208640,714.98,4,Away claim discuss however later recently. Yard marriage sport view whatever from whole purpose. Eat lay economy argue personal away reveal tend.,17:28:47,UPI
AZVR85135161881683,GB95URAP17054870000917,5/17/2016,17752.97,100001,Y,Medicals,FF,MOBILE,Dr,6:20:38,8:13:54,9/24/2019,38848087,200.27,7,"Industry scientist model vote. Nation win citizen test dog. Today his help.
Issue guess purpose people. Result it worker early ago easy. Student last believe scene wide movie.",7:21:36,DD
AZVR85135161881683,GB95URAP17054870000917,5/17/2016,17953.24,100001,N,Credited,OPERA,MOBILE,Cr,13:19:32,17:36:13,9/24/2019,52521171,200.27,4,Others team effort father figure company manage. Spend push quality style follow agent. Quite great nor teach certainly player board.,15:23:25,UPI
AZVR85135161881683,GB95URAP17054870000917,5/17/2016,17752.97,100001,Y,Insurance,MI,PC,Dr,17:44:43,23:32:11,9/24/2019,98909643,200.27,4,"Reveal explain action quickly door civil. Catch whose nation worry phone.
Pattern phone fund. Various I campaign design event effect describe. While design own general.",20:40:02,UPI
AZVR85135161881683,GB95URAP17054870000917,5/17/2016,17190.86,100001,Y,Rent,FF,POS,Dr,16:34:40,25:50:55,10/17/2019,94115086,562.11,3,"Foot music still white. Customer pay major tax strategy guess course.
Pattern service major contain fear. Glass subject garden child. Activity pull simply there necessary blue.",21:26:31,RTGS
AZVR85135161881683,GB95URAP17054870000917,5/17/2016,15954,100001,Y,Entertainment,OPERA,POS,Dr,14:04:35,16:35:20,10/19/2019,88258829,1236.86,2,"Dinner expect physical all American cultural type.
Lead call everything ever focus big be. Account class support relationship until effort daughter to.",15:20:42,IMPS
AZVR85135161881683,GB95URAP17054870000917,5/17/2016,17632.53,100001,N,Credited,OPERA,POS,Cr,6:45:43,10:33:04,10/22/2019,65449042,1678.53,4,"Final old try mention. Add key stand shoulder. Ability democratic east.
Why sport head wife station.",8:52:05,UPI
AZVR85135161881683,GB95URAP17054870000917,5/17/2016,15954,100001,Y,Transportation,EDGE,POS,Dr,11:06:52,13:31:03,10/22/2019,30174948,1678.53,7,"Tax decade cell people security involve mean.
They seven without identify pretty alone hair per. Still series low group brother billion recent natural. Option painting up her. Trip yeah his mother.",12:59:03,DD
AZVR85135161881683,GB95URAP17054870000917,5/17/2016,14275.47,100001,Y,Personal Care,FF,MOBILE,Dr,16:43:47,20:29:53,10/22/2019,6255534,1678.53,7,"Morning ask hear up give arrive mean. Network from until cause still.
Value while five serious from current. Black half hope word effort society respond. Old source blood know great couple maybe his.",19:01:08,DD
AZVR85135161881683,GB95URAP17054870000917,5/17/2016,12596.94,100001,Y,Entertainment,FF,POS,Dr,19:58:14,23:14:46,10/22/2019,47136946,1678.53,5,"Type management that general. Because now former movie choose morning house ball.
College building yourself state card. Learn possible discussion huge fall.",21:49:09,CARDS
AZVR85135161881683,GB95URAP17054870000917,5/17/2016,12795.22,100001,N,Credited,CHROME,POS,Cr,6:23:25,7:51:39,10/24/2019,64750620,198.28,2,Cold finally relate through total visit mean. Themselves thought art measure assume thank. Back debate wide including stand near after. Other lead cup individual involve voice the.,7:07:06,IMPS
AZVR85135161881683,GB95URAP17054870000917,5/17/2016,12596.94,100001,Y,Insurance,SAFARI,PC,Dr,8:16:55,11:34:53,10/24/2019,57764054,198.28,3,"Section care agreement yard travel century. Our project adult political guy. So part go society nice city audience measure.
Man while trip build. Room miss lawyer letter. Smile senior place lot.",9:57:23,RTGS
AZVR85135161881683,GB95URAP17054870000917,5/17/2016,12795.22,100001,N,Credited,OPERA,PC,Cr,16:14:17,18:11:19,10/24/2019,93617697,198.28,6,"Dark tough alone hotel pass ball. Imagine because gas truth. Thousand radio brother. Physical class have role billion nor.
Rule tree there walk test last study join. Daughter hear standard dark law.",17:06:37,CHEQUE
AZVR85135161881683,GB95URAP17054870000917,5/17/2016,12993.5,100001,N,Credited,EDGE,POS,Cr,18:21:44,22:43:34,10/24/2019,31102971,198.28,5,Really woman notice against identify during subject. Teach fast experience series. Serious spring brother travel assume outside charge. What draw while early enjoy stage.,20:25:10,CARDS
AZVR85135161881683,GB95URAP17054870000917,5/17/2016,14512.55,100001,N,Credited,FF,POS,Cr,6:20:31,9:41:12,10/27/2019,2122564,1519.05,7,Really you so draw while American down. Positive book agent east sing bit suggest. Heavy all where long song your direction leader.,9:00:48,DD
AZVR85135161881683,GB95URAP17054870000917,5/17/2016,16031.6,100001,N,Credited,MI,PC,Cr,15:58:49,18:05:24,10/27/2019,58636824,1519.05,2,"Cultural quite open born wonder think. Year conference vote those allow wear talk.
Once various specific forget public when real.",16:54:58,IMPS
AZVR85135161881683,GB95URAP17054870000917,5/17/2016,17550.65,100001,N,Credited,OPERA,MOBILE,Cr,18:43:43,23:13:34,10/27/2019,92773523,1519.05,2,Congress center time dream world seat young. Individual budget customer natural once any. Part attention anything.,21:43:14,IMPS
AZVR85135161881683,GB95URAP17054870000917,5/17/2016,19385.57,100001,N,Credited,IE,POS,Cr,4:40:43,6:01:37,11/3/2019,96256190,1834.92,5,Lay possible current environment reason improve simple. Marriage structure do eye themselves message. Professor within somebody animal decade bit.,5:28:39,CARDS
AZVR85135161881683,GB95URAP17054870000917,5/17/2016,21220.49,100001,N,Credited,EDGE,POS,Cr,7:42:43,9:31:59,11/3/2019,10448410,1834.92,3,"Nothing piece less pay first. Goal color health how use again will bad.
Gas grow commercial media authority top road. Market attorney someone time. Audience time human.",8:14:17,RTGS
AZVR85135161881683,GB95URAP17054870000917,5/17/2016,23055.41,100001,N,Credited,CHROME,MOBILE,Cr,13:45:44,16:34:08,11/3/2019,26279220,1834.92,5,Just produce say when later develop space. Very sea friend character attention similar to. None computer kid stage realize continue order. Child star report never large about stop.,14:55:01,CARDS
AZVR85135161881683,GB95URAP17054870000917,5/17/2016,24890.33,100001,N,Credited,IE,PC,Cr,16:13:00,18:17:07,11/3/2019,75316075,1834.92,3,"Enter thousand guy fish last. Child well reflect cultural care enough approach.
Pick of but hope. Night of night yet evidence you positive. Fast information though time prove hope them.",17:30:31,RTGS
AZVR85135161881683,GB95URAP17054870000917,5/17/2016,23055.41,100001,Y,Insurance,EDGE,MOBILE,Dr,22:12:48,25:01:29,11/3/2019,78431874,1834.92,1,"Able have mean discuss popular often. West should hard put current magazine.
Always maintain oil whom goal anyone member region. Sell year focus what.
Partner especially field believe.",23:12:45,NEFT
AZVR85135161881683,GB95URAP17054870000917,5/17/2016,22328.02,100001,Y,Insurance,EDGE,MOBILE,Dr,5:42:32,9:01:46,11/6/2019,12222179,727.39,5,"Skin see size citizen soldier must. Attack environment answer stand loss.
Ahead traditional collection be analysis whole. Ten serve someone much huge unit low.",7:14:17,CARDS
AZVR85135161881683,GB95URAP17054870000917,5/17/2016,23055.41,100001,N,Credited,OPERA,MOBILE,Cr,10:58:00,12:50:32,11/6/2019,3693520,727.39,1,More candidate rock window learn spend. Model professor challenge throw perform focus organization. Something find world cell those leg middle.,11:53:17,NEFT
AZVR85135161881683,GB95URAP17054870000917,5/17/2016,23782.8,100001,N,Credited,FF,MOBILE,Cr,14:48:00,16:30:48,11/6/2019,15991010,727.39,1,Return boy significant this involve partner. Discuss late work continue interesting soldier right good. Sort strong military sing capital. Economic ability minute traditional performance drive.,15:19:19,NEFT
AZVR85135161881683,GB95URAP17054870000917,5/17/2016,24510.19,100001,N,Credited,IE,MOBILE,Cr,15:31:11,18:15:53,11/6/2019,42928218,727.39,5,"Discover sing suffer.
Tax military former pay writer pay north concern. Including even professional hair grow trouble sister. Eight painting one when remember visit.",17:11:48,CARDS
AZVR85135161881683,GB95URAP17054870000917,5/17/2016,23782.8,100001,Y,Groceries,OPERA,MOBILE,Dr,18:23:29,22:12:48,11/6/2019,1091427,727.39,4,"Hotel poor doctor ground. Prevent design its special to. Door card civil wonder American decade.
Same charge carry general. Time picture box option live. Himself door study father all.",20:21:31,UPI
AZVR85135161881683,GB95URAP17054870000917,5/17/2016,25169.87,100001,N,Credited,OPERA,MOBILE,Cr,4:08:54,6:47:31,11/10/2019,66068051,1387.07,6,"Floor how consumer exist daughter free. Ball pass seem fear term wind.
Nothing simply once house.
Physical hotel no some. Note full nearly could discover notice.",5:53:11,CHEQUE
AZVR85135161881683,GB95URAP17054870000917,5/17/2016,26556.94,100001,N,Credited,FF,POS,Cr,8:08:55,10:51:12,11/10/2019,14085086,1387.07,5,"Close mouth clear exist long movie. Argue impact it.
According social true cause direction be purpose. He hospital old agency.",9:50:24,CARDS
AZVR85135161881683,GB95URAP17054870000917,5/17/2016,25169.87,100001,Y,Transportation,IE,MOBILE,Dr,11:28:01,13:54:51,11/10/2019,51179465,1387.07,6,Prepare hundred standard someone why. Final yeah save town structure audience nice until. These he color share bag.,13:01:42,CHEQUE
AZVR85135161881683,GB95URAP17054870000917,5/17/2016,23782.8,100001,Y,Dining,IE,PC,Dr,18:16:43,20:17:19,11/10/2019,39683472,1387.07,7,"School newspaper else guy amount. Girl believe any leave.
Mention author money think. Short two worry room figure forward.
Bar tree me adult enter. Travel age low effort.",19:22:15,DD
AZVR85135161881683,GB95URAP17054870000917,5/17/2016,22395.73,100001,Y,Online Shopping,OPERA,MOBILE,Dr,20:30:33,23:47:50,11/10/2019,95170237,1387.07,7,"Yourself put end worry pick laugh south. Tv kid customer institution particularly left.
Exactly five recently. Our score special do benefit. Task market major long drive modern.",22:15:42,DD
AZVR85135161881683,GB95URAP17054870000917,5/17/2016,24015.56,100001,N,Credited,IE,MOBILE,Cr,5:24:03,6:32:22,11/16/2019,19992884,1619.83,6,"Coach itself education order management. Behavior end board consider upon. College radio TV old from nothing.
Everyone free myself theory. Difference phone community.",5:55:45,CHEQUE
AZVR85135161881683,GB95URAP17054870000917,5/17/2016,22395.73,100001,Y,Rent,SAFARI,PC,Dr,9:53:25,12:19:02,11/16/2019,83708749,1619.83,6,Away social north high picture. Language commercial during decision enough base.,10:21:20,CHEQUE
AZVR85135161881683,GB95URAP17054870000917,5/17/2016,24015.56,100001,N,Credited,IE,POS,Cr,14:27:20,15:45:47,11/16/2019,90633638,1619.83,5,Road feeling then. Two drop agreement authority I. View realize individual exactly why civil case learn.,14:56:39,CARDS
AZVR85135161881683,GB95URAP17054870000917,5/17/2016,25635.39,100001,N,Credited,OPERA,POS,Cr,14:25:40,18:12:14,11/16/2019,63877915,1619.83,3,"Eye page hotel country after. Another fire rate American join else consider.
After heart sense. Career society value mother group. White education down some.",16:20:13,RTGS
AZVR85135161881683,GB95URAP17054870000917,5/17/2016,24015.56,100001,Y,Personal Care,IE,POS,Dr,18:44:50,21:31:31,11/16/2019,89134078,1619.83,5,"Wide study perform culture impact say police truth. Evidence wonder response sometimes performance. Understand there fall air.
Mother this after material system course main. Tonight enjoy and.",20:10:08,CARDS
AZVR85135161881683,GB95URAP17054870000917,5/17/2016,24242.31,100001,N,Credited,IE,PC,Cr,2:49:18,5:32:47,11/24/2019,32340945,226.75,1,"Run physical middle bad several any.
Maybe blue without produce relate. Claim piece expect benefit. Option city follow drug.",4:07:00,NEFT
AZVR85135161881683,GB95URAP17054870000917,5/17/2016,24015.56,100001,Y,Rent,SAFARI,PC,Dr,7:22:30,8:58:19,11/24/2019,2051062,226.75,7,"Actually TV beautiful good trial agree vote matter. Over with education military. Mission nation me.
Return investment spring author summer loss. Player here commercial determine knowledge.",8:15:22,DD
AZVR85135161881683,GB95URAP17054870000917,5/17/2016,24242.31,100001,N,Credited,EDGE,MOBILE,Cr,12:25:39,15:18:34,11/24/2019,60311412,226.75,6,"Ground fast fact learn despite. Admit alone study check against top very some.
Author best claim. Training site through table past staff.
Use seven kitchen smile. Culture be stay six ago.",14:04:42,CHEQUE
AZVR85135161881683,GB95URAP17054870000917,5/17/2016,24469.06,100001,N,Credited,CHROME,PC,Cr,18:17:49,20:53:00,11/24/2019,30557741,226.75,6,"Growth design offer success. Early member mother its.
Involve listen scientist class husband material. Situation control from smile throw they official onto.",19:09:19,CHEQUE
AZVR85135161881683,GB95URAP17054870000917,5/17/2016,24242.31,100001,Y,Medicals,OPERA,MOBILE,Dr,21:29:21,23:38:50,11/24/2019,4106128,226.75,7,Hope gas eat conference seven better family base. Similar imagine forward both. Ten exactly box leave different. Term feeling author ago.,22:34:36,DD
AZVR85135161881683,GB95URAP17054870000917,5/17/2016,25030.36,100001,N,Credited,OPERA,POS,Cr,8:06:49,10:32:55,11/26/2019,31151610,788.05,4,"Thought hundred perform list political. Big street garden person on.
Evidence range allow myself family.
Front ability serve last. Free majority office bed fire.",8:57:45,UPI
AZVR85135161881683,GB95URAP17054870000917,5/17/2016,25818.41,100001,N,Credited,CHROME,PC,Cr,14:50:18,19:13:31,11/26/2019,87285086,788.05,4,"Allow cut remain head lose idea. Simple understand which late close.
Guy party idea. They low edge heart huge. Character movie body experience.",17:32:06,UPI
AZVR85135161881683,GB95URAP17054870000917,5/17/2016,26606.46,100001,N,Credited,SAFARI,MOBILE,Cr,21:32:36,25:28:13,11/26/2019,11277019,788.05,1,"North down reality within.
Describe easy past. Tend huge kid.
Center because action show owner sort. Reflect watch can condition many prepare.",23:38:36,NEFT
AZVR85135161881683,GB95URAP17054870000917,5/17/2016,25007.6,100001,Y,Household Consumables,CHROME,POS,Dr,7:49:37,13:33:05,12/8/2019,3860489,1598.86,6,"Away church performance go remain news. Whom officer leg eye professional.
Fight even since reality scientist gas. Give member nation as rate could.",10:30:00,CHEQUE
AZVR85135161881683,GB95URAP17054870000917,5/17/2016,26606.46,100001,N,Credited,EDGE,MOBILE,Cr,21:47:22,25:40:04,12/8/2019,68038076,1598.86,2,Animal one call provide possible break. Arm reduce use east. Condition scientist whom we phone explain study.,23:48:00,IMPS
AZVR85135161881683,GB95URAP17054870000917,5/17/2016,26610.94,100001,N,Credited,CHROME,MOBILE,Cr,8:08:39,12:08:31,12/12/2019,34582886,4.48,7,Theory strategy benefit bill program woman similar green. Stage face decide specific off.,9:09:00,DD
AZVR85135161881683,GB95URAP17054870000917,5/17/2016,26615.42,100001,N,Credited,OPERA,MOBILE,Cr,16:09:36,20:18:41,12/12/2019,65724873,4.48,1,Player and issue consumer laugh prepare eye. Almost everything off painting challenge their major.,18:32:40,NEFT
AZVR85135161881683,GB95URAP17054870000917,5/17/2016,26382.9,100001,Y,Utilities,MI,PC,Dr,11:10:04,15:16:12,12/22/2019,37854287,232.52,5,"He factor no drug indeed. Air Republican under under executive toward such.
Section case inside force. No maintain require dinner.",12:44:16,CARDS
AZVR85135161881683,GB95URAP17054870000917,5/17/2016,26150.38,100001,Y,Personal Care,MI,POS,Dr,19:57:23,22:32:57,12/22/2019,16197640,232.52,7,"Stock before student.
Price able candidate art. Nature program future interest about.
Responsibility laugh she make. Protect military factor once.",21:29:53,DD
AZVR85135161881683,GB95URAP17054870000917,5/17/2016,26080.88,100001,Y,Dining,CHROME,POS,Dr,6:11:50,10:51:52,12/24/2019,99250157,69.5,4,Drop film century mission bill themselves if these. Drive rate read camera.,8:09:41,UPI
AZVR85135161881683,GB95URAP17054870000917,5/17/2016,26011.38,100001,Y,Household Consumables,MI,POS,Dr,12:26:25,15:07:46,12/24/2019,9243972,69.5,1,"Then box certainly arm strategy. Once hand church whole result front hotel.
Understand image music cup how enough. Economic travel itself partner. Do bill information any data president form.",14:17:50,NEFT
AZVR85135161881683,GB95URAP17054870000917,5/17/2016,26080.88,100001,N,Credited,MI,POS,Cr,18:57:48,22:18:19,12/24/2019,55267588,69.5,2,"Book themselves month level. Government stay would total oil actually heart.
Require dream myself sort program. Election approach tonight left.",19:33:58,IMPS
AZVR85135161881683,GB95URAP17054870000917,5/17/2016,26444.72,100001,N,Credited,SAFARI,PC,Cr,5:40:41,8:36:27,1/6/2020,30428287,363.84,4,"Save coach cup expert brother might join hand. Man him fast side short perhaps.
Gun hour catch page. Size best ever.",6:50:04,UPI
AZVR85135161881683,GB95URAP17054870000917,5/17/2016,26080.88,100001,Y,Transportation,CHROME,POS,Dr,9:06:29,12:31:26,1/6/2020,68945923,363.84,5,"When from eat of.
Mean he group necessary in. Painting western year hot grow nice. Necessary anything east space class affect campaign.",10:53:45,CARDS
AZVR85135161881683,GB95URAP17054870000917,5/17/2016,25717.04,100001,Y,Groceries,IE,POS,Dr,13:13:35,16:30:24,1/6/2020,44313005,363.84,3,Give never level direction toward. Various quite actually style Republican TV chance language.,14:51:20,RTGS
AZVR85135161881683,GB95URAP17054870000917,5/17/2016,26080.88,100001,N,Credited,FF,MOBILE,Cr,16:00:50,17:43:39,1/6/2020,83510441,363.84,6,"Game against only just. Religious leave face follow yet. It us follow mind too agency.
Available program manage response some evening. Choice party society.",17:06:06,CHEQUE
AZVR85135161881683,GB95URAP17054870000917,5/17/2016,25717.04,100001,Y,Transportation,FF,PC,Dr,20:59:16,22:46:53,1/6/2020,78805583,363.84,4,And bar well sell simple record. Difficult Mrs growth want suggest least just. They claim eat drug majority sometimes exactly.,21:36:58,UPI
AZVR85135161881683,GB95URAP17054870000917,5/17/2016,23982.26,100001,Y,Dining,OPERA,MOBILE,Dr,8:49:00,15:46:36,1/7/2020,47312364,1734.78,6,"Effect say agent authority human year over. Occur system would central American. Trial soldier common head force per.
Report little question those stay. According mother activity expect.",12:16:38,CHEQUE
AZVR85135161881683,GB95URAP17054870000917,5/17/2016,22247.48,100001,Y,Entertainment,IE,POS,Dr,12:22:48,17:31:52,1/7/2020,67535026,1734.78,5,"Hope air throughout real lot big together visit. Since pretty science national right hold something.
Hundred mission morning. By compare loss eat however.",16:02:15,CARDS
AZVR85135161881683,GB95URAP17054870000917,5/17/2016,22059.02,100001,Y,Personal Care,EDGE,PC,Dr,7:40:09,14:03:23,1/8/2020,61379626,188.46,3,"Short hit collection college. Without news beautiful many.
Nice in now program court weight suddenly trade. Cause sign conference person adult. Do social hand always close edge.",12:06:47,RTGS
AZVR85135161881683,GB95URAP17054870000917,5/17/2016,22118.11,100001,N,Credited,EDGE,MOBILE,Cr,5:33:37,9:18:44,1/26/2020,18956726,59.09,3,Resource difficult today rich decision mind. Serious scene area wide kitchen. Mind goal relate focus offer TV bag. Business box individual detail no card but.,8:14:59,RTGS
AZVR85135161881683,GB95URAP17054870000917,5/17/2016,22059.02,100001,Y,Household Consumables,IE,MOBILE,Dr,11:20:50,14:08:25,1/26/2020,26029986,59.09,6,Entire occur prove wife. As age now on president. No medical nothing clearly it security recent.,13:00:54,CHEQUE
AZVR85135161881683,GB95URAP17054870000917,5/17/2016,22118.11,100001,N,Credited,SAFARI,MOBILE,Cr,19:54:28,23:13:30,1/26/2020,19008097,59.09,4,"Soldier threat rock age baby. Place our American second seat cover everything provide.
Door another several argue sea force. Scientist learn reflect after.",21:21:30,UPI
AZVR85135161881683,GB95URAP17054870000917,5/17/2016,20744.77,100001,Y,Utilities,FF,PC,Dr,15:56:15,20:41:38,1/30/2020,39642899,1373.34,2,"I loss book network yourself. Miss process seek difficult space also.
First song nothing pretty environment score do. Mother certainly different military money painting group.",19:18:02,IMPS
AZVR85135161881683,GB95URAP17054870000917,5/17/2016,21916.7,100001,N,Credited,MI,MOBILE,Cr,4:46:24,9:16:15,2/8/2020,47286825,1171.93,1,Generation before reduce paper scientist benefit. Herself lot really training front. Specific task son authority.,7:11:42,NEFT
AZVR85135161881683,GB95URAP17054870000917,5/17/2016,20744.77,100001,Y,Household Consumables,OPERA,PC,Dr,13:22:40,18:36:25,2/8/2020,84351692,1171.93,5,"Mr make read scene go.
Pretty test put suffer measure role culture. Individual left case pattern.",16:03:03,CARDS
AZVR85135161881683,GB95URAP17054870000917,5/17/2016,21916.7,100001,N,Credited,IE,POS,Cr,19:33:46,23:00:28,2/8/2020,50804832,1171.93,5,"Language read able physical various close will. Off than establish focus inside agreement. If page view lawyer.
Future study catch arm computer program. West name door foot.",20:20:56,CARDS
AZVR85135161881683,GB95URAP17054870000917,5/17/2016,21925.67,100001,N,Credited,EDGE,POS,Cr,7:02:45,9:47:38,2/15/2020,49190991,8.97,3,"Effect I food message. I cold conference once.
Operation find policy administration may. Group five but account figure.",9:09:44,RTGS
AZVR85135161881683,GB95URAP17054870000917,5/17/2016,21934.64,100001,N,Credited,MI,PC,Cr,9:58:13,13:17:02,2/15/2020,79225786,8.97,1,"Sit course worry foreign reveal. National thought lawyer increase social eat big. Series event decision campaign.
Sometimes resource just player analysis. Sense draw activity interest.",11:44:05,NEFT
AZVR85135161881683,GB95URAP17054870000917,5/17/2016,21943.61,100001,N,Credited,IE,PC,Cr,12:22:24,16:30:10,2/15/2020,28229117,8.97,1,"Better five floor actually because house huge. Enjoy have who. Customer fear note suffer ok area know sign.
Food item manage unit. Democratic table model according community evening science.",14:35:56,NEFT
AZVR85135161881683,GB95URAP17054870000917,5/17/2016,21952.58,100001,N,Credited,EDGE,MOBILE,Cr,21:48:44,25:08:04,2/15/2020,48429092,8.97,4,"Discuss any material.
Law national star level choose. Crime former moment. Member city civil image.
Already task language. Environment fire arm necessary member. After be finish law college foot.",23:04:36,UPI
AZVR85135161881683,GB95URAP17054870000917,5/17/2016,20408.67,100001,Y,Personal Care,MI,PC,Dr,5:59:34,12:10:36,2/17/2020,52693069,1543.91,4,"Since girl investment girl cell in beat. After whom maybe how subject Democrat truth.
Fire without manager audience future police. Message century bring tough. Wall tough war base.",8:52:38,UPI
AZVR85135161881683,GB95URAP17054870000917,5/17/2016,18864.76,100001,Y,Utilities,OPERA,MOBILE,Dr,12:19:12,19:46:53,2/17/2020,90297953,1543.91,1,"Nice huge assume attorney final American. Small push military.
Once social real doctor. Show option go could.
Effect almost student attention white if brother industry. Look skill animal left shake.",16:09:11,NEFT
AZVR85135161881683,GB95URAP17054870000917,5/17/2016,20835.11,100001,N,Credited,OPERA,POS,Cr,5:37:24,9:49:15,2/24/2020,66355779,1970.35,1,Various international six different law movie scientist. Style before pattern us specific. Campaign assume more writer child American.,8:31:33,NEFT
AZVR85135161881683,GB95URAP17054870000917,5/17/2016,18864.76,100001,Y,Entertainment,IE,MOBILE,Dr,11:46:15,15:07:33,2/24/2020,72751121,1970.35,6,"Onto almost chance age huge attention. Bit floor management avoid me already exist set.
White forward view energy. Member size care real job opportunity.",13:23:44,CHEQUE
AZVR85135161881683,GB95URAP17054870000917,5/17/2016,20835.11,100001,N,Credited,CHROME,POS,Cr,18:37:25,20:55:45,2/24/2020,62936729,1970.35,6,"Very then three such. Fill exactly quickly.
Key tonight remember attorney number. Fund little foreign line break list forget. While key still claim.",19:20:00,CHEQUE
AZVR85135161881683,GB95URAP17054870000917,5/17/2016,20479.98,100001,Y,Rent,FF,POS,Dr,9:38:26,21:13:15,3/10/2020,83069123,355.13,3,"Method themselves lawyer entire.
Until plan clearly certainly which degree.
While sort finally here cup. Card camera often clearly bag.",15:33:15,RTGS
AZVR85135161881683,GB95URAP17054870000917,5/17/2016,20945.86,100001,N,Credited,EDGE,PC,Cr,5:10:54,8:14:59,3/16/2020,22687258,465.88,6,Direction hit certainly month find despite central. Easy somebody front write.,6:53:31,CHEQUE
AZVR85135161881683,GB95URAP17054870000917,5/17/2016,20479.98,100001,Y,Insurance,IE,PC,Dr,9:10:50,11:59:55,3/16/2020,41473382,465.88,2,Community keep strong discuss single up federal. Energy sign reflect ability. Body medical impact mention. Letter also activity in.,10:39:17,IMPS
AZVR85135161881683,GB95URAP17054870000917,5/17/2016,20014.1,100001,Y,Household Consumables,EDGE,POS,Dr,13:51:59,16:15:33,3/16/2020,12235544,465.88,1,"Nearly majority million without morning best lose. Property collection yard measure concern around these.
Face claim million decade nothing hand fight.",14:38:11,NEFT
AZVR85135161881683,GB95URAP17054870000917,5/17/2016,20479.98,100001,N,Credited,SAFARI,POS,Cr,16:21:29,17:38:31,3/16/2020,66666394,465.88,4,Approach challenge drive whom loss. Least wind trouble take see eat fall.,16:58:24,UPI
AZVR85135161881683,GB95URAP17054870000917,5/17/2016,20014.1,100001,Y,Rent,SAFARI,PC,Dr,21:17:49,23:29:30,3/16/2020,17519816,465.88,7,"Write administration strategy necessary. Wife along according cell how cell new. Owner upon meet economy score yes.
Camera size responsibility eat. Discuss allow wind nice air official account late.",22:19:37,DD
AZVR85135161881683,GB95URAP17054870000917,5/17/2016,18522.17,100001,Y,Household Consumables,IE,POS,Dr,5:12:05,8:27:12,3/23/2020,57697888,1491.93,4,Hot affect across challenge maintain sound thing anyone. Truth learn hard life response throw. Away support industry hospital.,7:18:15,UPI
AZVR85135161881683,GB95URAP17054870000917,5/17/2016,17030.24,100001,Y,Medicals,FF,POS,Dr,10:09:02,12:17:22,3/23/2020,54300590,1491.93,5,"Black strong try simple body our eye. Enter view company pretty.
Sign defense decide off professor Mrs modern. Side certainly break nor line find want.",10:57:14,CARDS
AZVR85135161881683,GB95URAP17054870000917,5/17/2016,18522.17,100001,N,Credited,CHROME,MOBILE,Cr,13:31:49,16:14:28,3/23/2020,3161531,1491.93,6,"Author day represent information most. Similar tell a discuss specific season. Look movement police either.
Step one on tell open. Impact green produce authority sea property rule state.",15:16:15,CHEQUE
AZVR85135161881683,GB95URAP17054870000917,5/17/2016,17030.24,100001,Y,Utilities,MI,MOBILE,Dr,17:14:26,19:45:18,3/23/2020,4369363,1491.93,4,"Father tonight paper family including sea. Individual recently because member suggest situation.
News few I certainly recent probably. Establish measure over through doctor. Read kind help product.",19:12:27,UPI
AZVR85135161881683,GB95URAP17054870000917,5/17/2016,15458.61,100001,Y,Transportation,FF,MOBILE,Dr,8:57:58,11:56:40,3/26/2020,45625688,1571.63,6,After carry throughout picture trial. Physical consider you appear soon. Foreign take example bag little.,10:29:18,CHEQUE
AZVR85135161881683,GB95URAP17054870000917,5/17/2016,13886.98,100001,Y,Utilities,FF,PC,Dr,15:22:50,18:01:13,3/26/2020,21519123,1571.63,1,Rest six sing beyond lay. Line true power involve sense between coach. Certainly attorney accept ago culture city. Current either keep.,17:17:40,NEFT
AZVR85135161881683,GB95URAP17054870000917,5/17/2016,15458.61,100001,N,Credited,OPERA,POS,Cr,19:58:47,22:49:46,3/26/2020,22181602,1571.63,1,"Foot fly old view behind. Think speak end executive each lawyer team.
Site bed attack can address.
Trial response develop foot middle. Firm action employee. Read edge story left bed stand kid.",21:38:47,NEFT
AZVR85135161881683,GB95URAP17054870000917,5/17/2016,15808.26,100001,N,Credited,CHROME,POS,Cr,13:58:59,22:08:24,4/5/2020,23922952,349.65,6,"North we begin among. Majority head either make. Save newspaper course such part international.
Article section particularly history.",18:09:44,CHEQUE
AZVR85135161881683,GB95URAP17054870000917,5/17/2016,14155.84,100001,Y,Household Consumables,FF,PC,Dr,5:25:08,8:20:28,4/18/2020,28034803,1652.42,6,"Policy learn certain against put it and stop.
Start station issue make degree pretty. A walk later. South get model along.
Agency reveal few number. Person moment subject act million nor.",6:44:52,CHEQUE
AZVR85135161881683,GB95URAP17054870000917,5/17/2016,12503.42,100001,Y,Medicals,MI,MOBILE,Dr,7:58:04,11:16:26,4/18/2020,40578156,1652.42,7,"Become win check see talk read PM. Picture defense floor. Throw more relate difference.
Lead attack relate movie tree a.
Nature let say. Carry citizen fine crime onto dinner serve.",9:30:06,DD
AZVR85135161881683,GB95URAP17054870000917,5/17/2016,14155.84,100001,N,Credited,EDGE,PC,Cr,14:01:34,15:56:38,4/18/2020,96877036,1652.42,6,Walk education kind yet happen loss foot. Far daughter wind both by ever interesting worker.,15:07:34,CHEQUE
AZVR85135161881683,GB95URAP17054870000917,5/17/2016,15808.26,100001,N,Credited,OPERA,PC,Cr,17:54:14,20:38:15,4/18/2020,967143,1652.42,2,"Seem argue break shake word. Personal for always every night three. Win full range lot level teacher.
No man his live race behind evening. Staff car into physical yard him stage.",19:40:20,IMPS
AZVR85135161881683,GB95URAP17054870000917,5/17/2016,17460.68,100001,N,Credited,IE,POS,Cr,21:06:09,23:21:00,4/18/2020,16185647,1652.42,4,"Trade good leave laugh wonder treat politics. Environment voice thought career shake. Campaign glass onto step without.
Place might born foot break easy. Bring end worker benefit.",22:28:08,UPI
AZVR85135161881683,GB95URAP17054870000917,5/17/2016,18923.19,100001,N,Credited,CHROME,MOBILE,Cr,5:32:25,9:57:35,4/29/2020,52027802,1462.51,7,Control game structure follow particular energy no. Shoulder speak television government. Require low positive anything.,6:59:40,DD
AZVR85135161881683,GB95URAP17054870000917,5/17/2016,20385.7,100001,N,Credited,CHROME,PC,Cr,14:13:29,16:33:22,4/29/2020,45506710,1462.51,6,"Mrs civil form any tree.
Rate prepare adult picture. Tax pass moment nature fly prevent. Defense ahead southern under part family theory sign. Win upon central protect see letter century.",15:12:55,CHEQUE
AZVR85135161881683,GB95URAP17054870000917,5/17/2016,18923.19,100001,Y,Groceries,IE,MOBILE,Dr,17:16:14,20:41:35,4/29/2020,50671618,1462.51,6,All glass customer exactly bank. Officer into may sell enjoy interesting. Suddenly meeting chair anything rather suffer.,19:37:00,CHEQUE
AZVR85135161881683,GB95URAP17054870000917,5/17/2016,19568.67,100001,N,Credited,OPERA,MOBILE,Cr,10:50:00,15:36:14,5/9/2020,93719520,645.48,6,"It heart front subject. You sport debate Republican between close. The friend pay team.
Visit language send former activity. Conference capital treatment social.",13:12:06,CHEQUE
AZVR85135161881683,GB95URAP17054870000917,5/17/2016,17838.79,100001,Y,Rent,EDGE,POS,Dr,4:31:39,8:15:40,5/15/2020,57832234,1729.88,3,Democratic money think. Question great result its. Building training our concern style Democrat.,6:04:31,RTGS
AZVR85135161881683,GB95URAP17054870000917,5/17/2016,16108.91,100001,Y,Dining,EDGE,PC,Dr,11:24:44,13:52:16,5/15/2020,65470121,1729.88,5,Event suffer two food effect. None away five very vote. Week catch successful page so hour sea.,12:22:49,CARDS
AZVR85135161881683,GB95URAP17054870000917,5/17/2016,17838.79,100001,N,Credited,IE,POS,Cr,13:06:12,15:54:31,5/15/2020,98845804,1729.88,4,"Small billion stage yeah. Race cultural maintain.
Myself long hour tough. Lead amount key word join question tax. Author difficult that everything exactly central Democrat fill.",15:01:59,UPI
AZVR85135161881683,GB95URAP17054870000917,5/17/2016,19568.67,100001,N,Credited,MI,PC,Cr,19:48:49,23:36:26,5/15/2020,83201141,1729.88,4,"Particularly develop win religious. Ready drop soon.
Degree business require service writer. Us at lay remember might.",21:16:26,UPI
AZVR85135161881683,GB95URAP17054870000917,5/17/2016,18014.58,100001,Y,Medicals,IE,MOBILE,Dr,5:55:49,8:08:00,5/18/2020,64345703,1554.09,7,"Watch address Democrat stop business have end. Six successful federal today at.
Suddenly staff idea mind. Else safe movie degree center. Statement address war me task nature.",7:12:12,DD
AZVR85135161881683,GB95URAP17054870000917,5/17/2016,16460.49,100001,Y,Entertainment,FF,PC,Dr,9:34:09,12:13:23,5/18/2020,96371923,1554.09,3,Trade sport operation without capital several participant. Southern change blue employee go travel would. Message city speech industry mouth place product. Give deal ok keep.,11:28:34,RTGS
AZVR85135161881683,GB95URAP17054870000917,5/17/2016,18014.58,100001,N,Credited,CHROME,PC,Cr,10:54:16,14:17:47,5/18/2020,88429328,1554.09,1,"During push low former join generation.
Way beat late offer listen ball. Opportunity suggest over trouble.
Political whole scene when especially. Year adult likely guy. Year room decade day.",12:33:42,NEFT
AZVR85135161881683,GB95URAP17054870000917,5/17/2016,19568.67,100001,N,Credited,SAFARI,MOBILE,Cr,16:38:45,19:54:15,5/18/2020,75230029,1554.09,5,Herself send affect clear. Gas choice quality somebody candidate choose. Onto send size decade deal your.,18:12:26,CARDS
AZVR85135161881683,GB95URAP17054870000917,5/17/2016,21122.76,100001,N,Credited,EDGE,PC,Cr,19:37:00,23:25:00,5/18/2020,90676789,1554.09,3,"Management significant man bank discussion morning. But evening never might security. Song level budget herself might.
Central measure often system. Service senior allow cause smile memory.",21:29:00,RTGS
AZVR85135161881683,GB95URAP17054870000917,5/17/2016,19513.89,100001,Y,Insurance,OPERA,PC,Dr,6:38:45,9:22:53,5/21/2020,21616303,1608.87,6,"Why reflect six market billion president. Red worker degree language kitchen individual improve.
Star want four account from really bit nice. Student strategy at final. Here natural bank suffer let.",7:09:30,CHEQUE
AZVR85135161881683,GB95URAP17054870000917,5/17/2016,21122.76,100001,N,Credited,MI,POS,Cr,11:03:16,13:29:48,5/21/2020,62505710,1608.87,4,Explain speak stop last vote. Watch fight four his seem interesting close. National trouble seek information not expect.,11:52:24,UPI
AZVR85135161881683,GB95URAP17054870000917,5/17/2016,22731.63,100001,N,Credited,CHROME,MOBILE,Cr,13:29:55,16:27:40,5/21/2020,97968603,1608.87,1,"Property skill usually lot yet herself home. Political wall better choose purpose responsibility. Down there true attack news human.
Bar hospital inside able quality stock. Blue task son.",15:47:53,NEFT
AZVR85135161881683,GB95URAP17054870000917,5/17/2016,24340.5,100001,N,Credited,SAFARI,MOBILE,Cr,17:28:56,20:24:50,5/21/2020,44901097,1608.87,6,Support table scientist away out player draw. Away concern population kind put interview special treat. Husband institution product decide mouth.,19:14:38,CHEQUE
AZVR85135161881683,GB95URAP17054870000917,5/17/2016,25779.57,100001,N,Credited,FF,MOBILE,Cr,5:59:58,11:31:29,5/23/2020,69882708,1439.07,5,"Operation citizen down newspaper. Hear back a more we world.
Bit yes hope certain subject top financial.",9:23:45,CARDS
AZVR85135161881683,GB95URAP17054870000917,5/17/2016,24340.5,100001,Y,Transportation,MI,MOBILE,Dr,18:35:59,24:21:11,5/23/2020,96234990,1439.07,7,"Hundred project role always. Strong call special purpose own enjoy perform.
Bad thing pattern crime free. Why health along area enter should vote. Seat glass pay series loss alone behind.",22:04:37,DD
AZVR85135161881683,GB95URAP17054870000917,5/17/2016,23301.23,100001,Y,Transportation,CHROME,PC,Dr,3:33:14,5:31:44,5/25/2020,65800904,1039.27,2,"Remember probably approach but suddenly. Especially where trade trial article sometimes card. One item economic. Race idea phone kid total hour.
Evidence see yes executive.",4:22:38,IMPS
AZVR85135161881683,GB95URAP17054870000917,5/17/2016,24340.5,100001,N,Credited,SAFARI,MOBILE,Cr,9:04:41,11:15:02,5/25/2020,71081069,1039.27,3,"Reality exactly sign it style brother live. Seat art billion matter market finish though. College special up employee risk stage.
Husband thing car south official drop. Network really between fine.",10:14:14,RTGS
AZVR85135161881683,GB95URAP17054870000917,5/17/2016,23301.23,100001,Y,Transportation,SAFARI,POS,Dr,11:17:39,14:33:51,5/25/2020,74030880,1039.27,2,Paper feeling responsibility policy American four. Decide respond budget herself their move.,13:14:47,IMPS
AZVR85135161881683,GB95URAP17054870000917,5/17/2016,24340.5,100001,N,Credited,SAFARI,POS,Cr,18:15:33,20:17:21,5/25/2020,51901936,1039.27,6,"Program reflect watch policy view leg. Medical good know unit. Success beautiful something none bill remain measure.
Evening national cell really.",19:40:22,CHEQUE
AZVR85135161881683,GB95URAP17054870000917,5/17/2016,23301.23,100001,Y,Household Consumables,EDGE,PC,Dr,20:21:37,23:21:36,5/25/2020,98288632,1039.27,2,"Son never energy mother.
Sell owner enjoy on size how will. Early team performance including year brother.",21:54:35,IMPS
AZVR85135161881683,GB95URAP17054870000917,5/17/2016,21794.57,100001,Y,Entertainment,EDGE,POS,Dr,9:10:14,12:55:45,5/26/2020,89013182,1506.66,1,"Process but care phone into such bring. Water trouble thing nation less benefit quickly.
Shake stage development nature college. Age drop ten happy sing leave.",11:48:50,NEFT
AZVR85135161881683,GB95URAP17054870000917,5/17/2016,20287.91,100001,Y,Rent,CHROME,PC,Dr,15:07:32,19:11:31,5/26/2020,28949114,1506.66,6,"Crime major road fear official surface camera.
Go thousand rule require personal.
Exactly professor training medical attorney medical.",16:19:11,CHEQUE
AZVR85135161881683,GB95URAP17054870000917,5/17/2016,18781.25,100001,Y,Medicals,CHROME,PC,Dr,22:56:58,25:39:01,5/26/2020,75217327,1506.66,1,Charge leave moment live often set left middle. Huge daughter operation benefit street yes. West environmental rule case year current.,23:37:23,NEFT
AZVR85135161881683,GB95URAP17054870000917,5/17/2016,16918.47,100001,Y,Household Consumables,SAFARI,MOBILE,Dr,6:38:49,8:39:38,5/30/2020,56668483,1862.78,3,"Lay trip south chance today scene.
Area defense treatment clear. Or consider eat ball push.
Write act whether. Change worry including room. Side let dark.",7:15:42,RTGS
AZVR85135161881683,GB95URAP17054870000917,5/17/2016,15055.69,100001,Y,Dining,CHROME,POS,Dr,10:06:54,12:30:05,5/30/2020,75664510,1862.78,5,"Often pull doctor she suffer career game. Drop he trip some project. Yeah after under evening front easy series author.
Short center suffer scene food view. Detail gas rise huge.",11:25:50,CARDS
AZVR85135161881683,GB95URAP17054870000917,5/17/2016,13192.91,100001,Y,Groceries,IE,MOBILE,Dr,12:53:41,16:29:57,5/30/2020,33993980,1862.78,5,"Only business start personal include lead audience. Back in prevent fast recognize. Speak pay notice worry door keep imagine.
Continue American put site. Window energy matter left.",14:57:57,CARDS
AZVR85135161881683,GB95URAP17054870000917,5/17/2016,15055.69,100001,N,Credited,MI,MOBILE,Cr,18:31:12,21:30:53,5/30/2020,91504036,1862.78,2,"Worry available raise us save just they. Contain establish series guess possible.
Make but require kitchen list. Hand be message south his night.",20:40:01,IMPS
AZVR85135161881683,GB95URAP17054870000917,5/17/2016,14329.93,100001,Y,Medicals,FF,MOBILE,Dr,6:58:45,12:57:28,6/1/2020,258548,725.76,6,Around over memory physical whether. Management have there newspaper would old. My many or must stand need indeed.,10:45:36,CHEQUE
AZVR85135161881683,GB95URAP17054870000917,5/17/2016,15055.69,100001,N,Credited,IE,PC,Cr,13:54:03,19:31:20,6/1/2020,5125609,725.76,7,"Year market political compare sign.
Through claim across plant. Girl up cut sure standard tonight state. Doctor present in.",16:18:16,DD
AZVR85135161881683,GB95URAP17054870000917,5/17/2016,15800.06,100001,N,Credited,FF,PC,Cr,6:56:08,8:56:09,6/9/2020,21111341,744.37,6,"Share indeed film future beyond part think. Go who seek just wrong officer.
Open answer type of responsibility officer. Front ready manage attorney.",8:07:24,CHEQUE
AZVR85135161881683,GB95URAP17054870000917,5/17/2016,15055.69,100001,Y,Transportation,FF,POS,Dr,8:46:03,11:41:32,6/9/2020,1535808,744.37,4,"Second born about they drop. Not three person late. Company indeed law.
Choice art risk at. Society either policy program still story.",10:05:01,UPI
AZVR85135161881683,GB95URAP17054870000917,5/17/2016,14311.32,100001,Y,Transportation,MI,POS,Dr,15:31:35,18:02:33,6/9/2020,91908582,744.37,2,Be believe early fast field how. Debate enjoy senior ball before write finish.,16:02:09,IMPS
AZVR85135161881683,GB95URAP17054870000917,5/17/2016,13566.95,100001,Y,Online Shopping,OPERA,POS,Dr,18:41:15,22:39:24,6/9/2020,28405368,744.37,1,Rate early minute interest half. Never discuss local lawyer manage water. Right many head history color key.,20:59:00,NEFT
AZVR85135161881683,GB95URAP17054870000917,5/17/2016,11757.28,100001,Y,Dining,OPERA,PC,Dr,10:07:49,14:01:19,6/20/2020,71332420,1809.67,2,"Baby instead under toward animal shake admit. Stay major scientist run among nature hot. Rich usually television.
Specific action respond guy. Carry site medical rich environment.",11:35:30,IMPS
AZVR85135161881683,GB95URAP17054870000917,5/17/2016,13566.95,100001,N,Credited,EDGE,PC,Cr,14:41:48,16:54:54,6/20/2020,51496180,1809.67,1,"Learn message dark guy none fine. Eat administration today. Rate run environment friend season agreement.
Toward probably off record. How travel hold sort trial production.",15:47:03,NEFT
AZVR85135161881683,GB95URAP17054870000917,5/17/2016,15376.62,100001,N,Credited,OPERA,PC,Cr,17:58:02,20:16:05,6/20/2020,42294627,1809.67,1,"Law glass major travel daughter. Send million example walk you my stand. Generation former much paper up.
Night worry international of right. Activity reach interview pull floor.",18:49:50,NEFT
AZVR85135161881683,GB95URAP17054870000917,5/17/2016,16503.42,100001,N,Credited,EDGE,MOBILE,Cr,10:39:48,18:02:43,6/22/2020,93127028,1126.8,4,"Upon player research lose. Nature great station wait.
Key church record window operation may send travel. Option forward opportunity probably. Vote west wide.",13:34:25,UPI
AZVR85135161881683,GB95URAP17054870000917,5/17/2016,17878.82,100001,N,Credited,CHROME,POS,Cr,9:33:45,16:59:37,7/2/2020,92672918,1375.4,3,"Sure sound woman capital assume. Scene year every eye whatever author small. Upon these hand risk finally but.
All drop first left. Still cup keep without standard. Among those begin them land down.",13:23:38,RTGS
AZVR85135161881683,GB95URAP17054870000917,5/17/2016,17814.48,100001,Y,Transportation,EDGE,PC,Dr,7:10:15,10:23:10,7/7/2020,10966068,64.34,3,"Born arrive table drive town. Use finally partner act member bit.
Key yeah page discover glass identify. Especially generation involve.",8:07:51,RTGS
AZVR85135161881683,GB95URAP17054870000917,5/17/2016,17750.14,100001,Y,Insurance,CHROME,PC,Dr,12:58:58,18:11:10,7/7/2020,15089915,64.34,4,Note daughter a say final. Show yourself minute by. Hear seven network high real management government.,15:57:50,UPI
AZVR85135161881683,GB95URAP17054870000917,5/17/2016,17814.48,100001,N,Credited,EDGE,MOBILE,Cr,18:25:27,20:42:07,7/7/2020,77621269,64.34,5,"Name TV future beyond get heart key change.
Force easy hard. Look class language top born. Threat event actually rich great.",19:42:45,CARDS
AZVR85135161881683,GB95URAP17054870000917,5/17/2016,17731.09,100001,Y,Personal Care,CHROME,PC,Dr,12:39:03,17:42:13,7/8/2020,86711890,83.39,6,Government different today public. Soldier much move training before wonder night. Address large member so interesting.,14:01:30,CHEQUE
AZVR85135161881683,GB95URAP17054870000917,5/17/2016,17814.48,100001,N,Credited,EDGE,POS,Cr,20:03:16,26:55:41,7/8/2020,62644358,83.39,6,"Sometimes culture official. Can majority appear institution. Before against professional.
Cup painting message increase thank place community. Onto your eat bring ask room recently.",23:09:56,CHEQUE
AZVR85135161881683,GB95URAP17054870000917,5/17/2016,18266.42,100001,N,Credited,SAFARI,MOBILE,Cr,6:16:59,10:58:11,7/13/2020,49311716,451.94,4,Environment talk experience system. Professional office son. Significant month response project.,8:34:43,UPI
AZVR85135161881683,GB95URAP17054870000917,5/17/2016,18718.36,100001,N,Credited,SAFARI,MOBILE,Cr,7:58:13,11:45:23,7/13/2020,36489718,451.94,6,Remain space pretty community continue build million response. Between bad analysis minute plan entire main conference. Suggest quality yes figure top professor fast safe.,10:03:01,CHEQUE
AZVR85135161881683,GB95URAP17054870000917,5/17/2016,18266.42,100001,Y,Household Consumables,SAFARI,POS,Dr,16:47:29,18:27:54,7/13/2020,40285528,451.94,3,"Thank middle nation share similar. Decide now movement beat. Car natural pull more produce.
Throughout set know move. Seek focus rise while.",17:41:37,RTGS
AZVR85135161881683,GB95URAP17054870000917,5/17/2016,17814.48,100001,Y,Online Shopping,FF,PC,Dr,20:53:28,23:18:36,7/13/2020,61918078,451.94,5,"Mother recent again customer actually. Three even line indeed. Go always scene.
Risk thousand through senior. Detail school spend we skill born enough.",22:39:42,CARDS
AZVR85135161881683,GB95URAP17054870000917,5/17/2016,17120.81,100001,Y,Utilities,MI,POS,Dr,4:54:12,7:37:53,7/14/2020,44488376,693.67,2,"Item short benefit chance must left people. Unit office shake simple sit bit. Happy senior enter choice carry answer.
Born discover rest defense. Threat agency body seek.",6:05:27,IMPS
AZVR85135161881683,GB95URAP17054870000917,5/17/2016,17814.48,100001,N,Credited,MI,MOBILE,Cr,8:22:08,11:17:16,7/14/2020,57275055,693.67,3,Pattern agreement air read teacher cultural dark security. Organization who shoulder prevent always commercial. More artist executive there wish.,10:04:16,RTGS
AZVR85135161881683,GB95URAP17054870000917,5/17/2016,17120.81,100001,Y,Groceries,SAFARI,POS,Dr,11:39:14,13:32:27,7/14/2020,9977419,693.67,3,"Air plant much. Left clearly than.
Including receive admit measure safe. Training reflect check agreement.
After apply child difference anything certainly like.",12:49:03,RTGS
AZVR85135161881683,GB95URAP17054870000917,5/17/2016,16427.14,100001,Y,Utilities,FF,POS,Dr,17:17:43,18:41:27,7/14/2020,71927657,693.67,2,"Collection energy experience rise training new be half. Final bar weight computer car.
Back my company. Standard time three always network list. Spring trip beautiful around last race man.",17:51:51,IMPS
AZVR85135161881683,GB95URAP17054870000917,5/17/2016,17120.81,100001,N,Credited,OPERA,PC,Cr,20:45:26,23:12:19,7/14/2020,12019151,693.67,7,"Imagine along second yeah somebody again. Art than over of know why head today.
Agency building ahead organization collection. Simple certainly possible young. Serve couple radio foreign simply.",21:14:44,DD
AZVR85135161881683,GB95URAP17054870000917,5/17/2016,18790.19,100001,N,Credited,SAFARI,POS,Cr,5:09:59,7:50:04,7/15/2020,8695703,1669.38,1,Unit election them guy marriage sure particularly. Baby series east someone job likely hand fill. Answer anything character memory prevent.,7:03:28,NEFT
AZVR85135161881683,GB95URAP17054870000917,5/17/2016,20459.57,100001,N,Credited,MI,POS,Cr,12:39:46,15:26:21,7/15/2020,90782909,1669.38,1,Certain Republican change occur either. Environment century factor something south six knowledge. Success herself culture.,13:48:37,NEFT
AZVR85135161881683,GB95URAP17054870000917,5/17/2016,22128.95,100001,N,Credited,FF,PC,Cr,13:49:31,17:25:55,7/15/2020,96225370,1669.38,7,"Better me oil kind offer mission.
Week administration decision agency charge. Style stock place traditional day.",16:10:55,DD
AZVR85135161881683,GB95URAP17054870000917,5/17/2016,20459.57,100001,Y,Insurance,CHROME,POS,Dr,20:09:55,22:13:34,7/15/2020,52735844,1669.38,1,Recognize phone necessary relate imagine left. Protect walk just smile change. Wide increase easy manage number.,21:14:19,NEFT
AZVR85135161881683,GB95URAP17054870000917,5/17/2016,21513.39,100001,N,Credited,SAFARI,MOBILE,Cr,6:36:28,11:18:02,7/17/2020,1771596,1053.82,2,"Instead really rise possible couple. Into pressure grow child must success on.
Often young left who page stop. Make information might stop book. Another turn fire country minute.",9:36:17,IMPS
AZVR85135161881683,GB95URAP17054870000917,5/17/2016,22567.21,100001,N,Credited,CHROME,PC,Cr,14:41:54,18:00:00,7/17/2020,54939554,1053.82,5,Apply of seek experience. Picture two lose single understand push performance.,16:18:00,CARDS
AZVR85135161881683,GB95URAP17054870000917,5/17/2016,23621.03,100001,N,Credited,SAFARI,POS,Cr,19:47:42,24:24:00,7/17/2020,98810390,1053.82,6,"Daughter order international American enough fast simple mean. Exist civil age option fly might.
Kid affect because situation big with. System coach top inside.",21:33:08,CHEQUE
AZVR85135161881683,GB95URAP17054870000917,5/17/2016,24844.37,100001,N,Credited,FF,POS,Cr,6:02:02,10:30:11,7/19/2020,60403360,1223.34,3,Discover decide as whatever commercial exist see eat. Author director late worker. Bad nature above wife.,9:39:52,RTGS
AZVR85135161881683,GB95URAP17054870000917,5/17/2016,26067.71,100001,N,Credited,MI,MOBILE,Cr,18:07:33,23:41:25,7/19/2020,36352913,1223.34,3,"Who how music try economic just public themselves.
Rest suddenly ahead dark. Pressure say but real chair same quality.
New true trip happen seem tough. Young bag marriage stay speech remember sea.",21:04:59,RTGS
AZVR85135161881683,GB95URAP17054870000917,5/17/2016,24157.9,100001,Y,Utilities,SAFARI,PC,Dr,10:44:49,13:54:46,7/21/2020,75810870,1909.81,4,"Place hard real thus. Office amount father capital artist field.
Collection behind stuff evidence stock physical daughter while. Across one always region threat party.",12:22:53,UPI
AZVR85135161881683,GB95URAP17054870000917,5/17/2016,26067.71,100001,N,Credited,EDGE,PC,Cr,15:31:21,22:33:32,7/21/2020,40661469,1909.81,5,Star mention everybody training Congress thought. Name officer send culture nearly whom. Return read start.,19:20:40,CARDS
AZVR85135161881683,GB95URAP17054870000917,5/17/2016,26235.67,100001,N,Credited,CHROME,MOBILE,Cr,7:27:48,10:54:35,7/24/2020,87606294,167.96,4,"Case compare whole why guy blue. Strategy television big dog laugh plan fly environmental.
Somebody might doctor bring. Exactly three most fact oil more. Fear join hold cultural important.",10:05:38,UPI
AZVR85135161881683,GB95URAP17054870000917,5/17/2016,26403.63,100001,N,Credited,CHROME,MOBILE,Cr,15:47:25,18:21:05,7/24/2020,69876684,167.96,6,Back color lose clear level. Hour picture parent avoid mother lawyer decade. Develop rich then game. Especially chance painting stay board chair.,16:27:15,CHEQUE
AZVR85135161881683,GB95URAP17054870000917,5/17/2016,26571.59,100001,N,Credited,OPERA,MOBILE,Cr,22:15:55,26:14:07,7/24/2020,56991949,167.96,3,Thought college up floor note without name. Provide occur help budget into factor surface.,23:30:37,RTGS
AZVR85135161881683,GB95URAP17054870000917,5/17/2016,26105.04,100001,Y,Rent,FF,MOBILE,Dr,17:51:34,26:12:31,7/29/2020,16390225,466.55,1,"Compare usually give. Although nature buy across pretty sign everybody. Box girl whole perform score time.
Month then alone fund. Despite half care we ok. Say scene deal law.",22:19:46,NEFT
AZVR85135161881683,GB95URAP17054870000917,5/17/2016,25722.76,100001,Y,Household Consumables,MI,POS,Dr,7:52:58,9:40:42,8/5/2020,46813336,382.28,2,"Bring charge born loss on. We price hospital race teacher.
Season everybody here accept fast just.",8:53:59,IMPS
AZVR85135161881683,GB95URAP17054870000917,5/17/2016,26105.04,100001,N,Credited,EDGE,POS,Cr,16:14:40,19:50:03,8/5/2020,7263507,382.28,4,Military large attorney rock score good. Fire unit place specific. Explain southern deal themselves probably across three movie. Crime recently dark herself ago Republican husband and.,17:21:29,UPI
AZVR85135161881683,GB95URAP17054870000917,5/17/2016,25722.76,100001,Y,Insurance,SAFARI,POS,Dr,19:06:24,23:39:08,8/5/2020,739597,382.28,1,Positive training alone provide improve. Himself help night maybe suddenly sound reach law. Admit have whatever seek decade street.,22:04:01,NEFT
AZVR85135161881683,GB95URAP17054870000917,5/17/2016,24064.56,100001,Y,Utilities,MI,MOBILE,Dr,14:05:09,19:58:10,8/12/2020,54237643,1658.2,4,Tough water expert cultural. Allow kitchen without piece save career. Person actually study production.,16:34:02,UPI
AZVR85135161881683,GB95URAP17054870000917,5/17/2016,22329.03,100001,Y,Utilities,IE,POS,Dr,2:26:13,5:02:24,8/21/2020,83993718,1735.53,1,"Fall money add might reality debate well house. Open hand about money left at black.
City prove home clear almost. Finally place over white position forget.",4:07:27,NEFT
AZVR85135161881683,GB95URAP17054870000917,5/17/2016,24064.56,100001,N,Credited,IE,MOBILE,Cr,9:07:21,11:58:45,8/21/2020,88486567,1735.53,4,"Beat mind require next product rich job.
New nearly ok star property authority audience. Watch material without on use manage chair.",10:03:17,UPI
AZVR85135161881683,GB95URAP17054870000917,5/17/2016,22329.03,100001,Y,Transportation,SAFARI,PC,Dr,10:41:53,13:27:47,8/21/2020,76474026,1735.53,2,Nor say interest by never. Before enter enough if Congress role reason majority. Hospital control democratic sell perhaps wonder morning.,12:37:51,IMPS
AZVR85135161881683,GB95URAP17054870000917,5/17/2016,20593.5,100001,Y,Medicals,FF,PC,Dr,18:38:33,21:07:19,8/21/2020,22321176,1735.53,6,"Sort Congress can people property run.
Similar condition accept end PM reason black. Gas occur network anyone bring various. Beyond approach scientist education.",19:43:59,CHEQUE
AZVR85135161881683,GB95URAP17054870000917,5/17/2016,18857.97,100001,Y,Entertainment,EDGE,MOBILE,Dr,21:07:22,23:32:38,8/21/2020,64441535,1735.53,2,Rather fight painting available development together model. In style receive anyone general value. Politics green common piece plant. Far collection person write herself.,22:06:26,IMPS
AZVR85135161881683,GB95URAP17054870000917,5/17/2016,20210.73,100001,N,Credited,IE,PC,Cr,21:56:07,26:18:08,8/25/2020,54641341,1352.76,2,"Also long above. Hand enough right natural me poor recently.
Any true make yet anything at. Can heart blood treatment see various.",23:15:29,IMPS
AZVR85135161881683,GB95URAP17054870000917,5/17/2016,18649.01,100001,Y,Medicals,IE,MOBILE,Dr,5:17:01,7:44:16,8/26/2020,60953377,1561.72,4,"Present read conference capital factor. Serious affect plant according itself. Rate skin management again fall just age bad.
Amount edge force floor school. Her officer hour option mouth.",6:00:58,UPI
AZVR85135161881683,GB95URAP17054870000917,5/17/2016,20210.73,100001,N,Credited,OPERA,MOBILE,Cr,9:23:02,12:11:05,8/26/2020,64765037,1561.72,6,Area level per Mrs compare good less. Increase fire financial size save whatever wear thought.,11:21:24,CHEQUE
AZVR85135161881683,GB95URAP17054870000917,5/17/2016,21772.45,100001,N,Credited,SAFARI,PC,Cr,12:11:09,14:08:03,8/26/2020,32715712,1561.72,1,Yes senior speech bag model sign partner. Single small mention. Term standard force brother back generation. Least garden discover single probably nothing lawyer rather.,13:21:59,NEFT
AZVR85135161881683,GB95URAP17054870000917,5/17/2016,23334.17,100001,N,Credited,CHROME,MOBILE,Cr,15:24:40,17:17:02,8/26/2020,58765272,1561.72,4,"Break newspaper few team bill environmental baby. Paper house source dark home he.
See student necessary price per we drop suggest. Product energy whether someone.",16:08:50,UPI
AZVR85135161881683,GB95URAP17054870000917,5/17/2016,24895.89,100001,N,Credited,OPERA,MOBILE,Cr,20:14:46,23:00:57,8/26/2020,38045448,1561.72,6,Nothing old decade pressure. Home rise scene management international stage star either. Politics another risk example just score energy.,21:50:51,CHEQUE
AZVR85135161881683,GB95URAP17054870000917,5/17/2016,26614.76,100001,N,Credited,IE,MOBILE,Cr,6:58:45,10:34:28,9/2/2020,35132912,1718.87,4,Relate chance ok appear bag style may. Message improve trial set eight. Interest eat early away current.,8:58:13,UPI
AZVR85135161881683,GB95URAP17054870000917,5/17/2016,28333.63,100001,N,Credited,CHROME,PC,Cr,9:51:27,15:09:01,9/2/2020,69424304,1718.87,5,"Material final service. Girl half particularly. Our today PM create last.
Bag suddenly effort green fear television. Member character appear economic. Road go dream true.",12:22:26,CARDS
AZVR85135161881683,GB95URAP17054870000917,5/17/2016,30052.5,100001,N,Credited,IE,MOBILE,Cr,18:01:53,20:12:04,9/2/2020,14158667,1718.87,6,"None friend despite. Market somebody hair director know hear several doctor. Reduce determine long.
Certainly piece city policy. Maintain author stand final boy address miss center.",19:33:38,CHEQUE
AZVR85135161881683,GB95URAP17054870000917,5/17/2016,29008.69,100001,Y,Household Consumables,OPERA,POS,Dr,3:40:02,6:17:38,9/7/2020,62479318,1043.81,3,Strong theory involve support road bag sure. Way national trouble ten if among huge. Another bar tax factor your across.,5:07:46,RTGS
AZVR85135161881683,GB95URAP17054870000917,5/17/2016,27964.88,100001,Y,Personal Care,OPERA,POS,Dr,8:46:35,10:42:56,9/7/2020,80251200,1043.81,6,Music subject within week new necessary many rest. Loss strategy either rise. Wish both interesting soon identify seem. Language about small issue onto.,9:36:07,CHEQUE
AZVR85135161881683,GB95URAP17054870000917,5/17/2016,29008.69,100001,N,Credited,MI,MOBILE,Cr,13:01:30,14:23:29,9/7/2020,23227439,1043.81,2,Pull human get toward. Only of live toward. Easy everyone fire wish loss respond.,13:42:38,IMPS
AZVR85135161881683,GB95URAP17054870000917,5/17/2016,27964.88,100001,Y,Personal Care,MI,POS,Dr,15:23:21,18:25:17,9/7/2020,91666031,1043.81,5,"And seem special people door. Others nature image station wrong quality should. Reduce hospital computer.
Perhaps crime think special break. Piece air not. Imagine serve most hair like.",17:01:39,CARDS
AZVR85135161881683,GB95URAP17054870000917,5/17/2016,26921.07,100001,Y,Online Shopping,CHROME,POS,Dr,19:37:48,22:08:02,9/7/2020,3803981,1043.81,7,"Left court medical situation every. Mother require way politics hotel culture.
Early well best news board help. Treat shake chair phone guess energy trouble property.",20:46:08,DD
AZVR85135161881683,GB95URAP17054870000917,5/17/2016,26029.85,100001,Y,Household Consumables,OPERA,MOBILE,Dr,12:09:44,16:58:07,9/10/2020,985628,891.22,4,"Spend court activity policy fill reason participant.
Travel program evidence finally among. Teach my wall fall. More store anything oil.",15:37:52,UPI
AZVR85135161881683,GB95URAP17054870000917,5/17/2016,25138.63,100001,Y,Transportation,EDGE,MOBILE,Dr,16:39:28,21:01:52,9/10/2020,70090598,891.22,3,"Similar never phone close meet drop. Own next general factor.
Front whom need different wait pressure list bit. Possible actually guy third decide.",20:12:48,RTGS
AZVR85135161881683,GB95URAP17054870000917,5/17/2016,26122.21,100001,N,Credited,IE,POS,Cr,10:44:19,17:08:47,10/2/2020,44832728,983.58,5,From opportunity you name board a campaign. Central agency great area hospital. Follow history power something.,13:35:08,CARDS
AZVR85135161881683,GB95URAP17054870000917,5/17/2016,25138.63,100001,Y,Medicals,FF,MOBILE,Dr,16:29:50,19:03:16,10/2/2020,67207251,983.58,1,"Difference decision great beautiful service. Shoulder become couple woman out figure. That authority room reflect throw score become.
Value tax record bank suggest animal. Same then case.",17:40:50,NEFT
AZVR85135161881683,GB95URAP17054870000917,5/17/2016,26575.03,100001,N,Credited,MI,POS,Cr,15:59:56,21:10:47,10/5/2020,43600595,1436.4,7,"Particularly look eat central activity quickly. Provide accept deep east wonder leg.
Record defense air beat decide show. Already seat laugh certainly require million treat agreement.",19:14:35,DD
AZVR85135161881683,GB95URAP17054870000917,5/17/2016,24751.38,100001,Y,Utilities,OPERA,MOBILE,Dr,7:46:15,9:21:32,10/8/2020,56522402,1823.65,1,Election return heavy away world model fine stuff. Computer just while itself describe. Any bring technology ago stop air whose form. Seat director sister could music lose.,8:50:57,NEFT
AZVR85135161881683,GB95URAP17054870000917,5/17/2016,22927.73,100001,Y,Groceries,MI,POS,Dr,11:39:38,13:38:47,10/8/2020,71362458,1823.65,5,Away wonder spend eat raise. Modern maintain half generation shake. City analysis leader fill mean medical who.,12:37:37,CARDS
AZVR85135161881683,GB95URAP17054870000917,5/17/2016,24751.38,100001,N,Credited,EDGE,POS,Cr,17:31:18,21:01:12,10/8/2020,56094916,1823.65,5,"Something miss especially near street. Forward simply traditional really same floor well.
Five toward condition song. Into young culture within. My specific hour heart believe they.",18:48:47,CARDS
AZVR85135161881683,GB95URAP17054870000917,5/17/2016,22927.73,100001,Y,Personal Care,FF,MOBILE,Dr,19:26:42,23:46:22,10/8/2020,84076212,1823.65,3,Theory important manager lot again. Price up police kid life service. Attention environment interest.,21:49:30,RTGS
AZVR85135161881683,GB95URAP17054870000917,5/17/2016,23885.1,100001,N,Credited,SAFARI,POS,Cr,4:53:24,12:39:37,10/9/2020,50786978,957.37,5,You spring state arm line fill. Collection office card summer across. Vote blood garden many thousand smile. Cultural pick challenge ready agree indicate state.,8:45:53,CARDS
AZVR85135161881683,GB95URAP17054870000917,5/17/2016,24842.47,100001,N,Credited,SAFARI,MOBILE,Cr,21:24:52,26:30:38,10/9/2020,93628877,957.37,4,None purpose behavior possible happen performance. Detail include allow space house she.,22:31:00,UPI
AZVR85135161881683,GB95URAP17054870000917,5/17/2016,24449.56,100001,Y,Online Shopping,EDGE,POS,Dr,12:18:23,16:28:38,10/10/2020,9228580,392.91,7,"Long season fly by. Morning owner exactly school plan.
Station a form generation whether father. Thus represent best ago little PM they. National west drug base thing.",14:45:36,DD
AZVR85135161881683,GB95URAP17054870000917,5/17/2016,24705.34,100001,N,Credited,SAFARI,MOBILE,Cr,5:42:49,9:14:06,10/12/2020,63962833,255.78,7,"Series marriage above may answer point.
Wide company management enjoy color score. Close center able above network particular.",8:01:35,DD
AZVR85135161881683,GB95URAP17054870000917,5/17/2016,24961.12,100001,N,Credited,EDGE,PC,Cr,15:35:41,18:02:56,10/12/2020,81921898,255.78,4,Protect me son know. Loss although chair strategy region business season staff. Magazine agent future interest deal gun.,16:51:33,UPI
AZVR85135161881683,GB95URAP17054870000917,5/17/2016,24705.34,100001,Y,Transportation,SAFARI,PC,Dr,15:32:08,20:08:31,10/12/2020,40851327,255.78,3,"Hair participant born into check phone poor. Stuff opportunity method cause. Choose before might top able add never.
Nature man along key. My you tree western fear along.",18:19:01,RTGS
AZVR85135161881683,GB95URAP17054870000917,5/17/2016,26055.38,100001,N,Credited,IE,MOBILE,Cr,7:38:06,10:19:02,10/19/2020,15288752,1350.04,7,Campaign east add network the tax ago no. Nice team take environmental site interest.,8:43:14,DD
AZVR85135161881683,GB95URAP17054870000917,5/17/2016,24705.34,100001,Y,Entertainment,CHROME,PC,Dr,12:45:15,14:11:34,10/19/2020,58596586,1350.04,1,"Include picture surface newspaper pull law better.
Pm court seem production company. Learn short wear week floor.",13:22:07,NEFT
AZVR85135161881683,GB95URAP17054870000917,5/17/2016,26055.38,100001,N,Credited,IE,MOBILE,Cr,15:43:04,19:42:49,10/19/2020,43520091,1350.04,7,"Quality too day across response serve body. Fine put where those. Main stop phone star deep simple summer city.
Minute produce price open. Answer final ahead attorney right.",17:20:32,DD
AZVR85135161881683,GB95URAP17054870000917,5/17/2016,27405.42,100001,N,Credited,OPERA,MOBILE,Cr,19:03:19,22:25:22,10/19/2020,26547572,1350.04,7,"Both painting always the response alone. Prevent ground site.
Coach within consider out life. Clearly space easy especially tonight full minute.",20:18:25,DD
AZVR85135161881683,GB95URAP17054870000917,5/17/2016,28216.11,100001,N,Credited,SAFARI,MOBILE,Cr,16:36:26,23:04:52,10/21/2020,53738363,810.69,1,Break a threat tree us nation gun. Clearly agree phone training son. Where war catch ask statement.,20:45:20,NEFT
AZVR85135161881683,GB95URAP17054870000917,5/17/2016,28402.46,100001,N,Credited,FF,PC,Cr,5:11:23,9:01:07,10/27/2020,59950196,186.35,4,"Style eight local spring including. Civil garden people safe family build.
Her sound share room. Travel affect company.
Well international rock want over. Growth Mr lawyer.",7:04:26,UPI
AZVR85135161881683,GB95URAP17054870000917,5/17/2016,28588.81,100001,N,Credited,CHROME,POS,Cr,8:01:09,12:34:27,10/27/2020,17058629,186.35,6,"Choice goal model under respond. Task customer behind. Kitchen man very serious whether source least.
Note their participant population. Suggest most federal me.",10:23:50,CHEQUE
AZVR85135161881683,GB95URAP17054870000917,5/17/2016,28775.16,100001,N,Credited,MI,MOBILE,Cr,16:06:04,18:33:17,10/27/2020,97621768,186.35,1,Meet phone people. Memory anything brother training production simply up. Baby manage will two manager.,17:37:13,NEFT
AZVR85135161881683,GB95URAP17054870000917,5/17/2016,28588.81,100001,Y,Personal Care,OPERA,MOBILE,Dr,22:01:15,25:06:16,10/27/2020,79071826,186.35,6,"Time after example reduce maintain quality reflect. Respond type represent election head base.
Lead building fine. Poor research edge only. When west hair class may you final.",23:59:31,CHEQUE
AZVR85135161881683,GB95URAP17054870000917,5/17/2016,28328.08,100001,Y,Insurance,SAFARI,MOBILE,Dr,6:33:06,11:37:22,11/9/2020,5976515,260.73,2,"Most bring join game always.
Modern arm husband imagine cup middle various. Score skin upon fly paper whole. Stage field strategy treatment reach doctor energy.",8:52:01,IMPS
AZVR85135161881683,GB95URAP17054870000917,5/17/2016,28588.81,100001,N,Credited,SAFARI,MOBILE,Cr,14:47:55,17:31:36,11/9/2020,98128693,260.73,4,Four forget interview capital quality. Thus focus these pull.,16:27:16,UPI
AZVR85135161881683,GB95URAP17054870000917,5/17/2016,28849.54,100001,N,Credited,IE,POS,Cr,21:48:37,25:35:43,11/9/2020,9433380,260.73,5,"Mean around beat young. Choice strong before alone.
Bit arrive their fast idea. Few whose need cost step.",23:55:48,CARDS
AZVR85135161881683,GB95URAP17054870000917,5/17/2016,29761.49,100001,N,Credited,EDGE,PC,Cr,7:18:09,12:19:54,11/11/2020,22818782,911.95,6,Practice mean herself himself. Experience assume blue really expert. Guy newspaper window company. Region public method.,10:43:32,CHEQUE
AZVR85135161881683,GB95URAP17054870000917,5/17/2016,28849.54,100001,Y,Entertainment,MI,POS,Dr,14:46:12,18:43:17,11/11/2020,1745818,911.95,7,"Toward gas institution. Fast have agreement structure.
Together ground force rather able it as. Argue agent this positive center personal effect capital.",16:00:55,DD
AZVR85135161881683,GB95URAP17054870000917,5/17/2016,28990.07,100001,N,Credited,SAFARI,MOBILE,Cr,4:45:48,8:48:48,11/21/2020,79005500,140.53,5,"Responsibility benefit line media yard term join. Probably budget whatever must sure.
Energy same dark quite prepare he set. Nature Mrs adult window ball garden.",6:55:39,CARDS
AZVR85135161881683,GB95URAP17054870000917,5/17/2016,28849.54,100001,Y,Household Consumables,CHROME,MOBILE,Dr,11:37:55,15:40:11,11/21/2020,17525121,140.53,2,Heart safe skin ready born second share together. Space task last artist value walk.,13:05:33,IMPS
AZVR85135161881683,GB95URAP17054870000917,5/17/2016,28990.07,100001,N,Credited,EDGE,MOBILE,Cr,16:41:15,20:01:37,11/21/2020,76576614,140.53,3,"Give positive who main. Bring all realize win hair back. Ever lay police notice watch image.
Floor consider modern half fall. Same lawyer out future fire him.",18:15:42,RTGS
AZVR85135161881683,GB95URAP17054870000917,5/17/2016,29369.7,100001,N,Credited,OPERA,PC,Cr,16:02:19,22:01:18,11/22/2020,21247415,379.63,3,Trouble lay provide amount professional. Threat only thought fine.,19:53:48,RTGS
AZVR85135161881683,GB95URAP17054870000917,5/17/2016,29290.45,100001,Y,Insurance,FF,POS,Dr,7:09:24,11:22:23,11/26/2020,68876975,79.25,1,Performance whatever foot score cup occur he ok. Pretty forget thousand player former together arm. Letter remember human themselves sea free. By best race risk million foot buy.,10:13:46,NEFT
AZVR85135161881683,GB95URAP17054870000917,5/17/2016,29211.2,100001,Y,Household Consumables,MI,PC,Dr,21:40:41,26:24:43,11/26/2020,81144181,79.25,1,Still purpose they white. Six daughter fine yourself west decision skin there. Wide those something Mrs high away situation.,23:41:23,NEFT
AZVR85135161881683,GB95URAP17054870000917,5/17/2016,28718.82,100001,Y,Utilities,IE,POS,Dr,4:41:52,7:57:01,12/1/2020,49387803,492.38,3,Tax bit consider cover. Walk who require. Whose board because conference PM enter.,6:56:07,RTGS
AZVR85135161881683,GB95URAP17054870000917,5/17/2016,29211.2,100001,N,Credited,MI,MOBILE,Cr,10:24:48,12:35:22,12/1/2020,98598144,492.38,2,"Attack white indicate heavy edge five must officer. Table miss especially fly. Say decade approach it card member pretty.
Event party central safe painting. Meeting probably admit impact.",11:57:49,IMPS
AZVR85135161881683,GB95URAP17054870000917,5/17/2016,28718.82,100001,Y,Entertainment,SAFARI,MOBILE,Dr,14:48:39,17:16:40,12/1/2020,74629336,492.38,4,"Everybody identify as. East six early own.
Sea range play opportunity bed everybody middle life. Off industry blue realize quickly glass. Ever leg give all kitchen once culture.",15:34:17,UPI
AZVR85135161881683,GB95URAP17054870000917,5/17/2016,28226.44,100001,Y,Household Consumables,SAFARI,PC,Dr,17:02:53,20:16:53,12/1/2020,24078849,492.38,5,Former wear because increase both cell style. Race development worker mind national that news then.,19:14:36,CARDS
AZVR85135161881683,GB95URAP17054870000917,5/17/2016,28371.92,100001,N,Credited,EDGE,MOBILE,Cr,5:41:45,7:49:25,12/9/2020,28754961,145.48,2,Decade parent its bag send pull seven current. Traditional doctor ten send wall. Smile pay forward information follow.,6:23:51,IMPS
AZVR85135161881683,GB95URAP17054870000917,5/17/2016,28226.44,100001,Y,Rent,SAFARI,MOBILE,Dr,13:57:57,17:51:04,12/9/2020,78233515,145.48,1,"Play seem now apply method. Feeling say instead nice.
Could station cultural design pull seek. Drop note than care back positive people. Country ability pull within put.",16:11:03,NEFT
AZVR85135161881683,GB95URAP17054870000917,5/17/2016,28371.92,100001,N,Credited,FF,POS,Cr,19:17:29,21:44:06,12/9/2020,73582281,145.48,6,Anything surface put TV second begin do. He building administration product. Message join without full affect buy rest.,21:04:23,CHEQUE
AZVR85135161881683,GB95URAP17054870000917,5/17/2016,26932.05,100001,Y,Rent,SAFARI,POS,Dr,5:23:03,7:46:01,12/18/2020,89455289,1439.87,1,"Kind war nothing into control.
Kitchen health star property mean yourself law already. Right moment article quite man.",6:21:39,NEFT
AZVR85135161881683,GB95URAP17054870000917,5/17/2016,25492.18,100001,Y,Dining,IE,POS,Dr,9:50:06,12:01:00,12/18/2020,49179675,1439.87,7,"Language anyone trip spend popular. Grow almost degree in training war.
Change cut benefit method number approach. Thought low type activity.",10:14:53,DD
AZVR85135161881683,GB95URAP17054870000917,5/17/2016,24052.31,100001,Y,Insurance,OPERA,MOBILE,Dr,10:45:28,13:17:27,12/18/2020,643726,1439.87,5,Behavior check remember go. Everything position American.,12:20:44,CARDS
AZVR85135161881683,GB95URAP17054870000917,5/17/2016,25492.18,100001,N,Credited,FF,PC,Cr,15:50:38,18:46:34,12/18/2020,49001389,1439.87,3,"Admit house anything table.
Course half support piece leave so agency. Foreign common place become drive save small.
People place perform huge. Assume view else. Decision citizen may unit.",17:48:04,RTGS
AZVR85135161881683,GB95URAP17054870000917,5/17/2016,24052.31,100001,Y,Utilities,IE,MOBILE,Dr,20:12:18,22:30:29,12/18/2020,71670591,1439.87,2,First study him child watch change activity. Movement idea industry good. Will medical bad another Republican traditional assume.,20:48:50,IMPS
AZVR85135161881683,GB95URAP17054870000917,5/17/2016,23011.93,100001,Y,Household Consumables,OPERA,POS,Dr,7:35:41,11:20:12,12/21/2020,71428666,1040.38,4,"Order item parent wind perform. Glass world direction know event it.
Discussion first let purpose charge look talk. Go toward behavior peace body bad maintain until. Poor raise defense owner.",8:58:32,UPI
AZVR85135161881683,GB95URAP17054870000917,5/17/2016,21971.55,100001,Y,Rent,IE,PC,Dr,9:48:24,12:16:05,12/21/2020,52356360,1040.38,5,"Professor read at else until painting. As capital whatever agree.
Provide expert professional minute. See couple response mother option budget charge single. Court ago forward whole thought choice.",11:11:25,CARDS
AZVR85135161881683,GB95URAP17054870000917,5/17/2016,20931.17,100001,Y,Insurance,FF,PC,Dr,14:37:16,18:43:01,12/21/2020,52069871,1040.38,5,That matter theory church discussion. Stuff official attention across. Indeed some apply.,16:20:00,CARDS
AZVR85135161881683,GB95URAP17054870000917,5/17/2016,21971.55,100001,N,Credited,SAFARI,POS,Cr,17:21:12,21:19:04,12/21/2020,68033293,1040.38,6,"House memory store she create show social. College education threat provide executive suggest ago.
Arm hundred military industry. Outside follow determine others.",19:14:44,CHEQUE
AZVR85135161881683,GB95URAP17054870000917,5/17/2016,20132.4,100001,Y,Online Shopping,MI,POS,Dr,7:03:35,9:31:12,12/27/2020,1040265,1839.15,5,Carry edge building eat station. Conference civil often official phone mission now. Law well somebody season begin.,8:09:56,CARDS
AZVR85135161881683,GB95URAP17054870000917,5/17/2016,21971.55,100001,N,Credited,CHROME,POS,Cr,10:03:06,12:36:07,12/27/2020,67409143,1839.15,2,"Model just believe item pay carry. Particular fear true possible citizen world. Could cause director wish close room.
Natural try open year.",11:45:34,IMPS
AZVR85135161881683,GB95URAP17054870000917,5/17/2016,20132.4,100001,Y,Transportation,MI,POS,Dr,14:43:02,18:09:19,12/27/2020,59085829,1839.15,6,Adult machine national city give. Manage up ball arm determine. Walk base popular health mission allow.,16:40:18,CHEQUE
AZVR85135161881683,GB95URAP17054870000917,5/17/2016,18293.25,100001,Y,Transportation,IE,POS,Dr,21:52:24,24:37:11,12/27/2020,3094808,1839.15,7,Under argue job tree tough concern form. Good value financial quickly example. American prevent international.,22:52:47,DD
AZVR85135161881683,GB95URAP17054870000917,5/17/2016,18241.11,100001,Y,Household Consumables,FF,MOBILE,Dr,17:31:23,23:28:12,1/1/2021,12536719,52.14,6,"Western draw character out challenge read. She page list need.
Year those according because task land.",18:44:05,CHEQUE
AZVR85135161881683,GB95URAP17054870000917,5/17/2016,18258.46,100001,N,Credited,EDGE,MOBILE,Cr,7:39:01,12:26:42,1/11/2021,55254571,17.35,1,Never total relationship road newspaper top spend. Collection prevent this federal give about draw. Population for crime son each. Dinner itself by anyone improve.,10:13:06,NEFT
AZVR85135161881683,GB95URAP17054870000917,5/17/2016,18241.11,100001,Y,Entertainment,MI,PC,Dr,11:03:04,15:18:05,1/11/2021,64920696,17.35,5,What growth including stop serious wind. Certainly in senior tree particular expert.,13:28:56,CARDS
AZVR85135161881683,GB95URAP17054870000917,5/17/2016,18258.46,100001,N,Credited,IE,PC,Cr,20:09:34,24:40:04,1/11/2021,78484924,17.35,1,"Onto operation anyone truth. Tonight professor sea bar.
Suffer professor up method see surface compare reason. Field apply team get than. Against human share too.",21:53:41,NEFT
AZVR85135161881683,GB95URAP17054870000917,5/17/2016,16740.4,100001,Y,Transportation,EDGE,POS,Dr,9:08:13,12:26:24,1/23/2021,22181190,1518.06,3,"Sell meeting woman cost. Few never card military. Cultural throw Democrat environmental.
Eye such particular. Pm activity here rich more information time. Story member role eat concern.",10:32:26,RTGS
AZVR85135161881683,GB95URAP17054870000917,5/17/2016,15222.34,100001,Y,Insurance,CHROME,PC,Dr,16:23:37,19:12:28,1/23/2021,27519073,1518.06,7,"Lawyer off left crime daughter. Ok since about indeed. Daughter whom along.
Develop air like impact. Raise then up generation federal.
She successful accept practice laugh.",17:55:13,DD
AZVR85135161881683,GB95URAP17054870000917,5/17/2016,16740.4,100001,N,Credited,EDGE,MOBILE,Cr,20:49:57,24:34:17,1/23/2021,79687850,1518.06,2,"Eight south term itself several word. Ground interesting movie actually want road style.
Leave although short picture special. Money father test all two month.",23:09:23,IMPS
AZVR85135161881683,GB95URAP17054870000917,5/17/2016,17817.21,100001,N,Credited,EDGE,PC,Cr,6:29:11,9:19:49,1/26/2021,29478286,1076.81,2,"Whether source for dark consider gun. Yeah few voice not difference building teacher. Language behind religious cup.
Look seek spend investment significant increase few.",8:18:25,IMPS
AZVR85135161881683,GB95URAP17054870000917,5/17/2016,16740.4,100001,Y,Utilities,MI,MOBILE,Dr,17:44:10,22:19:38,1/26/2021,45558030,1076.81,5,Decision development interview major vote tough though. Wait peace model summer pass often. Pretty smile first piece do position station.,21:07:42,CARDS
AZVR85135161881683,GB95URAP17054870000917,5/17/2016,16083.72,100001,Y,Rent,MI,PC,Dr,16:45:49,22:35:11,1/30/2021,73890485,656.68,1,Strategy mouth player enjoy. Western door chance man official development economic. Need wrong perform stuff for accept.,20:19:41,NEFT
AZVR85135161881683,GB95URAP17054870000917,5/17/2016,17690.17,100001,N,Credited,EDGE,POS,Cr,6:04:00,7:58:39,2/10/2021,53279774,1606.45,7,"Effort water several office Congress business figure serve.
Decade necessary every just ever eat perhaps too. Local our force will know manager.",6:50:26,DD
AZVR85135161881683,GB95URAP17054870000917,5/17/2016,19296.62,100001,N,Credited,EDGE,MOBILE,Cr,9:39:01,10:50:55,2/10/2021,74776788,1606.45,6,Above add too according eight. Price myself box. Wear start health add. Majority term class second cell paper generation fact.,10:07:13,CHEQUE
AZVR85135161881683,GB95URAP17054870000917,5/17/2016,20903.07,100001,N,Credited,MI,MOBILE,Cr,13:59:26,15:33:48,2/10/2021,89756607,1606.45,5,Their wind message oil through. Protect wall describe method doctor fact town. Wear participant her in.,14:54:24,CARDS
AZVR85135161881683,GB95URAP17054870000917,5/17/2016,22509.52,100001,N,Credited,CHROME,POS,Cr,16:53:12,20:36:09,2/10/2021,33206851,1606.45,5,"Accept song fly travel. Enter per government director reduce get land.
Travel interesting day serious possible participant represent. Take modern sea. Adult soldier table however better.",18:41:33,CARDS
AZVR85135161881683,GB95URAP17054870000917,5/17/2016,24115.97,100001,N,Credited,OPERA,POS,Cr,20:31:20,22:10:00,2/10/2021,11435105,1606.45,2,Almost he his common. Security east measure concern none. Natural final interview development woman everyone free.,21:20:16,IMPS
AZVR85135161881683,GB95URAP17054870000917,5/17/2016,22400.37,100001,Y,Transportation,FF,MOBILE,Dr,10:18:20,13:04:45,2/20/2021,32807288,1715.6,7,"Probably including dream start third gun charge. Mention range remember government best last onto. Husband maintain hear movement own.
Continue impact court son.",11:36:40,DD
AZVR85135161881683,GB95URAP17054870000917,5/17/2016,24115.97,100001,N,Credited,EDGE,POS,Cr,10:57:12,12:48:07,2/20/2021,818612,1715.6,1,"None mission himself writer.
Finally mean actually positive west too agent doctor. Our mouth five director yard business left. Deal figure investment bag break style.",12:05:41,NEFT
AZVR85135161881683,GB95URAP17054870000917,5/17/2016,25831.57,100001,N,Credited,EDGE,PC,Cr,19:53:16,23:31:30,2/20/2021,24006002,1715.6,6,"Politics without effort use call soon positive western. Chair production listen challenge side establish bag.
Draw personal fast through modern professional real. Leg important summer.",21:31:12,CHEQUE
AZVR85135161881683,GB95URAP17054870000917,5/17/2016,26787.08,100001,N,Credited,FF,POS,Cr,18:06:42,23:54:47,2/28/2021,6749613,955.51,2,"Leg beautiful alone fall life this. Against use new group.
Care federal involve agreement. Soldier detail especially represent yet. Now consider development culture upon along.",20:10:32,IMPS
AZVR85135161881683,GB95URAP17054870000917,5/17/2016,28492.18,100001,N,Credited,FF,PC,Cr,4:11:59,8:11:49,3/5/2021,38213328,1705.1,2,Until whose produce game himself large thousand. Newspaper color stuff deep society history. Hard enjoy like civil material enter.,7:05:05,IMPS
AZVR85135161881683,GB95URAP17054870000917,5/17/2016,26787.08,100001,Y,Transportation,CHROME,POS,Dr,12:23:37,15:50:52,3/5/2021,99072599,1705.1,6,"Last result perform particular church they like. Name build technology above.
President game head participant contain left. Answer step form stay. Take act number receive national.",13:41:39,CHEQUE
AZVR85135161881683,GB95URAP17054870000917,5/17/2016,25081.98,100001,Y,Rent,SAFARI,MOBILE,Dr,19:43:20,23:53:49,3/5/2021,76819933,1705.1,3,"Memory gun next site particular his. Or feeling step detail available staff include. Pm film team.
Black weight first church. Fall suddenly employee message.",22:31:19,RTGS
AZVR85135161881683,GB95URAP17054870000917,5/17/2016,26792.31,100001,N,Credited,IE,POS,Cr,5:54:10,9:57:50,3/6/2021,29307791,1710.33,4,Issue consider per sound art win. Necessary challenge direction together popular a. Least example sing job lawyer method poor likely.,7:42:44,UPI
AZVR85135161881683,GB95URAP17054870000917,5/17/2016,25081.98,100001,Y,Groceries,IE,PC,Dr,11:18:36,14:58:49,3/6/2021,25377163,1710.33,2,"Onto with they say join shoulder. Trip condition oil north guy officer seek. Enough blue these agency.
Door remember manage night. Any style include. Term total family.",12:58:44,IMPS
AZVR85135161881683,GB95URAP17054870000917,5/17/2016,23371.65,100001,Y,Transportation,CHROME,POS,Dr,15:12:04,17:46:34,3/6/2021,47423190,1710.33,6,"Concern evening forget. Possible reach road subject industry wall. Red marriage crime entire.
Exactly base consider that.",16:23:13,CHEQUE
AZVR85135161881683,GB95URAP17054870000917,5/17/2016,25081.98,100001,N,Credited,OPERA,POS,Cr,19:46:31,21:58:04,3/6/2021,11083634,1710.33,4,"Indicate institution avoid product begin. Same with develop left culture. Himself pick dream tend let.
What probably listen kid. Others seek safe mouth discuss right.",21:03:56,UPI
AZVR85135161881683,GB95URAP17054870000917,5/17/2016,25044.57,100001,Y,Entertainment,SAFARI,MOBILE,Dr,21:03:48,26:11:33,3/9/2021,45030352,37.41,6,"House hit news tree one before. Outside well pressure church well treat.
Factor laugh friend go. Successful nearly long while do. Forget too mother book. Thank usually high behind design.",22:49:55,CHEQUE
AZVR85135161881683,GB95URAP17054870000917,5/17/2016,24030.38,100001,Y,Groceries,FF,PC,Dr,6:36:37,8:21:11,3/14/2021,74821112,1014.19,4,"Look across what. Five off people environmental near.
Hit dinner per. Plan important kid daughter candidate full. Act seem behavior perhaps.
Either about another. Toward suddenly guess.",7:51:09,UPI
AZVR85135161881683,GB95URAP17054870000917,5/17/2016,23016.19,100001,Y,Medicals,IE,MOBILE,Dr,9:18:14,11:58:25,3/14/2021,42765295,1014.19,2,"Across receive hear low reach. Life mean can forward.
Adult Democrat since audience in. Base knowledge address support help laugh. Reduce international that discussion too Mr much.",11:10:48,IMPS
AZVR85135161881683,GB95URAP17054870000917,5/17/2016,24030.38,100001,N,Credited,IE,POS,Cr,14:13:39,15:49:42,3/14/2021,68390044,1014.19,6,No rich view hospital. Other spring computer.,14:52:46,CHEQUE
AZVR85135161881683,GB95URAP17054870000917,5/17/2016,23016.19,100001,Y,Utilities,OPERA,POS,Dr,16:55:38,19:51:15,3/14/2021,94486094,1014.19,6,"Tend building kitchen become. Understand product mouth unit blue major visit.
Around production bill issue. Difference call tree region son debate receive. Cause happy someone authority.",18:41:51,CHEQUE
AZVR85135161881683,GB95URAP17054870000917,5/17/2016,22002,100001,Y,Medicals,IE,POS,Dr,18:14:33,21:33:31,3/14/2021,75483456,1014.19,2,Lead majority about foreign woman remember stop group. Need everyone structure goal fish. Save land kitchen month behind everybody. Drive blood here together.,20:04:28,IMPS
AZVR85135161881683,GB95URAP17054870000917,5/17/2016,20314.39,100001,Y,Groceries,MI,POS,Dr,11:18:54,16:05:03,3/17/2021,49072952,1687.61,6,"Play democratic quickly. Crime music arm short.
Bank fund over even newspaper east toward. Movie sort structure community.",12:58:13,CHEQUE
AZVR85135161881683,GB95URAP17054870000917,5/17/2016,20434.65,100001,N,Credited,MI,MOBILE,Cr,17:57:50,24:39:21,3/25/2021,22940995,120.26,4,"Human week ability huge race attorney. Who describe message next good difficult those. Writer research state likely share cold.
Lose kitchen bank create prevent. Cold fear here right coach true.",21:42:58,UPI
AZVR85135161881683,GB95URAP17054870000917,5/17/2016,18511.41,100001,Y,Rent,CHROME,POS,Dr,11:10:44,19:41:04,3/30/2021,68231804,1923.24,1,Animal have industry claim. Dog college last lawyer responsibility manager. Actually special Mrs court should have. Medical yes beautiful worry thousand.,16:55:03,NEFT
AZVR85135161881683,GB95URAP17054870000917,5/17/2016,17678.68,100001,Y,Dining,MI,PC,Dr,4:23:13,7:19:12,3/31/2021,79703772,832.73,3,"Town step radio trial too. Center place win paper.
Everyone authority clear. Bit shake deep wrong continue.
Imagine fund fear. Raise protect piece town goal.",5:31:39,RTGS
AZVR85135161881683,GB95URAP17054870000917,5/17/2016,16845.95,100001,Y,Personal Care,SAFARI,MOBILE,Dr,8:44:18,10:03:06,3/31/2021,96643129,832.73,3,"Notice prove magazine attack.
Party weight technology information provide line. Car woman either tonight later hear guess impact. Economic black money catch space require.",9:21:32,RTGS
AZVR85135161881683,GB95URAP17054870000917,5/17/2016,17678.68,100001,N,Credited,EDGE,POS,Cr,14:47:21,16:47:45,3/31/2021,86499453,832.73,6,How major word condition of respond despite back. Show identify appear lay box. Democratic read example its letter two control.,15:12:10,CHEQUE
AZVR85135161881683,GB95URAP17054870000917,5/17/2016,18511.41,100001,N,Credited,CHROME,PC,Cr,16:19:27,19:06:36,3/31/2021,8163929,832.73,7,Nature program dream role sound minute front. Your up teacher whatever thus simply spend. Benefit probably nothing me always pick.,17:37:11,DD
AZVR85135161881683,GB95URAP17054870000917,5/17/2016,19344.14,100001,N,Credited,EDGE,PC,Cr,22:09:23,24:19:35,3/31/2021,94656718,832.73,3,Scene check game increase why act beat argue. Yeah lay trouble contain fast. Miss parent item participant.,22:54:57,RTGS
AZVR85135161881683,GB95URAP17054870000917,5/17/2016,19066.78,100001,Y,Rent,CHROME,MOBILE,Dr,9:44:28,14:12:51,4/1/2021,243322,277.36,4,"Speech cell yard material result. Kind protect agency company pattern seat.
Should throw operation front hand. Sort in within.
Place address left central politics. Join clear ground building spring.",11:46:56,UPI
AZVR85135161881683,GB95URAP17054870000917,5/17/2016,18789.42,100001,Y,Insurance,IE,PC,Dr,13:57:21,18:29:03,4/1/2021,97400257,277.36,3,"Task if upon. Sense glass claim increase teacher. Story per today TV kind company.
Organization arrive nor. Build traditional want soldier together always raise collection.",16:38:25,RTGS
AZVR85135161881683,GB95URAP17054870000917,5/17/2016,19066.78,100001,N,Credited,SAFARI,PC,Cr,21:47:12,24:17:53,4/1/2021,39816153,277.36,3,Sea benefit last serious listen. In within answer so hundred challenge. During cold institution food policy always station.,23:17:59,RTGS
AZVR85135161881683,GB95URAP17054870000917,5/17/2016,19742.65,100001,N,Credited,EDGE,PC,Cr,3:50:26,5:22:28,4/2/2021,50494484,675.87,5,"Investment fear brother toward. Son care after single baby.
Pay summer color set page.",4:20:17,CARDS
AZVR85135161881683,GB95URAP17054870000917,5/17/2016,20418.52,100001,N,Credited,CHROME,POS,Cr,7:14:22,10:12:58,4/2/2021,17232753,675.87,4,"Life effect well explain. Fish seven evidence able rich race. Mr lot man hour.
Ground less last exist best third. Product itself pattern father rather stop reflect.",8:39:59,UPI
AZVR85135161881683,GB95URAP17054870000917,5/17/2016,21094.39,100001,N,Credited,EDGE,MOBILE,Cr,12:00:07,14:27:08,4/2/2021,45555916,675.87,6,"High in reflect level debate.
Ask federal reflect over term. Once role particular month smile matter look. Similar by day analysis hold war situation resource.",13:56:52,CHEQUE
AZVR85135161881683,GB95URAP17054870000917,5/17/2016,21770.26,100001,N,Credited,FF,PC,Cr,18:13:41,20:31:38,4/2/2021,65798195,675.87,2,"Like allow church. Hard Mr through difference.
Money down coach. Effort crime up bank red great. Image rich free far identify. Look baby cover floor.",19:06:34,IMPS
AZVR85135161881683,GB95URAP17054870000917,5/17/2016,21094.39,100001,Y,Personal Care,OPERA,POS,Dr,22:10:46,24:16:03,4/2/2021,45551,675.87,5,"Stock receive task bring. While PM health health south thought.
Bit local yes between. Discover read doctor magazine card help. Low party organization up data current.",22:58:16,CARDS
AZVR85135161881683,GB95URAP17054870000917,5/17/2016,19507.42,100001,Y,Entertainment,EDGE,PC,Dr,6:57:31,10:58:11,4/8/2021,24998963,1586.97,6,"Move amount pattern hot book within politics too. Recent keep report safe free national.
Hour young thing case public today. According several the.",9:05:49,CHEQUE
AZVR85135161881683,GB95URAP17054870000917,5/17/2016,17920.45,100001,Y,Personal Care,OPERA,PC,Dr,13:07:42,15:11:34,4/8/2021,20781217,1586.97,2,Professional body born she. Perform because no amount. Agent music wall financial everyone.,13:53:44,IMPS
AZVR85135161881683,GB95URAP17054870000917,5/17/2016,19507.42,100001,N,Credited,MI,MOBILE,Cr,19:56:58,23:32:04,4/8/2021,91430052,1586.97,3,Name at house maybe catch his election oil. Different chair develop size fund. You choose at vote staff within kind. Season three man one other history increase.,20:58:49,RTGS
AZVR85135161881683,GB95URAP17054870000917,5/17/2016,18160.79,100001,Y,Household Consumables,EDGE,MOBILE,Dr,19:50:45,26:40:30,4/16/2021,59614579,1346.63,3,Single beat example issue street coach help sometimes. Degree beautiful try political interest.,21:46:26,RTGS
AZVR85135161881683,GB95URAP17054870000917,5/17/2016,19210.31,100001,N,Credited,FF,MOBILE,Cr,19:21:13,27:04:41,4/19/2021,42998334,1049.52,6,"According increase happen. Pull specific create threat.
Sport owner tax person himself evidence health. Head staff describe. Share perhaps mind its ten president environmental.",22:08:41,CHEQUE
AZVR85135161881683,GB95URAP17054870000917,5/17/2016,20907.65,100001,N,Credited,IE,MOBILE,Cr,9:28:59,14:37:48,5/8/2021,22880666,1697.34,5,"Million us option inside onto. Everything nation nature song section little.
Effect soldier matter eye why field here. Quickly nice job least medical.",10:49:52,CARDS
AZVR85135161881683,GB95URAP17054870000917,5/17/2016,22604.99,100001,N,Credited,FF,POS,Cr,21:36:35,24:42:26,5/8/2021,32950922,1697.34,2,"Kind necessary under realize truth growth. Outside among describe other page. Rule claim chance performance actually marriage music.
Peace than course general. Notice yourself understand place.",23:39:20,IMPS
AZVR85135161881683,GB95URAP17054870000917,5/17/2016,22060.42,100001,Y,Transportation,OPERA,PC,Dr,5:15:42,7:56:20,5/25/2021,19936444,544.57,5,Yard maybe to able sister develop catch ground. Firm recent shoulder we phone read show leave. Four work place loss finish help someone tax.,7:03:07,CARDS
AZVR85135161881683,GB95URAP17054870000917,5/17/2016,21515.85,100001,Y,Entertainment,CHROME,POS,Dr,8:34:04,10:35:48,5/25/2021,53975737,544.57,5,Enough commercial back lay question conference chance. Budget better fall. She lead they take.,9:17:55,CARDS
AZVR85135161881683,GB95URAP17054870000917,5/17/2016,22060.42,100001,N,Credited,IE,POS,Cr,12:50:19,14:29:08,5/25/2021,75354961,544.57,6,"Discussion between couple method street benefit worry. Book lead despite since approach common energy none. Pressure public interesting against.
Thing day week decade. Man several such car.",13:39:55,CHEQUE
AZVR85135161881683,GB95URAP17054870000917,5/17/2016,22604.99,100001,N,Credited,MI,MOBILE,Cr,16:41:58,18:07:23,5/25/2021,52375576,544.57,5,Probably receive share rise crime. Lead somebody seem money. Hold hour table structure wish. Catch maybe guy of group laugh live.,17:09:29,CARDS
AZVR85135161881683,GB95URAP17054870000917,5/17/2016,23149.56,100001,N,Credited,OPERA,MOBILE,Cr,22:39:02,25:41:15,5/25/2021,61922648,544.57,1,"Exactly assume day detail production possible. House season class behavior cover receive thus.
Right first happen expect. How two they increase.",23:48:53,NEFT
AZVR85135161881683,GB95URAP17054870000917,5/17/2016,23052.85,100001,Y,Entertainment,EDGE,PC,Dr,7:45:26,11:37:15,5/26/2021,54721500,96.71,5,Unit throw brother while matter research certain Republican. Audience wish black down democratic food gun. Stage important reality daughter.,8:47:55,CARDS
AZVR85135161881683,GB95URAP17054870000917,5/17/2016,22956.14,100001,Y,Online Shopping,SAFARI,PC,Dr,16:54:30,21:47:12,5/26/2021,63847314,96.71,6,"Minute age store. Feeling almost week direction. Experience in movement happen. Along hit color thousand which point floor.
Real market husband save.",19:31:13,CHEQUE
AZVR85135161881683,GB95URAP17054870000917,5/17/2016,24021.3,100001,N,Credited,FF,PC,Cr,10:33:49,14:39:26,5/30/2021,65818657,1065.16,6,"Through southern realize. Wear edge level cover likely law.
Machine detail none though exist television read. Exactly for window total out meet research.",11:40:53,CHEQUE
AZVR85135161881683,GB95URAP17054870000917,5/17/2016,22956.14,100001,Y,Dining,MI,MOBILE,Dr,14:13:50,17:51:06,5/30/2021,62472838,1065.16,3,"Offer value certainly federal figure about how. Record wish drug begin over crime price. Goal war expect window commercial.
Scientist bed walk act. Tough meeting evidence vote fear.",16:15:50,RTGS
AZVR85135161881683,GB95URAP17054870000917,5/17/2016,24021.3,100001,N,Credited,MI,PC,Cr,16:49:52,20:49:08,5/30/2021,58890158,1065.16,1,"Or executive run free. Million test member energy already. Grow expert hotel blood campaign how these.
Fish notice it. Way pass southern perform.
Test station discuss candidate yet spend.",18:34:02,NEFT
AZVR85135161881683,GB95URAP17054870000917,5/17/2016,25797.1,100001,N,Credited,EDGE,MOBILE,Cr,5:38:33,11:04:47,5/31/2021,29235087,1775.8,6,Beat per same expert wide contain. Decision also stop environmental kind explain often answer.,9:33:57,CHEQUE
AZVR85135161881683,GB95URAP17054870000917,5/17/2016,27572.9,100001,N,Credited,FF,MOBILE,Cr,16:55:55,20:15:52,5/31/2021,38282997,1775.8,6,"Follow yourself nor. Task standard eight whole reflect movement. Would nothing exactly short.
Like wide above mind beautiful. Behind fill top full candidate. Decision with wonder toward.",17:47:05,CHEQUE
AZVR85135161881683,GB95URAP17054870000917,5/17/2016,26362.67,100001,Y,Household Consumables,SAFARI,PC,Dr,7:49:26,15:20:53,6/1/2021,75538958,1210.23,2,"Office back TV million. The operation hair election. Group recognize expect when until pick play couple.
Special often under certain ability. Full son program building news answer son.",11:48:28,IMPS
AZVR85135161881683,GB95URAP17054870000917,5/17/2016,27572.9,100001,N,Credited,IE,MOBILE,Cr,17:29:46,22:14:28,6/1/2021,8346766,1210.23,7,"Article these purpose TV. Around individual my deal voice foreign. Each floor tend everybody shoulder.
Others receive speak line pressure whatever. Action step fire pass bring new choose on.",19:40:56,DD
AZVR85135161881683,GB95URAP17054870000917,5/17/2016,28801.49,100001,N,Credited,MI,PC,Cr,3:25:05,6:14:26,6/7/2021,28429050,1228.59,7,"Heart decision lead knowledge. Apply knowledge right item leg example image.
Near it treat see. Skin born capital suggest.",5:13:40,DD
AZVR85135161881683,GB95URAP17054870000917,5/17/2016,27572.9,100001,Y,Utilities,OPERA,MOBILE,Dr,7:55:07,10:03:41,6/7/2021,23431577,1228.59,2,These field current long other generation election responsibility. Hospital resource past hospital ability my kid. Network task owner partner.,8:25:49,IMPS
AZVR85135161881683,GB95URAP17054870000917,5/17/2016,26344.31,100001,Y,Dining,CHROME,PC,Dr,13:35:18,16:04:55,6/7/2021,48483148,1228.59,3,"Create join already than. Attorney order big movie environmental wonder.
Will yet already say. Artist age few identify born.",14:53:54,RTGS
AZVR85135161881683,GB95URAP17054870000917,5/17/2016,27572.9,100001,N,Credited,CHROME,MOBILE,Cr,16:06:06,17:58:10,6/7/2021,65980798,1228.59,2,"American head garden often collection concern.
Yes environmental simply address. Unit movement enough ok.",17:21:14,IMPS
AZVR85135161881683,GB95URAP17054870000917,5/17/2016,28801.49,100001,N,Credited,FF,POS,Cr,22:12:21,24:43:26,6/7/2021,47740129,1228.59,6,Long three past create mission win note or. Already detail white everyone you leader. Represent popular Mrs interest eye.,22:48:19,CHEQUE
AZVR85135161881683,GB95URAP17054870000917,5/17/2016,28498.92,100001,Y,Transportation,IE,MOBILE,Dr,4:24:46,7:41:07,6/8/2021,9258211,302.57,3,"Play investment indicate above man raise amount. Manager must indeed small those stock.
Growth maintain hear west yes.
Seven interesting official doctor politics good involve.",5:40:05,RTGS
AZVR85135161881683,GB95URAP17054870000917,5/17/2016,28801.49,100001,N,Credited,CHROME,MOBILE,Cr,13:06:43,14:42:58,6/8/2021,58683972,302.57,6,"Kind fly spring material which. Service what suddenly respond might next. Process build big prevent now be guess.
Many magazine general across. To network between beat likely war course.",13:45:49,CHEQUE
AZVR85135161881683,GB95URAP17054870000917,5/17/2016,28498.92,100001,Y,Dining,SAFARI,PC,Dr,12:50:05,15:27:37,6/8/2021,28104438,302.57,4,"Environment deal think piece you conference baby. Be economy her interesting other.
Rate near business bring. Student interest school economy. Same former look plan five.",14:53:11,UPI
AZVR85135161881683,GB95URAP17054870000917,5/17/2016,28196.35,100001,Y,Household Consumables,OPERA,PC,Dr,19:55:27,21:56:21,6/8/2021,21142949,302.57,3,"Course entire method than old nation career. Yeah too but stay role.
Thing federal yourself. Protect similar game meet stay finally can production.",20:26:56,RTGS
AZVR85135161881683,GB95URAP17054870000917,5/17/2016,27101.32,100001,Y,Dining,CHROME,PC,Dr,6:25:30,10:25:24,6/9/2021,38780813,1095.03,4,"Large matter he to for likely. Billion investment million sport actually. Building throughout personal better account.
Near force significant media country middle. Most want one. Sit day others hand.",8:44:33,UPI
AZVR85135161881683,GB95URAP17054870000917,5/17/2016,28196.35,100001,N,Credited,CHROME,MOBILE,Cr,12:29:51,15:26:58,6/9/2021,90781643,1095.03,2,Institution attorney important within sure save build sense. Agree matter house picture. Loss manager detail upon our bag choice.,13:39:04,IMPS
AZVR85135161881683,GB95URAP17054870000917,5/17/2016,29291.38,100001,N,Credited,FF,PC,Cr,15:49:40,18:48:48,6/9/2021,85322417,1095.03,7,"Modern suggest experience more bag. Most first glass image. Write edge itself its.
Behind one lawyer record story. Assume personal executive to door least find.",17:42:38,DD
AZVR85135161881683,GB95URAP17054870000917,5/17/2016,28196.35,100001,Y,Personal Care,EDGE,MOBILE,Dr,21:34:41,25:23:16,6/9/2021,11128625,1095.03,2,"Tv less camera successful. Follow throughout audience official daughter store effort. Position investment talk.
Rule another front begin. Do in clear fear notice.",23:50:55,IMPS
AZVR85135161881683,GB95URAP17054870000917,5/17/2016,27712.65,100001,Y,Groceries,SAFARI,PC,Dr,5:11:15,7:50:20,6/15/2021,49889499,483.7,1,Blood strong case real even themselves travel. Require career head see. Your heavy power between.,6:34:57,NEFT
AZVR85135161881683,GB95URAP17054870000917,5/17/2016,28196.35,100001,N,Credited,OPERA,MOBILE,Cr,8:46:10,10:15:37,6/15/2021,54023451,483.7,6,Spend will dog miss throughout data if. Color lawyer wife nothing because major same. Job throw forward.,9:30:25,CHEQUE
AZVR85135161881683,GB95URAP17054870000917,5/17/2016,27712.65,100001,Y,Insurance,EDGE,PC,Dr,13:43:59,16:25:11,6/15/2021,71888989,483.7,6,"Word sell individual final face method nation. Reveal sell prepare during whose. Expert actually reduce decade major between pick.
Lawyer last every discussion.",15:11:43,CHEQUE
AZVR85135161881683,GB95URAP17054870000917,5/17/2016,28196.35,100001,N,Credited,IE,PC,Cr,17:17:43,20:06:31,6/15/2021,29894710,483.7,6,Daughter understand real wall direction tend general. Church one never more growth firm better affect. Song base himself item if.,18:54:27,CHEQUE
AZVR85135161881683,GB95URAP17054870000917,5/17/2016,27712.65,100001,Y,Entertainment,SAFARI,MOBILE,Dr,19:14:18,22:47:17,6/15/2021,7333255,483.7,6,"Focus station science loss. Herself board new in nor article. Bad major of.
Lead environment charge month name tend course. Above heart life.
Scene there training.",21:13:28,CHEQUE
AZVR85135161881683,GB95URAP17054870000917,5/17/2016,26517.78,100001,Y,Online Shopping,EDGE,POS,Dr,4:50:29,8:42:37,6/21/2021,63865981,1194.87,6,"Customer arrive describe simple his feeling. Rock vote certain environmental ten difference. Letter seat Mrs form.
Decade mind his list very. Rest raise sure capital heart it. Officer land get.",7:06:04,CHEQUE
AZVR85135161881683,GB95URAP17054870000917,5/17/2016,25322.91,100001,Y,Transportation,CHROME,PC,Dr,11:30:00,15:24:31,6/21/2021,77116239,1194.87,2,Off require sea central. Beautiful all quite later blood institution. Claim effort continue change.,14:11:41,IMPS
AZVR85135161881683,GB95URAP17054870000917,5/17/2016,26517.78,100001,N,Credited,IE,PC,Cr,21:53:19,25:33:19,6/21/2021,66183174,1194.87,3,"Dream base more page service everything. Network action meet model I word.
Item create eat really. Interest suddenly old so white. Positive charge party feeling face yourself member.",22:37:21,RTGS
AZVR85135161881683,GB95URAP17054870000917,5/17/2016,25361.5,100001,Y,Insurance,CHROME,MOBILE,Dr,5:54:10,7:33:10,7/1/2021,93680349,1156.28,5,Wrong account learn. Soon blood box low. Difference soldier industry generation future behind. Maybe realize action thousand positive together.,7:06:37,CARDS
AZVR85135161881683,GB95URAP17054870000917,5/17/2016,24205.22,100001,Y,Household Consumables,SAFARI,PC,Dr,7:54:34,10:36:07,7/1/2021,77808820,1156.28,3,"Animal get everything behavior among. Daughter so write.
Low compare center animal. Worker figure class capital or politics manager into. Half industry clear every main although.",8:51:03,RTGS
AZVR85135161881683,GB95URAP17054870000917,5/17/2016,23048.94,100001,Y,Personal Care,IE,MOBILE,Dr,15:22:44,17:13:17,7/1/2021,80829393,1156.28,6,Direction win purpose customer finally whatever. Brother north child idea action board. Door plan participant service.,15:58:06,CHEQUE
AZVR85135161881683,GB95URAP17054870000917,5/17/2016,21892.66,100001,Y,Online Shopping,MI,PC,Dr,17:18:29,18:59:21,7/1/2021,39147387,1156.28,7,"Four consumer particularly lawyer natural. Edge garden then participant western. At sea machine score.
Else through and. Another what whose these figure boy very director.",17:56:36,DD
AZVR85135161881683,GB95URAP17054870000917,5/17/2016,23048.94,100001,N,Credited,EDGE,MOBILE,Cr,19:53:20,21:22:26,7/1/2021,88689968,1156.28,1,Notice suggest create ball kitchen still character. Address worker grow. Ever machine smile yeah reduce.,20:36:23,NEFT
AZVR85135161881683,GB95URAP17054870000917,5/17/2016,21368.09,100001,Y,Rent,IE,POS,Dr,9:06:24,19:48:00,7/5/2021,89826355,1680.85,3,"Tv notice pay score cold. Cold policy series arm staff including card.
By score space cover have sure. End audience important interesting suddenly move central.",14:11:55,RTGS
AZVR85135161881683,GB95URAP17054870000917,5/17/2016,22947.41,100001,N,Credited,IE,MOBILE,Cr,5:47:00,7:26:06,7/16/2021,81339211,1579.32,1,"Market role finally family child control need. Prove race network always blue save. One performance consumer national.
Two talk realize open land clear pull around.
Form cell to light lawyer room.",6:41:56,NEFT
AZVR85135161881683,GB95URAP17054870000917,5/17/2016,21368.09,100001,Y,Rent,IE,PC,Dr,9:28:45,11:27:23,7/16/2021,72076026,1579.32,3,"Best realize cultural window between. Test now although watch science full.
Bit player writer spend image floor occur pick. Whose include hundred.",9:58:48,RTGS
AZVR85135161881683,GB95URAP17054870000917,5/17/2016,19788.77,100001,Y,Online Shopping,CHROME,PC,Dr,12:23:57,14:34:42,7/16/2021,37937560,1579.32,1,"Former agree fast ground team early. Future work rule care cost drive talk. Letter admit democratic floor ago deal must doctor.
Image and create partner. Probably go ask recent leave debate.",13:04:42,NEFT
AZVR85135161881683,GB95URAP17054870000917,5/17/2016,18209.45,100001,Y,Transportation,FF,POS,Dr,18:21:36,20:57:50,7/16/2021,29930395,1579.32,3,"Doctor message here visit. Professor last the hard.
Cost blue room official pay both. Home keep according better. Task song traditional stay level.",19:22:22,RTGS
AZVR85135161881683,GB95URAP17054870000917,5/17/2016,19788.77,100001,N,Credited,OPERA,PC,Cr,20:00:26,22:35:33,7/16/2021,88199603,1579.32,2,Analysis although level control. Fine address big have management keep do.,21:12:25,IMPS
AZVR85135161881683,GB95URAP17054870000917,5/17/2016,20519.09,100001,N,Credited,SAFARI,PC,Cr,14:18:38,19:47:17,7/29/2021,45272769,730.32,6,Tonight laugh benefit group arrive project. Travel power bill stop tax. Size chair respond including PM stock.,18:08:28,CHEQUE
AZVR85135161881683,GB95URAP17054870000917,5/17/2016,21879.24,100001,N,Credited,FF,MOBILE,Cr,12:31:56,16:43:53,8/13/2021,6611620,1360.15,1,"Success main possible represent institution hard. Record of easy top.
Involve take deal according author. Question why market reveal box white.",15:51:16,NEFT
AZVR85135161881683,GB95URAP17054870000917,5/17/2016,23239.39,100001,N,Credited,OPERA,POS,Cr,19:56:11,22:37:38,8/13/2021,83472961,1360.15,3,"Catch memory chance evening only sense writer. Us else toward get its yourself deal.
Thus behind blood. Among some here reach.",21:34:09,RTGS
AZVR85135161881683,GB95URAP17054870000917,5/17/2016,23224.85,100001,Y,Dining,OPERA,PC,Dr,8:08:40,11:29:38,8/20/2021,68826536,14.54,2,Special while happen leg cover part structure idea. Kitchen job so pull small position drop.,9:20:09,IMPS
AZVR85135161881683,GB95URAP17054870000917,5/17/2016,23239.39,100001,N,Credited,IE,POS,Cr,11:19:27,12:55:59,8/20/2021,9683914,14.54,1,"Late rich total tell along situation often. Unit person material thing site evidence. Stock traditional important.
Agency smile have entire we officer radio. Again body condition hospital here.",12:15:37,NEFT
AZVR85135161881683,GB95URAP17054870000917,5/17/2016,23224.85,100001,Y,Insurance,OPERA,PC,Dr,17:43:57,19:28:33,8/20/2021,27848289,14.54,7,"Act each its western control. Affect model red personal mean. Win ok behind walk improve agree as.
Religious energy Mrs miss. Give crime sometimes necessary people leg politics. Expert help say.",18:47:39,DD
AZVR85135161881683,GB95URAP17054870000917,5/17/2016,23239.39,100001,N,Credited,SAFARI,PC,Cr,20:02:13,22:18:54,8/20/2021,7013164,14.54,1,"Citizen trip become ground.
Go son entire. Movement while music manager family spend. Should character political effect treat community thousand wonder.
Sister condition push very speak their.",21:39:51,NEFT
AZVR85135161881683,GB95URAP17054870000917,5/17/2016,21602.81,100001,Y,Dining,FF,POS,Dr,4:20:40,5:41:38,8/27/2021,39158352,1636.58,6,"Including notice poor also job still across. Yeah movie character.
Organization woman very current at so town father. Result choose life evidence energy area. Open itself term send pretty.",4:58:22,CHEQUE
AZVR85135161881683,GB95URAP17054870000917,5/17/2016,19966.23,100001,Y,Utilities,SAFARI,PC,Dr,7:38:12,10:49:26,8/27/2021,80828389,1636.58,1,"Action give light simple agent station. Candidate mother everybody not stock.
Them account reduce account listen. Already party talk skill different. Whole effect public edge region bring.",9:35:34,NEFT
AZVR85135161881683,GB95URAP17054870000917,5/17/2016,18329.65,100001,Y,Rent,MI,POS,Dr,12:35:10,15:28:00,8/27/2021,92959309,1636.58,6,"Group million everybody course impact. Catch deal drive shoulder magazine key.
Floor much experience usually book.",14:06:31,CHEQUE
AZVR85135161881683,GB95URAP17054870000917,5/17/2016,16693.07,100001,Y,Rent,OPERA,POS,Dr,15:36:43,18:02:55,8/27/2021,34931851,1636.58,6,"Gas hope environmental bag policy across ever author. Help up remain write sport common.
Factor in hot should. Trial road energy miss. Ten whether us large save hot.",17:27:27,CHEQUE
AZVR85135161881683,GB95URAP17054870000917,5/17/2016,15056.49,100001,Y,Groceries,EDGE,POS,Dr,22:24:32,25:33:26,8/27/2021,40750569,1636.58,6,"Chair heart past growth cultural forward discover. Allow five provide Mr page child. Might share order movie professional ever.
Today town between impact play use. Morning party drive hour son.",23:48:58,CHEQUE
AZVR85135161881683,GB95URAP17054870000917,5/17/2016,16183.25,100001,N,Credited,CHROME,MOBILE,Cr,10:31:55,16:54:46,8/31/2021,72625,1126.76,6,Choice receive more star teach voice think. Sound reveal test out. Other I might office she past.,13:27:00,CHEQUE
AZVR85135161881683,GB95URAP17054870000917,5/17/2016,15038.44,100001,Y,Utilities,MI,POS,Dr,6:14:14,10:55:03,9/13/2021,71191829,1144.81,3,Loss trouble commercial resource brother road reality. Use group social various soldier often force process. Sit ball box customer follow themselves.,8:28:03,RTGS
AZVR85135161881683,GB95URAP17054870000917,5/17/2016,16183.25,100001,N,Credited,IE,POS,Cr,13:54:04,17:42:22,9/13/2021,83977008,1144.81,1,"Hear start on to. Toward right book mission.
Conference themselves life information. Machine lead by himself law agree. Rest dog any young successful president.",15:52:08,NEFT
AZVR85135161881683,GB95URAP17054870000917,5/17/2016,17328.06,100001,N,Credited,EDGE,PC,Cr,20:57:16,24:27:51,9/13/2021,98869398,1144.81,5,Sort war add radio drop garden blue court. Heavy suggest father per individual data. Peace run with very collection although finish. Impact hit town song outside serve list.,21:54:01,CARDS
AZVR85135161881683,GB95URAP17054870000917,5/17/2016,16692.97,100001,Y,Online Shopping,SAFARI,POS,Dr,5:00:59,9:08:24,9/17/2021,41775288,635.09,5,Early fall worker born break prove. Expert include ever outside foot. Coach place item television wait fly.,6:35:46,CARDS
AZVR85135161881683,GB95URAP17054870000917,5/17/2016,16057.88,100001,Y,Personal Care,IE,MOBILE,Dr,10:06:06,14:54:57,9/17/2021,57050713,635.09,1,"Drug wife study require authority ahead doctor let. Peace improve real growth.
Suffer happen film source very. Time research result talk. Film plan fill few record future agreement fact.",12:44:28,NEFT
AZVR85135161881683,GB95URAP17054870000917,5/17/2016,16692.97,100001,N,Credited,OPERA,POS,Cr,23:00:46,24:54:44,9/17/2021,31733410,635.09,2,Recent citizen consider purpose region agency. Yes run step stuff test project season performance. Note can season less history.,23:41:24,IMPS
AZVR85135161881683,GB95URAP17054870000917,5/17/2016,15309.95,100001,Y,Insurance,EDGE,PC,Dr,5:57:58,9:54:37,9/21/2021,612623,1383.02,5,Whether bed foot population culture wear experience. View you security soldier. Reveal small week we hear painting strong performance.,8:39:06,CARDS
AZVR85135161881683,GB95URAP17054870000917,5/17/2016,13926.93,100001,Y,Groceries,FF,PC,Dr,15:12:25,19:54:01,9/21/2021,78031654,1383.02,6,Population prevent certainly nice pressure. Day rest stop easy clearly. Attack child fall rather candidate involve too. Participant writer series must.,17:23:33,CHEQUE
AZVR85135161881683,GB95URAP17054870000917,5/17/2016,12543.91,100001,Y,Insurance,EDGE,MOBILE,Dr,18:46:43,22:26:28,9/21/2021,6876593,1383.02,1,"Key beat thank later each truth blood. Area report left box rock fine. Front go often network drug.
Between operation all.
Charge level loss even friend. Science hard including.",19:58:43,NEFT
AZVR85135161881683,GB95URAP17054870000917,5/17/2016,13257.53,100001,N,Credited,MI,PC,Cr,10:35:13,14:42:03,9/26/2021,64319575,713.62,6,"Down raise natural once. Dog break best mother nation.
May and pretty participant. May turn vote middle which television. Small discussion half follow mother analysis grow former.",11:31:18,CHEQUE
AZVR85135161881683,GB95URAP17054870000917,5/17/2016,12543.91,100001,Y,Rent,EDGE,PC,Dr,20:56:20,27:58:54,9/26/2021,45685583,713.62,4,"Light position policy meeting yard effort food.
Recently window allow vote drug piece. Choice blood recent court. Eat fine these couple impact final leg thus.",23:59:33,UPI
AZVR85135161881683,GB95URAP17054870000917,5/17/2016,14382.47,100001,N,Credited,EDGE,POS,Cr,7:36:44,13:52:29,10/2/2021,39730244,1838.56,6,"Western serve feeling chance become as. Particularly challenge say idea mean.
Picture whether seem gun institution. City officer end.",10:57:26,CHEQUE
AZVR85135161881683,GB95URAP17054870000917,5/17/2016,12543.91,100001,Y,Rent,MI,PC,Dr,15:02:56,20:10:34,10/2/2021,90397776,1838.56,2,"Society enter eat break public. Work beat Republican official magazine.
Stuff us half or lose.
Price able which else election. Forward him human enter daughter fire.",16:27:37,IMPS
AZVR85135161881683,GB95URAP17054870000917,5/17/2016,13374.85,100001,N,Credited,CHROME,MOBILE,Cr,5:03:49,9:20:54,10/13/2021,35996101,830.94,1,Interview dinner wide real first magazine management. Name wonder the sense compare degree.,7:40:20,NEFT
AZVR85135161881683,GB95URAP17054870000917,5/17/2016,14205.79,100001,N,Credited,FF,PC,Cr,11:18:54,16:34:07,10/13/2021,94770599,830.94,1,"Adult operation ten stage. By community light take himself course wonder.
Thousand into despite fight gas practice. She difficult nice hour current management level.",13:48:25,NEFT
AZVR85135161881683,GB95URAP17054870000917,5/17/2016,13374.85,100001,Y,Medicals,OPERA,MOBILE,Dr,20:35:38,22:51:41,10/13/2021,43840878,830.94,7,Past south party first wear. Free home kind sell attack. Situation under by serious instead group.,22:13:25,DD
QJYT23073653949112,GB68IABX12043144453048,12/5/2019,2728.78,100001,Y,Medicals,IE,PC,Dr,11:59:44,15:11:13,12/5/2019,22329677,1919.84,5,House community condition everything indicate rule apply. Mention person security score model inside know really. Figure hair Democrat case indeed involve among.,13:00:43,CARDS
QJYT23073653949112,GB68IABX12043144453048,12/5/2019,4648.62,100001,N,Credited,IE,POS,Cr,22:34:38,26:49:24,12/5/2019,84679079,1919.84,3,"Radio job forward push. Scene represent cultural bag.
Agent face country until. Behavior attorney member race trial smile information.",23:55:16,RTGS
QJYT23073653949112,GB68IABX12043144453048,12/5/2019,6115.99,100001,N,Credited,FF,PC,Cr,3:52:30,7:29:01,12/12/2019,67449026,1467.37,7,"Stage concern wonder dark. May business he turn evening series particularly.
Clear air evidence throw up. Black skill performance media nearly general. Parent anyone instead gun beat.",5:35:38,DD
QJYT23073653949112,GB68IABX12043144453048,12/5/2019,4648.62,100001,Y,Dining,CHROME,POS,Dr,9:52:14,12:44:28,12/12/2019,47035270,1467.37,1,"Effect range believe development whether. Century hospital tell turn begin.
Water investment southern car region. Place anything away trial better call west.",11:39:01,NEFT
QJYT23073653949112,GB68IABX12043144453048,12/5/2019,3181.25,100001,Y,Online Shopping,EDGE,POS,Dr,11:34:37,14:05:33,12/12/2019,10247433,1467.37,4,Image military wide. Learn reason there campaign skin others would. Institution lay argue defense.,13:23:15,UPI
QJYT23073653949112,GB68IABX12043144453048,12/5/2019,1713.88,100001,Y,Online Shopping,IE,PC,Dr,17:07:03,19:06:23,12/12/2019,83669873,1467.37,2,"Teacher certain lot agree police run. Next run word case term issue poor.
Treat road stay southern study service a. Answer poor meet arrive region. Able question across professional much stay from.",18:37:59,IMPS
QJYT23073653949112,GB68IABX12043144453048,12/5/2019,3181.25,100001,N,Credited,EDGE,MOBILE,Cr,18:08:44,21:45:28,12/12/2019,16631038,1467.37,1,"Wish why threat pressure. Economy body field.
West serious thought box whom mean lot. Player specific kind pressure concern office. Door responsibility large food.",20:04:39,NEFT
QJYT23073653949112,GB68IABX12043144453048,12/5/2019,3521.16,100001,N,Credited,SAFARI,POS,Cr,7:13:39,8:47:30,12/23/2019,50997077,339.91,3,Probably add activity. Piece course at cold start candidate ahead. Service maybe begin cause feeling look lay. Because consumer well account.,7:55:15,RTGS
QJYT23073653949112,GB68IABX12043144453048,12/5/2019,3181.25,100001,Y,Household Consumables,EDGE,PC,Dr,15:05:27,17:24:24,12/23/2019,44875572,339.91,4,"Around could improve. My land born soon.
Pay develop care hair determine. Manager chance ten continue I.
Recent young door establish. Game bag view five travel newspaper. Watch prevent air season.",15:46:18,UPI
QJYT23073653949112,GB68IABX12043144453048,12/5/2019,3521.16,100001,N,Credited,MI,PC,Cr,19:30:09,23:11:07,12/23/2019,92742482,339.91,1,Current should notice attorney certain customer itself. The material almost alone clear also reason. Big no you stage manager rate.,20:21:44,NEFT
QJYT23073653949112,GB68IABX12043144453048,12/5/2019,3575.74,100001,N,Credited,OPERA,MOBILE,Cr,13:11:04,17:33:07,12/25/2019,6432522,54.58,3,Clear adult understand rise growth court. Type far option food tell purpose discuss bill. Easy build case consumer per information. Win and book check true maintain.,14:43:11,RTGS
QJYT23073653949112,GB68IABX12043144453048,12/5/2019,5254.65,100001,N,Credited,EDGE,POS,Cr,3:57:03,5:48:33,12/27/2019,81836000,1678.91,6,"Tree candidate natural step sometimes forget or. Camera middle large box book speak skill.
Daughter action century north billion actually. Foreign rest open first.",5:16:29,CHEQUE
QJYT23073653949112,GB68IABX12043144453048,12/5/2019,6933.56,100001,N,Credited,FF,PC,Cr,11:00:46,12:52:45,12/27/2019,35697855,1678.91,7,Protect answer responsibility store protect reality. Somebody billion contain its table movement actually. Writer particularly worry structure either.,12:20:13,DD
QJYT23073653949112,GB68IABX12043144453048,12/5/2019,5254.65,100001,Y,Personal Care,IE,PC,Dr,15:27:31,18:19:30,12/27/2019,22220226,1678.91,4,"Design scene in various system tax.
Marriage listen building provide early. Same appear project way choice western relate. General mission mission institution suffer to support.",17:28:57,UPI
QJYT23073653949112,GB68IABX12043144453048,12/5/2019,3575.74,100001,Y,Groceries,EDGE,MOBILE,Dr,20:52:32,25:14:15,12/27/2019,25740097,1678.91,6,"Executive government leader low animal. House professor citizen raise.
Bring sea never court sort.
The quickly modern data final sure minute. Fact worry its set east.",23:11:08,CHEQUE
QJYT23073653949112,GB68IABX12043144453048,12/5/2019,1893.88,100001,Y,Online Shopping,EDGE,POS,Dr,8:49:18,13:46:53,1/15/2020,29464289,1681.86,6,"Stand live real note artist foot hand another. Along itself several partner simple sure rest.
Support family fast land surface guy. Picture recognize appear.",10:08:16,CHEQUE
QJYT23073653949112,GB68IABX12043144453048,12/5/2019,3575.74,100001,N,Credited,SAFARI,PC,Cr,19:20:26,24:42:08,1/15/2020,77267221,1681.86,3,"Economic to reflect information gun. Would occur manage rise who respond. Respond detail employee.
Baby you simply nature company wonder. Compare friend our.",21:13:51,RTGS
QJYT23073653949112,GB68IABX12043144453048,12/5/2019,3869.75,100001,N,Credited,OPERA,POS,Cr,18:25:03,25:12:21,1/18/2020,85337824,294.01,6,"Amount statement result mind check kid throughout. Better step stay matter soon card no.
Move to able budget artist.
As kitchen ability must. Financial represent knowledge site fine ok industry.",23:52:28,CHEQUE
QJYT23073653949112,GB68IABX12043144453048,12/5/2019,3566.92,100001,Y,Entertainment,MI,POS,Dr,14:22:34,19:32:03,1/22/2020,78849655,302.83,1,"Learn outside represent another value fish discussion. There accept brother stuff trade.
Lawyer go every. Parent stock southern other which. Through drug raise.",16:46:38,NEFT
QJYT23073653949112,GB68IABX12043144453048,12/5/2019,2421.34,100001,Y,Groceries,EDGE,PC,Dr,5:55:42,8:57:39,1/27/2020,97741480,1145.58,6,Serious but son order. Those military identify thousand society speak music. Material pull to people assume human method.,7:43:46,CHEQUE
QJYT23073653949112,GB68IABX12043144453048,12/5/2019,1275.76,100001,Y,Rent,FF,PC,Dr,10:02:36,13:02:58,1/27/2020,78488861,1145.58,1,"Safe person machine home the. Kind score happy maintain safe.
Treat blue appear you. Letter lawyer establish let everybody above front.",11:37:23,NEFT
QJYT23073653949112,GB68IABX12043144453048,12/5/2019,130.18,100001,Y,Transportation,EDGE,PC,Dr,10:33:37,14:08:41,1/27/2020,16238992,1145.58,4,"Beyond you food play beat rest when. Wind against bed heart certain less.
Approach hold his cost building front. Their head material successful early until. Occur table hotel thing culture despite.",12:11:12,UPI
QJYT23073653949112,GB68IABX12043144453048,12/5/2019,481.07,100001,N,Credited,FF,PC,Cr,14:24:46,19:06:36,2/3/2020,38068713,350.89,6,"Admit their painting good practice toward. This certain capital see bring western.
Business include have represent end office.
Customer always drug step.",15:17:10,CHEQUE
QJYT23073653949112,GB68IABX12043144453048,12/5/2019,130.18,100001,Y,Entertainment,OPERA,POS,Dr,18:49:47,23:44:09,2/3/2020,53290717,350.89,6,"Us interview firm industry behavior economic pass. Rock set picture.
Nor able floor establish hour indeed point drug. Guess toward somebody choice.",22:38:15,CHEQUE
QJYT23073653949112,GB68IABX12043144453048,12/5/2019,540.77,100001,N,Credited,MI,PC,Cr,11:54:40,17:41:26,2/9/2020,86323611,410.59,4,"Door treatment fill catch compare recognize. Show test vote scientist increase threat.
Big before mention imagine although. Born front class economy campaign he.",15:28:52,UPI
QJYT23073653949112,GB68IABX12043144453048,12/5/2019,951.36,100001,N,Credited,IE,POS,Cr,15:06:02,18:17:50,2/9/2020,54037984,410.59,4,"Official produce memory along remember bill usually. Treat watch into operation Republican.
Executive sort recognize everything. Pass space year from.
Site often economy theory new score.",17:12:39,UPI
QJYT23073653949112,GB68IABX12043144453048,12/5/2019,2605.3,100001,N,Credited,MI,MOBILE,Cr,21:37:04,29:08:11,2/12/2020,40900896,1653.94,5,Total day within with.,23:12:57,CARDS
QJYT23073653949112,GB68IABX12043144453048,12/5/2019,1606.53,100001,Y,Entertainment,IE,POS,Dr,4:09:35,8:06:24,2/14/2020,43172757,998.77,2,"Off growth star design. Lead raise focus. Pull listen citizen prove threat range ten.
That I add develop money. Music board for play whose some. Fire it moment school.",6:24:34,IMPS
QJYT23073653949112,GB68IABX12043144453048,12/5/2019,2605.3,100001,N,Credited,CHROME,PC,Cr,12:15:11,16:32:17,2/14/2020,35530305,998.77,6,Letter lot big rather establish language letter. Activity strong hold whatever. Sister account fast prevent big.,13:42:52,CHEQUE
QJYT23073653949112,GB68IABX12043144453048,12/5/2019,3604.07,100001,N,Credited,EDGE,PC,Cr,20:24:43,24:59:51,2/14/2020,76946998,998.77,6,"Raise government bring model writer face arrive. Talk black job issue ask people.
Happen participant impact smile tonight show live maybe.",23:14:47,CHEQUE
QJYT23073653949112,GB68IABX12043144453048,12/5/2019,4667.51,100001,N,Credited,FF,MOBILE,Cr,4:28:20,11:16:39,2/15/2020,18723298,1063.44,4,Respond size court human today. Responsibility understand whether democratic fund box of. Fear exist vote.,8:16:46,UPI
QJYT23073653949112,GB68IABX12043144453048,12/5/2019,5730.95,100001,N,Credited,MI,PC,Cr,21:25:29,25:57:33,2/15/2020,30272002,1063.44,5,"Later reduce chair. Side build leader grow anything.
Tree reality west just crime song food fear.
Course west break provide blood go. Work baby stand.",22:24:56,CARDS
QJYT23073653949112,GB68IABX12043144453048,12/5/2019,4308.63,100001,Y,Rent,CHROME,PC,Dr,7:28:49,11:17:06,2/24/2020,78279858,1422.32,5,"Social industry toward more watch. Speech college participant.
Purpose certainly project eye with us oil. Official article billion without reduce.",10:04:46,CARDS
QJYT23073653949112,GB68IABX12043144453048,12/5/2019,5730.95,100001,N,Credited,FF,POS,Cr,13:43:51,17:27:49,2/24/2020,387385,1422.32,5,Cell discuss hundred area ground car stage there. Citizen bar past allow specific never. Difficult general young north.,15:24:12,CARDS
QJYT23073653949112,GB68IABX12043144453048,12/5/2019,7153.27,100001,N,Credited,FF,POS,Cr,22:48:17,25:01:33,2/24/2020,87679533,1422.32,5,"Growth may manager section when stuff western. Including vote option child.
Method occur from miss ok key face. Growth real leader about read wind.",23:29:33,CARDS
QJYT23073653949112,GB68IABX12043144453048,12/5/2019,6257.76,100001,Y,Household Consumables,IE,PC,Dr,4:02:12,6:03:36,3/2/2020,92433427,895.51,2,Return bad discover modern relationship around politics the. Write itself head religious training.,4:39:02,IMPS
QJYT23073653949112,GB68IABX12043144453048,12/5/2019,7153.27,100001,N,Credited,FF,MOBILE,Cr,10:33:08,11:37:33,3/2/2020,97020943,895.51,6,"Six there international industry service series everyone. Hit above ready throw religious drive cell charge.
Whatever war away central television area child way. Unit thus left.",11:06:50,CHEQUE
QJYT23073653949112,GB68IABX12043144453048,12/5/2019,8048.78,100001,N,Credited,IE,POS,Cr,13:23:47,17:01:19,3/2/2020,56526516,895.51,1,Trial computer threat nation end interesting student. Participant everything situation adult alone best notice and. Else be during hard seem. Art develop remain just design.,15:10:13,NEFT
QJYT23073653949112,GB68IABX12043144453048,12/5/2019,7153.27,100001,Y,Entertainment,CHROME,POS,Dr,15:51:31,18:06:47,3/2/2020,89822968,895.51,6,"Sort item push ready issue. Office figure what type open far doctor him.
Quickly help certain certain fall lawyer yet. Pick between near especially threat make including. Artist increase wide stand.",17:03:34,CHEQUE
QJYT23073653949112,GB68IABX12043144453048,12/5/2019,6257.76,100001,Y,Online Shopping,CHROME,PC,Dr,23:07:40,25:37:06,3/2/2020,1085273,895.51,6,"Feeling state suddenly. Life property drive team.
Seek out the upon fire whose. Fish usually politics score movement hotel.",23:50:26,CHEQUE
QJYT23073653949112,GB68IABX12043144453048,12/5/2019,7202.94,100001,N,Credited,CHROME,POS,Cr,5:36:40,7:56:15,3/3/2020,45116636,945.18,6,"Provide he speak authority black race. Class almost government law.
Page film they fish. Before realize any south must the.
Government then surface find party over. Might few whatever my other.",6:45:16,CHEQUE
QJYT23073653949112,GB68IABX12043144453048,12/5/2019,6257.76,100001,Y,Groceries,CHROME,MOBILE,Dr,8:08:01,10:58:49,3/3/2020,80551065,945.18,2,Beat recent character member surface evening. Sport major yet establish. Media laugh every their seem.,10:03:30,IMPS
QJYT23073653949112,GB68IABX12043144453048,12/5/2019,5312.58,100001,Y,Medicals,FF,PC,Dr,12:24:11,15:57:21,3/3/2020,11339045,945.18,4,Always above idea system really author pull. Hard risk unit seat.,14:01:29,UPI
QJYT23073653949112,GB68IABX12043144453048,12/5/2019,6257.76,100001,N,Credited,IE,PC,Cr,18:11:39,20:46:31,3/3/2020,59606031,945.18,4,"Probably write since. Table thank traditional recent father plan. Their maybe president.
In attention animal. Learn tax but not better anything.",19:50:51,UPI
QJYT23073653949112,GB68IABX12043144453048,12/5/2019,5312.58,100001,Y,Transportation,FF,PC,Dr,21:06:18,23:17:27,3/3/2020,4602286,945.18,6,"How bar I future near friend. Professor fact boy employee owner treat.
Leader guess answer evening inside. Government choose film traditional card score. My cultural herself we.",21:35:56,CHEQUE
QJYT23073653949112,GB68IABX12043144453048,12/5/2019,5004.32,100001,Y,Entertainment,OPERA,MOBILE,Dr,4:56:00,8:37:46,3/5/2020,78468504,308.26,2,"Bar its sea mind. High wind partner good environmental imagine compare. Begin church eye skin me out out.
Degree education land while. American however their art.",7:42:59,IMPS
QJYT23073653949112,GB68IABX12043144453048,12/5/2019,4696.06,100001,Y,Rent,FF,PC,Dr,10:05:35,15:33:02,3/5/2020,39139344,308.26,5,"Financial past or fly. Save question I report.
Return eight training from low. Within camera per play. Might management production soon western quite election compare.",12:52:22,CARDS
QJYT23073653949112,GB68IABX12043144453048,12/5/2019,4387.8,100001,Y,Household Consumables,OPERA,MOBILE,Dr,21:12:41,24:08:00,3/5/2020,61814486,308.26,4,"Market work their note build. Rate involve year fall Democrat test other.
When their out drive. Soon his point anyone girl still.
Build start plan key politics. She skin move what strong film tend.",21:48:52,UPI
QJYT23073653949112,GB68IABX12043144453048,12/5/2019,5031.85,100001,N,Credited,SAFARI,PC,Cr,6:54:20,12:11:38,3/6/2020,69835278,644.05,5,"Spring song measure walk machine. Available see table west mention. Market feel analysis available.
Number outside even speech. Remain learn drop up whether Congress.",8:39:20,CARDS
QJYT23073653949112,GB68IABX12043144453048,12/5/2019,5675.9,100001,N,Credited,OPERA,MOBILE,Cr,18:42:55,21:49:51,3/6/2020,2494647,644.05,2,School lose similar family couple smile. Trial movie position before mouth card.,19:31:45,IMPS
QJYT23073653949112,GB68IABX12043144453048,12/5/2019,6673.24,100001,N,Credited,MI,PC,Cr,10:30:38,14:23:11,3/11/2020,4769866,997.34,5,"Still sit serious enough think environmental whom different. Attention protect turn lay.
Act not cell environmental. Career put down television side foot. Leave contain north human however country.",12:49:24,CARDS
QJYT23073653949112,GB68IABX12043144453048,12/5/2019,6017.52,100001,Y,Dining,OPERA,MOBILE,Dr,2:12:20,4:54:56,3/12/2020,65706282,655.72,3,"Last front plant someone term type check. Information have now pass story each state remember.
Lay billion measure serve everything. Level tree foot see likely more focus.",4:03:41,RTGS
QJYT23073653949112,GB68IABX12043144453048,12/5/2019,5361.8,100001,Y,Entertainment,FF,MOBILE,Dr,9:49:12,10:54:31,3/12/2020,37230333,655.72,5,"Industry else boy need fill focus.
Mrs head grow trial perhaps final. Still democratic development yard door church cup. Capital go direction organization body foreign population.",10:24:11,CARDS
QJYT23073653949112,GB68IABX12043144453048,12/5/2019,6017.52,100001,N,Credited,EDGE,MOBILE,Cr,13:26:05,15:17:30,3/12/2020,85366190,655.72,6,Very want politics leader garden. Whom according exist. Good similar trade common hear character.,14:19:41,CHEQUE
QJYT23073653949112,GB68IABX12043144453048,12/5/2019,5361.8,100001,Y,Groceries,IE,MOBILE,Dr,17:52:07,19:09:09,3/12/2020,16035973,655.72,5,Loss politics may follow half idea business court. Soon dinner father peace exactly experience market. Arrive force already.,18:43:26,CARDS
QJYT23073653949112,GB68IABX12043144453048,12/5/2019,4706.08,100001,Y,Transportation,MI,MOBILE,Dr,22:21:53,24:22:53,3/12/2020,61123465,655.72,7,"Hotel ability item here. Exist represent message soldier.
Say chair building political exist visit than. Probably how star agreement check so about. Computer but provide movie cover color final.",23:31:05,DD
QJYT23073653949112,GB68IABX12043144453048,12/5/2019,4248.11,100001,Y,Entertainment,CHROME,POS,Dr,6:51:35,10:33:18,3/21/2020,19964485,457.97,3,"Sign yes go simple leave hair. Knowledge speak clearly institution yet event. Even card middle.
Quality direction past. Determine tell record art. Guy state require rest practice.",8:45:14,RTGS
QJYT23073653949112,GB68IABX12043144453048,12/5/2019,4706.08,100001,N,Credited,EDGE,PC,Cr,12:31:47,14:53:28,3/21/2020,86455282,457.97,5,What out subject their reach. Everything find bring lead raise see. Major police important huge before compare knowledge. Simple modern catch center detail large eye thus.,13:25:19,CARDS
QJYT23073653949112,GB68IABX12043144453048,12/5/2019,5164.05,100001,N,Credited,MI,MOBILE,Cr,21:49:00,25:02:14,3/21/2020,89512128,457.97,5,"Push wind year leg west agent. Use much senior now practice.
Whatever result age explain example. Democratic carry join join. Large suggest cut form from century economy.",23:10:34,CARDS
QJYT23073653949112,GB68IABX12043144453048,12/5/2019,5783.85,100001,N,Credited,IE,PC,Cr,5:30:49,9:25:48,3/24/2020,75865573,619.8,1,Majority seek sometimes. Sort window girl avoid. Decision past husband class find individual thank. Off health along charge avoid hear matter.,7:35:49,NEFT
QJYT23073653949112,GB68IABX12043144453048,12/5/2019,6403.65,100001,N,Credited,CHROME,PC,Cr,9:01:06,13:20:29,3/24/2020,81702091,619.8,3,"Opportunity sound pass just law act for. Argue cultural support probably. Ago account cup draw upon.
Word admit wrong hundred. With after sometimes decide. Mean property give including charge very.",11:10:30,RTGS
QJYT23073653949112,GB68IABX12043144453048,12/5/2019,5783.85,100001,Y,Transportation,MI,POS,Dr,17:21:39,19:02:29,3/24/2020,43128655,619.8,7,"Term develop company staff American. Act my decade beautiful practice particularly.
Not model somebody skill conference. Pay page large vote ok Congress most.",18:29:19,DD
QJYT23073653949112,GB68IABX12043144453048,12/5/2019,5164.05,100001,Y,Entertainment,MI,PC,Dr,20:51:18,23:00:26,3/24/2020,36521913,619.8,5,Six author card treatment magazine. About view yard any effect statement play. Speech including personal ever project seven stage.,22:23:57,CARDS
QJYT23073653949112,GB68IABX12043144453048,12/5/2019,6158.84,100001,N,Credited,SAFARI,POS,Cr,8:01:14,18:53:17,4/8/2020,61383630,994.79,5,Bit suffer need produce loss thus information Congress. Water election poor foreign my. Price call consumer medical still.,13:18:17,CARDS
QJYT23073653949112,GB68IABX12043144453048,12/5/2019,5367.16,100001,Y,Online Shopping,CHROME,POS,Dr,8:21:00,12:00:21,5/14/2020,60697189,791.68,1,"Company old improve rock. Produce kid defense pull.
Know throw share seem decade that piece hotel. Fly force add.
Admit very try father. Spend various ready always box military himself various.",10:46:34,NEFT
QJYT23073653949112,GB68IABX12043144453048,12/5/2019,4575.48,100001,Y,Medicals,SAFARI,MOBILE,Dr,14:17:25,20:18:07,5/14/2020,98254637,791.68,2,"Attention player office. Compare fish explain. North thought bed.
Manage politics role effort increase. Trade inside go fight shake.",16:24:41,IMPS
QJYT23073653949112,GB68IABX12043144453048,12/5/2019,3253.03,100001,Y,Rent,MI,PC,Dr,16:58:04,23:04:01,5/15/2020,19442112,1322.45,4,Cold yard city buy would. Campaign event movement administration its. Mind per one often.,20:25:40,UPI
QJYT23073653949112,GB68IABX12043144453048,12/5/2019,4933.83,100001,N,Credited,MI,PC,Cr,3:30:03,6:02:45,5/17/2020,85903821,1680.8,2,Prevent hundred start painting rock wait. Son person loss home always next. Answer area tough force despite effect.,4:56:49,IMPS
QJYT23073653949112,GB68IABX12043144453048,12/5/2019,6614.63,100001,N,Credited,MI,MOBILE,Cr,11:16:00,14:07:36,5/17/2020,63529746,1680.8,5,"Message itself fish material. Bit box teacher fine future off. Brother around major window degree debate.
Wonder data threat task prove material per. Always for mouth another.",11:56:45,CARDS
QJYT23073653949112,GB68IABX12043144453048,12/5/2019,4933.83,100001,Y,Household Consumables,FF,MOBILE,Dr,13:36:56,14:54:26,5/17/2020,25038583,1680.8,3,Ask everything few card. Number resource attack wait teach. Success bag around could resource available hot. Become edge hospital improve cut order food.,14:25:05,RTGS
QJYT23073653949112,GB68IABX12043144453048,12/5/2019,3253.03,100001,Y,Groceries,SAFARI,MOBILE,Dr,21:38:48,24:20:28,5/17/2020,62425773,1680.8,2,"Church include necessary share white yard protect.
Various human rock ability everybody pay. Forget difficult someone site.",22:57:39,IMPS
QJYT23073653949112,GB68IABX12043144453048,12/5/2019,2800.98,100001,Y,Transportation,OPERA,PC,Dr,8:04:26,11:03:19,5/18/2020,76335303,452.05,4,Anyone room body pressure test community less. Personal might note physical success body. Woman mission history. Citizen another leave rock behind Congress American.,9:10:50,UPI
QJYT23073653949112,GB68IABX12043144453048,12/5/2019,3253.03,100001,N,Credited,CHROME,MOBILE,Cr,12:29:17,14:43:48,5/18/2020,1383638,452.05,5,"Develop fight each they. Long model marriage various sound executive evidence argue. Operation push officer rise share put Mrs.
On wait public his red because look owner. Wind establish local.",13:40:08,CARDS
QJYT23073653949112,GB68IABX12043144453048,12/5/2019,2800.98,100001,Y,Transportation,CHROME,POS,Dr,21:02:08,26:07:22,5/18/2020,69404344,452.05,6,"By safe public able later somebody who oil.
Him pull commercial into executive say window somebody. Create energy floor. Prove skin war total attention each interview.",23:28:33,CHEQUE
QJYT23073653949112,GB68IABX12043144453048,12/5/2019,991.86,100001,Y,Entertainment,MI,POS,Dr,8:27:40,14:45:57,5/23/2020,67335404,1809.12,5,"Visit quite college get she. Design skill rather ago media school difficult.
Focus cut girl international away house theory. Identify while decade debate. Evening probably leave.",11:02:25,CARDS
QJYT23073653949112,GB68IABX12043144453048,12/5/2019,246.79,100001,Y,Online Shopping,FF,PC,Dr,7:48:32,10:39:38,5/31/2020,55181334,745.07,4,"Staff heart hope wrong. Them toward likely building. Name heavy rate husband.
Say tree various control identify training various. Last candidate become wish.",9:35:55,UPI
QJYT23073653949112,GB68IABX12043144453048,12/5/2019,991.86,100001,N,Credited,EDGE,POS,Cr,19:40:58,21:48:05,5/31/2020,3021552,745.07,1,"Industry project team quite stay few. Specific worry act effect.
Message term consider identify war. Least walk their subject left must soon. Best owner him but leg hair parent method.",20:57:47,NEFT
QJYT23073653949112,GB68IABX12043144453048,12/5/2019,1212.38,100001,N,Credited,CHROME,MOBILE,Cr,8:41:48,13:40:03,6/1/2020,51178093,220.52,3,Collection PM majority dinner image benefit can president. Discussion realize and teach computer. Total ten far well.,11:27:31,RTGS
QJYT23073653949112,GB68IABX12043144453048,12/5/2019,991.86,100001,Y,Online Shopping,SAFARI,POS,Dr,13:41:34,16:16:56,6/1/2020,32988482,220.52,2,"Fact however debate significant million such. Plan laugh skin majority kid.
Else per peace reflect skin worry sit. Throw southern growth. Voice know involve yourself.",14:39:56,IMPS
QJYT23073653949112,GB68IABX12043144453048,12/5/2019,1212.38,100001,N,Credited,EDGE,MOBILE,Cr,20:17:24,24:51:13,6/1/2020,16775848,220.52,5,"Beyond choice development up list. Best race range avoid paper. Value recently national conference sometimes focus goal child.
Natural argue let human. Wrong personal politics us relate address line.",22:17:08,CARDS
QJYT23073653949112,GB68IABX12043144453048,12/5/2019,2725.19,100001,N,Credited,CHROME,PC,Cr,8:35:13,11:29:46,6/7/2020,96068120,1512.81,6,Quite baby American art. Current evening mission world.,9:31:30,CHEQUE
QJYT23073653949112,GB68IABX12043144453048,12/5/2019,1212.38,100001,Y,Entertainment,FF,MOBILE,Dr,12:32:00,15:38:20,6/7/2020,73733782,1512.81,2,"There effort whom her space ahead even choice. Election movement century hair us its.
Tax popular myself traditional per few foot world. Notice note spring.",14:37:38,IMPS
QJYT23073653949112,GB68IABX12043144453048,12/5/2019,2169.89,100001,N,Credited,FF,PC,Cr,12:20:34,18:24:22,6/14/2020,95535227,957.51,1,"Seek they set price like feel.
Sure property standard trip public statement movement. Apply most statement store bad consider office. Summer somebody buy.
Machine third professional husband room can.",16:27:23,NEFT
QJYT23073653949112,GB68IABX12043144453048,12/5/2019,2200.92,100001,N,Credited,MI,POS,Cr,6:57:16,8:19:00,6/17/2020,42144977,31.03,7,"Check health indicate table fish. Much activity term feeling.
Agency sense region. Similar local knowledge worker.
Usually short detail. Study glass cultural.",7:29:53,DD
QJYT23073653949112,GB68IABX12043144453048,12/5/2019,2169.89,100001,Y,Insurance,FF,MOBILE,Dr,9:24:11,12:03:09,6/17/2020,69908323,31.03,5,Night feeling reality force price who. Music time special determine oil according. Control national leader fish machine success eye where.,10:36:06,CARDS
QJYT23073653949112,GB68IABX12043144453048,12/5/2019,2138.86,100001,Y,Utilities,IE,PC,Dr,13:19:27,14:32:59,6/17/2020,26188980,31.03,6,"Summer in home evening occur none. Effort apply this public.
Job evidence bed field mention policy. Material here step safe. Score build history improve risk.",13:44:37,CHEQUE
QJYT23073653949112,GB68IABX12043144453048,12/5/2019,2107.83,100001,Y,Insurance,FF,MOBILE,Dr,18:06:25,20:47:27,6/17/2020,53130938,31.03,7,"Trouble product consider role mouth push economic least. Democrat moment reveal.
Soon property ask floor. Various raise role candidate have.",19:49:29,DD
QJYT23073653949112,GB68IABX12043144453048,12/5/2019,2076.8,100001,Y,Household Consumables,SAFARI,POS,Dr,20:47:45,22:39:13,6/17/2020,70691610,31.03,3,Like join sell six prove. Kitchen garden why themselves stay car.,22:02:12,RTGS
QJYT23073653949112,GB68IABX12043144453048,12/5/2019,2597.68,100001,N,Credited,IE,PC,Cr,5:10:58,6:21:51,6/22/2020,58252840,520.88,4,"Many fact continue ago rest.
Because level response enjoy dinner serve machine. Ask ground want billion meet. Eight difference check couple including skill project.",5:42:06,UPI
QJYT23073653949112,GB68IABX12043144453048,12/5/2019,3118.56,100001,N,Credited,FF,PC,Cr,9:56:44,12:02:23,6/22/2020,15222459,520.88,7,"Reveal various nearly figure alone. Put whatever radio computer several. Amount pick again rule something family mouth.
City program daughter seat choice. Part concern design degree front.",11:37:01,DD
QJYT23073653949112,GB68IABX12043144453048,12/5/2019,2597.68,100001,Y,Insurance,IE,PC,Dr,11:53:11,14:04:14,6/22/2020,29574667,520.88,3,Fire movie fine paper money fast. Share huge better environmental draw animal manage set. Far program wish budget require.,13:09:33,RTGS
QJYT23073653949112,GB68IABX12043144453048,12/5/2019,3118.56,100001,N,Credited,FF,MOBILE,Cr,15:39:58,17:20:18,6/22/2020,1197419,520.88,7,Perhaps responsibility hope day sea. Design respond chance marriage stuff show. Fish all series fish sure region different.,16:40:04,DD
QJYT23073653949112,GB68IABX12043144453048,12/5/2019,3639.44,100001,N,Credited,EDGE,PC,Cr,21:09:31,22:19:41,6/22/2020,71988481,520.88,1,Support state thus show white. Range organization economy enough floor interesting fire much.,21:36:15,NEFT
QJYT23073653949112,GB68IABX12043144453048,12/5/2019,4964.32,100001,N,Credited,FF,PC,Cr,5:54:21,8:27:49,7/2/2020,71216805,1324.88,3,"Every machine kind property morning. Same political bag amount. Kind cup now all.
Poor experience picture. Management process listen season forget.",7:25:07,RTGS
QJYT23073653949112,GB68IABX12043144453048,12/5/2019,6289.2,100001,N,Credited,OPERA,POS,Cr,9:07:37,11:23:00,7/2/2020,51419417,1324.88,4,Say budget religious treatment for most start. Draw environment fast not. Certain develop security history.,10:27:00,UPI
QJYT23073653949112,GB68IABX12043144453048,12/5/2019,7614.08,100001,N,Credited,FF,MOBILE,Cr,13:25:28,16:02:50,7/2/2020,53599711,1324.88,4,Reach doctor eight along college often star. Course allow half affect mean. How impact present money into sea write. Left prove deep just big accept.,14:44:34,UPI
QJYT23073653949112,GB68IABX12043144453048,12/5/2019,6289.2,100001,Y,Household Consumables,MI,POS,Dr,15:45:16,17:10:23,7/2/2020,20341466,1324.88,3,Wind other especially toward threat room. Provide usually factor data listen degree effort. Economic player way order here article. Bill seem from away thousand beyond sometimes.,16:14:02,RTGS
QJYT23073653949112,GB68IABX12043144453048,12/5/2019,7614.08,100001,N,Credited,IE,PC,Cr,20:46:31,22:58:27,7/2/2020,38308529,1324.88,5,Success market explain. Base ever reveal authority culture sign. Record degree cold help throw cover.,21:50:49,CARDS
QJYT23073653949112,GB68IABX12043144453048,12/5/2019,8175.42,100001,N,Credited,FF,POS,Cr,19:43:56,25:18:08,7/5/2020,75648831,561.34,3,Some include station ability one figure. Feeling media cold cause father conference partner.,21:15:42,RTGS
QJYT23073653949112,GB68IABX12043144453048,12/5/2019,8595.4,100001,N,Credited,EDGE,PC,Cr,14:03:22,17:06:49,7/9/2020,22447708,419.98,7,Sometimes image none thousand rise appear respond. One cultural recently cold ball whole serious.,15:34:43,DD
QJYT23073653949112,GB68IABX12043144453048,12/5/2019,9676.8,100001,N,Credited,OPERA,MOBILE,Cr,11:40:36,22:21:28,7/10/2020,41607060,1081.4,6,"Future provide how provide well amount. Suffer do remember matter green from effect. Which direction opportunity identify respond manager black.
Trip produce also former. Hotel product leader price.",16:33:39,CHEQUE
QJYT23073653949112,GB68IABX12043144453048,12/5/2019,11030.43,100001,N,Credited,SAFARI,PC,Cr,4:19:34,6:51:55,7/15/2020,33636269,1353.63,6,"Day show wind black. Culture poor account speak local owner.
One safe trade. Develop partner north professional. Popular lay they source onto.
Forget risk animal.",5:38:17,CHEQUE
QJYT23073653949112,GB68IABX12043144453048,12/5/2019,9676.8,100001,Y,Insurance,EDGE,POS,Dr,11:41:45,14:27:03,7/15/2020,7000584,1353.63,3,"Four treatment during step section water bag. Memory already cause house network goal throw most.
Building stuff management mother ahead. Old including its back red. Fund ground them PM fact.",13:29:57,RTGS
QJYT23073653949112,GB68IABX12043144453048,12/5/2019,8323.17,100001,Y,Transportation,IE,PC,Dr,14:10:07,17:07:41,7/15/2020,43871506,1353.63,7,Writer matter newspaper PM range. Certain ago site government these I east. Teach man politics make.,16:13:11,DD
QJYT23073653949112,GB68IABX12043144453048,12/5/2019,6969.54,100001,Y,Dining,IE,PC,Dr,21:13:39,23:58:07,7/15/2020,52705489,1353.63,4,"Ball my oil many others drive adult. Require audience sport tend.
Be moment everything with some explain within require.",22:18:45,UPI
QJYT23073653949112,GB68IABX12043144453048,12/5/2019,6893.08,100001,Y,Rent,MI,POS,Dr,12:52:21,16:20:56,7/19/2020,67668366,76.46,5,"Shoulder economic a guy send parent. Condition then west while. Cause young hear.
Decide anyone foreign south bed particularly accept.",15:30:36,CARDS
QJYT23073653949112,GB68IABX12043144453048,12/5/2019,6816.62,100001,Y,Household Consumables,SAFARI,POS,Dr,13:30:28,18:22:04,7/19/2020,30644793,76.46,3,Always marriage business nature leave medical. Case pattern who.,16:48:04,RTGS
QJYT23073653949112,GB68IABX12043144453048,12/5/2019,5338.12,100001,Y,Medicals,OPERA,MOBILE,Dr,5:58:37,10:45:35,7/22/2020,81656165,1478.5,1,"Long research white.
Floor page guy speak statement degree career. Attorney we change. Goal address indicate ahead wall.
Sea game build too election rest. Nor animal exactly foot news future pretty.",8:04:17,NEFT
QJYT23073653949112,GB68IABX12043144453048,12/5/2019,3859.62,100001,Y,Dining,MI,MOBILE,Dr,13:06:47,17:22:14,7/22/2020,97429746,1478.5,1,"Party card recognize such new. Life cup brother trouble method view buy.
Ability life bill Mr concern. Yeah until benefit water. Interview education girl near. Media decide study.",15:35:50,NEFT
QJYT23073653949112,GB68IABX12043144453048,12/5/2019,5338.12,100001,N,Credited,EDGE,POS,Cr,21:14:38,24:54:44,7/22/2020,39417213,1478.5,5,"Yes total Congress ok management think. Individual recent blood network history. Time government laugh mouth store.
Surface eight partner the culture. Something report like question idea threat be.",23:30:31,CARDS
QJYT23073653949112,GB68IABX12043144453048,12/5/2019,5091.24,100001,Y,Transportation,MI,PC,Dr,8:37:50,14:18:55,7/28/2020,26052137,246.88,4,Over own security must. Find place wind bit agency others phone. Choose side near interview note we.,11:45:57,UPI
QJYT23073653949112,GB68IABX12043144453048,12/5/2019,4844.36,100001,Y,Medicals,IE,POS,Dr,13:37:34,19:26:50,7/28/2020,59220107,246.88,4,Across discover night public. More determine laugh learn alone both war. Plan more summer game rate green. Ok evidence would color.,16:42:05,UPI
QJYT23073653949112,GB68IABX12043144453048,12/5/2019,6805.67,100001,N,Credited,IE,PC,Cr,8:50:42,12:33:35,7/31/2020,18134667,1961.31,3,"Ok almost development hope care send. Save maintain important out carry health.
Break than represent major such learn often house. Choose foreign image change take.",10:02:42,RTGS
QJYT23073653949112,GB68IABX12043144453048,12/5/2019,4844.36,100001,Y,Household Consumables,EDGE,PC,Dr,11:04:08,14:28:52,7/31/2020,73862581,1961.31,2,"Short physical main.
Should by test risk home a change western. Reduce manager morning agency. Discover choose share they at.
Research walk away law minute card so. Seven off food focus strategy.",13:13:42,IMPS
QJYT23073653949112,GB68IABX12043144453048,12/5/2019,2883.05,100001,Y,Rent,CHROME,POS,Dr,16:12:59,19:47:16,7/31/2020,12335640,1961.31,5,"How loss very ability. Tonight house lead various conference set.
Toward simple according despite. Social general I never all same computer. If when like next.",18:58:08,CARDS
QJYT23073653949112,GB68IABX12043144453048,12/5/2019,2565.02,100001,Y,Medicals,EDGE,PC,Dr,3:32:33,5:12:27,8/1/2020,27571170,318.03,3,Tonight anyone could skill student member try wonder. Notice bring same move this within PM.,4:01:51,RTGS
QJYT23073653949112,GB68IABX12043144453048,12/5/2019,2883.05,100001,N,Credited,IE,POS,Cr,10:16:15,12:11:34,8/1/2020,67407200,318.03,1,Serve early which speech national. Successful hour condition instead. Career ask floor maybe. Seek miss move always especially better.,10:59:05,NEFT
QJYT23073653949112,GB68IABX12043144453048,12/5/2019,2565.02,100001,Y,Rent,MI,POS,Dr,11:47:32,12:39:09,8/1/2020,3193372,318.03,6,"Arrive simply follow view. Former to reflect probably say call fish.
Doctor movie more entire. Against surface draw while.",12:14:18,CHEQUE
QJYT23073653949112,GB68IABX12043144453048,12/5/2019,2246.99,100001,Y,Entertainment,SAFARI,POS,Dr,14:57:09,18:01:01,8/1/2020,40256009,318.03,7,"Eye particular once spring create. Same company season prepare quite for.
Authority environmental why yet sign save. Idea south ground cold accept.",16:29:06,DD
QJYT23073653949112,GB68IABX12043144453048,12/5/2019,1928.96,100001,Y,Entertainment,OPERA,MOBILE,Dr,22:23:32,25:11:58,8/1/2020,17543422,318.03,3,"Feel machine option education price choose century. Similar drop century least lose. Defense agree writer design.
Development in author name. Point practice thousand lay policy quickly eye.",23:54:15,RTGS
QJYT23073653949112,GB68IABX12043144453048,12/5/2019,1753.01,100001,Y,Online Shopping,SAFARI,PC,Dr,7:03:24,9:47:38,8/5/2020,98617302,175.95,6,"Nice blue difficult area question officer themselves cup.
Management for future arrive finally stock. Perform behind career stuff no side same. Detail also leader every compare.",8:50:43,CHEQUE
QJYT23073653949112,GB68IABX12043144453048,12/5/2019,1928.96,100001,N,Credited,EDGE,PC,Cr,9:26:29,11:44:44,8/5/2020,1535259,175.95,2,Maintain face Mrs break born suddenly city toward. Lawyer those remember perform become.,10:33:05,IMPS
QJYT23073653949112,GB68IABX12043144453048,12/5/2019,1753.01,100001,Y,Online Shopping,SAFARI,PC,Dr,14:07:58,16:41:00,8/5/2020,82323455,175.95,6,"Ok key across interview exactly. West who break available.
Wear character camera. Red outside read each a however night. Value enough condition or growth notice.",15:49:22,CHEQUE
QJYT23073653949112,GB68IABX12043144453048,12/5/2019,1577.06,100001,Y,Medicals,OPERA,POS,Dr,18:14:44,20:50:20,8/5/2020,12766352,175.95,3,"Really professor share institution very smile cut. Window decade decision item huge past.
None respond she while most set age travel. Visit boy here today Democrat.",19:22:01,RTGS
QJYT23073653949112,GB68IABX12043144453048,12/5/2019,1247.87,100001,Y,Online Shopping,SAFARI,POS,Dr,9:16:49,12:52:52,9/23/2020,50182770,329.19,6,"Response move approach ok thing born job. Begin physical a role. Unit student into source.
Cold group government. Might serious difference meeting study.",12:02:46,CHEQUE
QJYT23073653949112,GB68IABX12043144453048,12/5/2019,918.68,100001,Y,Groceries,SAFARI,MOBILE,Dr,22:37:23,25:37:32,9/23/2020,88957852,329.19,3,"Color middle my. Leg best painting type history one. Campaign must president prepare feel outside admit.
Safe recognize theory girl. Rich general party usually. Tv test run.",23:51:15,RTGS
QJYT23073653949112,GB68IABX12043144453048,12/5/2019,2632.85,100001,N,Credited,CHROME,PC,Cr,10:05:29,13:41:40,9/27/2020,66988540,1714.17,7,"Foot mind alone artist. Offer community every century might attorney window building.
Any room serious remain information sister respond.",11:50:03,DD
QJYT23073653949112,GB68IABX12043144453048,12/5/2019,4347.02,100001,N,Credited,CHROME,POS,Cr,13:39:03,15:11:01,9/27/2020,34077207,1714.17,6,"Wide his else treat discussion. Billion our soldier. Safe she appear heart play analysis worry.
Paper add food form see he. Trade office artist Democrat like. Represent direction help people civil.",14:31:37,CHEQUE
QJYT23073653949112,GB68IABX12043144453048,12/5/2019,6061.19,100001,N,Credited,OPERA,MOBILE,Cr,20:32:42,22:57:33,9/27/2020,84798558,1714.17,2,Rate condition pass focus outside. Reveal grow oil for. Treatment letter stuff decade cause spend mean.,21:51:01,IMPS
QJYT23073653949112,GB68IABX12043144453048,12/5/2019,7400.97,100001,N,Credited,CHROME,MOBILE,Cr,7:00:40,14:03:35,10/6/2020,17164337,1339.78,6,Generation both realize quite property must defense. Wrong TV fast data want. Morning people worry after success.,10:35:09,CHEQUE
QJYT23073653949112,GB68IABX12043144453048,12/5/2019,8740.75,100001,N,Credited,CHROME,PC,Cr,19:26:26,25:08:30,10/6/2020,61712058,1339.78,1,"Development three type once. Knowledge affect sister record another million.
Available class almost budget size nearly. Bill forward law yes matter among.",23:01:59,NEFT
QJYT23073653949112,GB68IABX12043144453048,12/5/2019,10644.29,100001,N,Credited,FF,PC,Cr,5:17:27,10:42:05,10/7/2020,82494254,1903.54,3,"We service under explain significant skin. What figure book what.
Analysis official type administration nice. Seven door sit evidence.",7:59:43,RTGS
QJYT23073653949112,GB68IABX12043144453048,12/5/2019,12547.83,100001,N,Credited,IE,POS,Cr,12:44:31,15:46:06,10/7/2020,65008799,1903.54,2,"Free town college language hold cause. Blood huge service recent statement.
Commercial expect catch firm.
Which thing middle society after throw. Building coach respond tell.",14:40:22,IMPS
QJYT23073653949112,GB68IABX12043144453048,12/5/2019,10644.29,100001,Y,Transportation,SAFARI,MOBILE,Dr,18:11:12,21:41:46,10/7/2020,54163553,1903.54,7,Table result order upon level open. Lot all lawyer market within prevent son yourself. Box citizen upon while black.,20:54:13,DD
QJYT23073653949112,GB68IABX12043144453048,12/5/2019,9763.53,100001,Y,Personal Care,EDGE,PC,Dr,6:12:03,8:20:31,10/9/2020,10837993,880.76,1,"Interest treatment safe future adult exist. Affect drop ago account drive hospital.
Wall early decade avoid big. Pass decide guy employee. Street hear debate do glass major. Increase begin hope.",6:56:34,NEFT
QJYT23073653949112,GB68IABX12043144453048,12/5/2019,10644.29,100001,N,Credited,FF,PC,Cr,7:31:53,9:57:29,10/9/2020,32753363,880.76,7,"Leave behavior explain hand feel realize. Easy administration job within.
Task with present avoid street. Security media almost drug leave. Cold article if always.",9:23:39,DD
QJYT23073653949112,GB68IABX12043144453048,12/5/2019,11525.05,100001,N,Credited,OPERA,MOBILE,Cr,14:50:54,16:46:08,10/9/2020,30829862,880.76,7,Manager often throughout dark inside gas. Reflect however city among food important rich.,15:39:08,DD
QJYT23073653949112,GB68IABX12043144453048,12/5/2019,12405.81,100001,N,Credited,CHROME,POS,Cr,16:12:33,18:30:08,10/9/2020,57163109,880.76,7,"More court remain many. Bank continue production eye. News night window major he ground foot.
Yard road project attorney wear value. Amount Congress institution positive interest direction specific.",17:31:21,DD
QJYT23073653949112,GB68IABX12043144453048,12/5/2019,11525.05,100001,Y,Dining,SAFARI,POS,Dr,22:21:12,24:19:29,10/9/2020,78499355,880.76,5,"Expect key far eat court own. Several would imagine professor.
Daughter begin artist another financial develop. Including loss street third return. Seem point lay movie often agreement worker hour.",23:49:36,CARDS
QJYT23073653949112,GB68IABX12043144453048,12/5/2019,12112.5,100001,N,Credited,OPERA,PC,Cr,11:34:45,17:13:04,10/13/2020,28016946,587.45,2,Read position husband more dinner join kid. Sing house attention whether green. Should suggest language American speak quite scene phone.,14:27:17,IMPS
QJYT23073653949112,GB68IABX12043144453048,12/5/2019,11525.05,100001,Y,Dining,MI,MOBILE,Dr,18:22:43,22:25:15,10/13/2020,82911065,587.45,5,Bar nice Congress age today paper enough. Seek then character defense.,20:10:26,CARDS
QJYT23073653949112,GB68IABX12043144453048,12/5/2019,10679.01,100001,Y,Utilities,SAFARI,MOBILE,Dr,10:36:36,21:02:45,10/16/2020,61243743,846.04,1,Cup pass which exactly too collection a. Perform citizen case be say. Per name range media blood. Who leg six factor state inside hospital necessary.,16:12:29,NEFT
QJYT23073653949112,GB68IABX12043144453048,12/5/2019,10437.7,100001,Y,Insurance,SAFARI,MOBILE,Dr,10:04:52,13:28:59,10/25/2020,7046636,241.31,6,"Than citizen memory eat. You this region help he would skill. However smile assume increase choose animal.
Our minute size simply surface computer explain. War boy dog no focus.",11:41:26,CHEQUE
QJYT23073653949112,GB68IABX12043144453048,12/5/2019,10679.01,100001,N,Credited,CHROME,POS,Cr,19:16:09,24:49:22,10/25/2020,94443059,241.31,1,"Soldier benefit want her herself street exist. Nearly total home determine.
Issue daughter should building bill standard way. Reveal thing drug summer home soldier.",21:28:50,NEFT
QJYT23073653949112,GB68IABX12043144453048,12/5/2019,12035.47,100001,N,Credited,SAFARI,PC,Cr,7:54:16,9:37:05,10/31/2020,29669950,1356.46,1,Any again treat build total western. Crime should possible that beat woman staff walk.,8:46:13,NEFT
QJYT23073653949112,GB68IABX12043144453048,12/5/2019,10679.01,100001,Y,Medicals,MI,POS,Dr,15:16:34,17:50:01,10/31/2020,6751296,1356.46,1,Training traditional consumer might as high responsibility create. Laugh type work. Happy just instead sure win discuss all.,17:10:08,NEFT
QJYT23073653949112,GB68IABX12043144453048,12/5/2019,12035.47,100001,N,Credited,EDGE,POS,Cr,19:45:59,22:52:34,10/31/2020,84496461,1356.46,3,"Although person far whole white task. Question knowledge measure. Take ten moment art enter traditional girl.
Occur debate improve air. About role minute try son since cause.",20:26:38,RTGS
QJYT23073653949112,GB68IABX12043144453048,12/5/2019,13792.01,100001,N,Credited,FF,POS,Cr,9:08:01,13:26:41,11/14/2020,77537164,1756.54,1,"Field let all such defense. Anyone sell indeed quickly.
Bed recently voice win skin pretty. Major only strategy provide million toward.",10:57:56,NEFT
QJYT23073653949112,GB68IABX12043144453048,12/5/2019,15548.55,100001,N,Credited,CHROME,POS,Cr,11:32:28,16:03:48,11/14/2020,57355832,1756.54,7,Hard material per behavior director someone. Next watch director side food fish public local.,13:53:35,DD
QJYT23073653949112,GB68IABX12043144453048,12/5/2019,17305.09,100001,N,Credited,OPERA,POS,Cr,19:38:53,23:08:49,11/14/2020,15842435,1756.54,4,"Computer why anything movie new. Laugh fast doctor while check truth hot quality. Blue half rise something cost article.
Give both above grow piece. Conference huge form professor much edge.",20:54:39,UPI
QJYT23073653949112,GB68IABX12043144453048,12/5/2019,17070.75,100001,Y,Insurance,MI,MOBILE,Dr,5:27:09,8:41:20,11/23/2020,81870387,234.34,2,"Result around beyond place task. Suggest visit which top example decide. Current garden line continue pressure.
Remember its cover identify. Ago this crime pressure sure.",6:48:37,IMPS
QJYT23073653949112,GB68IABX12043144453048,12/5/2019,17305.09,100001,N,Credited,MI,MOBILE,Cr,10:42:39,13:15:29,11/23/2020,63699364,234.34,4,"Citizen case site relate. Pick pass night who by.
Bed beat why down similar share. From short say tax.
Check last down possible. Color loss night last soldier agent look reduce.",11:46:58,UPI
QJYT23073653949112,GB68IABX12043144453048,12/5/2019,17070.75,100001,Y,Personal Care,MI,PC,Dr,15:38:12,18:38:17,11/23/2020,4471875,234.34,1,"Form become economy win woman. Try always amount age. Let major those soon animal single.
Old manager quite teacher join American. Key defense help wind ask add. Effect minute worker marriage.",17:33:52,NEFT
QJYT23073653949112,GB68IABX12043144453048,12/5/2019,17305.09,100001,N,Credited,IE,MOBILE,Cr,23:23:37,25:22:28,11/23/2020,38656507,234.34,4,"Democratic leader song possible mouth. Money build rich someone design painting.
Claim southern event weight. Skill Republican risk thought.
Pm join experience program big.",23:53:01,UPI
QJYT23073653949112,GB68IABX12043144453048,12/5/2019,16452.98,100001,Y,Online Shopping,CHROME,PC,Dr,3:28:25,5:48:10,11/25/2020,93793940,852.11,6,Current want wear professional individual political party. Near bag even case board enough similar. Understand throw door order special move generation order. Back start foot author check close.,4:31:25,CHEQUE
QJYT23073653949112,GB68IABX12043144453048,12/5/2019,17305.09,100001,N,Credited,OPERA,MOBILE,Cr,7:16:21,10:09:30,11/25/2020,31085885,852.11,3,"Radio central part similar edge easy. Something back old leave much law trade.
Remember artist family as short. Fact close very possible item east.",9:03:41,RTGS
QJYT23073653949112,GB68IABX12043144453048,12/5/2019,16452.98,100001,Y,Transportation,FF,PC,Dr,12:54:15,14:46:12,11/25/2020,20176976,852.11,4,Size most if evening. Different after act hand everyone resource. Energy decide guy red degree something side poor. Most others suggest measure note ok great financial.,13:59:10,UPI
QJYT23073653949112,GB68IABX12043144453048,12/5/2019,17305.09,100001,N,Credited,CHROME,MOBILE,Cr,15:53:17,18:55:26,11/25/2020,27831366,852.11,5,Such material partner common. Religious onto wish yes employee lay. Mouth close return third economy.,17:25:13,CARDS
QJYT23073653949112,GB68IABX12043144453048,12/5/2019,18157.2,100001,N,Credited,CHROME,PC,Cr,22:04:18,24:53:16,11/25/2020,73474968,852.11,2,"Pm explain become past him artist. Term reach century message including. Type that member never develop since.
Area a will relate reveal. But identify reveal few.",23:35:56,IMPS
QJYT23073653949112,GB68IABX12043144453048,12/5/2019,17428.56,100001,Y,Transportation,FF,MOBILE,Dr,3:00:21,6:19:48,11/28/2020,25757019,728.64,1,"Spring cause center performance change. Fund up sound long very summer.
Mind first page success.
Member full change low state tonight. Leader guess face debate more place candidate.",4:52:50,NEFT
QJYT23073653949112,GB68IABX12043144453048,12/5/2019,18157.2,100001,N,Credited,FF,POS,Cr,10:41:21,13:19:02,11/28/2020,69102127,728.64,4,"Item wide every draw book offer American. Reveal story notice treatment often. Drive method stage positive value dream.
Adult their music degree. Side born give voice imagine.",12:17:22,UPI
QJYT23073653949112,GB68IABX12043144453048,12/5/2019,18885.84,100001,N,Credited,EDGE,PC,Cr,15:55:00,18:48:26,11/28/2020,56468427,728.64,4,"Skill customer use free clearly pull still. Society next forward find show.
None cost mention while treatment. Voice wide peace news theory. White throughout cover create.",18:02:30,UPI
QJYT23073653949112,GB68IABX12043144453048,12/5/2019,19614.48,100001,N,Credited,SAFARI,PC,Cr,19:22:15,21:51:38,11/28/2020,53155085,728.64,3,"Sea cut risk game hundred. Class share phone history still. Easy lose mother shoulder shoulder because.
Ability activity actually appear. Wall raise minute room. Stage her discuss image authority.",20:58:34,RTGS
QJYT23073653949112,GB68IABX12043144453048,12/5/2019,21276.37,100001,N,Credited,CHROME,POS,Cr,19:05:10,25:40:06,12/9/2020,71867434,1661.89,6,"Speech special production bed why record. Fall least seat girl huge better ground.
Clearly from story nearly amount. Despite evening drive. Event scientist many but than.",20:30:33,CHEQUE
QJYT23073653949112,GB68IABX12043144453048,12/5/2019,21496.95,100001,N,Credited,SAFARI,POS,Cr,12:58:40,19:57:17,12/13/2020,96119815,220.58,6,Marriage back somebody radio. Understand book rate card figure each population. Financial among particular expect against pressure bad. Now himself clear price.,14:14:23,CHEQUE
QJYT23073653949112,GB68IABX12043144453048,12/5/2019,21399.34,100001,Y,Online Shopping,CHROME,MOBILE,Dr,5:09:17,8:49:52,12/27/2020,20712266,97.61,2,"Successful thus share force where adult senior. Argue election simply woman nice your.
North serious president voice country happy. Local else whole gas fact.",6:09:41,IMPS
QJYT23073653949112,GB68IABX12043144453048,12/5/2019,21301.73,100001,Y,Transportation,EDGE,PC,Dr,14:33:57,18:34:43,12/27/2020,54332843,97.61,4,Various world bad Republican activity way Republican foreign. Kind perform season movie speak. Ago finish probably car choice wrong.,15:47:27,UPI
QJYT23073653949112,GB68IABX12043144453048,12/5/2019,21204.12,100001,Y,Dining,SAFARI,MOBILE,Dr,17:29:42,19:36:46,12/27/2020,86676199,97.61,1,"Per magazine shake must value source especially. Budget door method not evidence song. Our middle include group born.
Next data soldier court. Five before name should. Soon seat enter general power.",18:30:01,NEFT
QJYT23073653949112,GB68IABX12043144453048,12/5/2019,22080.98,100001,N,Credited,OPERA,MOBILE,Cr,11:17:10,17:36:12,1/1/2021,74327898,876.86,5,"Shoulder happen late around. Good no mention moment close.
Significant white attorney democratic building culture our. Officer former campaign cup front.",15:19:41,CARDS
QJYT23073653949112,GB68IABX12043144453048,12/5/2019,22049.88,100001,Y,Medicals,EDGE,PC,Dr,3:02:36,7:22:41,1/7/2021,27931455,31.1,4,"Production its cut pick.
Like recent red generation. Final low not run. Back anyone computer impact discuss impact. Cost family argue area painting course ask.",5:09:46,UPI
QJYT23073653949112,GB68IABX12043144453048,12/5/2019,22018.78,100001,Y,Medicals,CHROME,MOBILE,Dr,8:22:55,11:34:52,1/7/2021,52716027,31.1,3,Third read already table just. Sea step child true realize economic. Generation win one right another answer.,9:40:35,RTGS
QJYT23073653949112,GB68IABX12043144453048,12/5/2019,22049.88,100001,N,Credited,MI,POS,Cr,16:43:01,18:46:11,1/7/2021,38229916,31.1,3,"Manager month peace especially. Need money recognize per final. Prepare positive then instead.
Myself tree then knowledge. Any technology nothing small job.",17:44:51,RTGS
QJYT23073653949112,GB68IABX12043144453048,12/5/2019,22018.78,100001,Y,Dining,OPERA,POS,Dr,20:50:12,24:16:41,1/7/2021,60445230,31.1,2,"This agent response director color attack policy speak.
Thing guy they student. Third represent hair analysis ground concern.",22:25:00,IMPS
QJYT23073653949112,GB68IABX12043144453048,12/5/2019,22672.6,100001,N,Credited,OPERA,PC,Cr,8:35:10,10:07:48,1/8/2021,6064778,653.82,6,Daughter instead apply participant least trip. Similar really after like mind next.,9:29:06,CHEQUE
QJYT23073653949112,GB68IABX12043144453048,12/5/2019,23326.42,100001,N,Credited,CHROME,PC,Cr,10:26:23,15:56:04,1/8/2021,9492967,653.82,4,"Contain woman born mind ten hair.
Collection until laugh adult our. Party could arm two newspaper enough item.
Note power evidence moment modern very. Lose seek race adult election last.",12:58:32,UPI
QJYT23073653949112,GB68IABX12043144453048,12/5/2019,22672.6,100001,Y,Insurance,SAFARI,MOBILE,Dr,16:31:11,21:01:32,1/8/2021,73711056,653.82,7,"Life red debate available. Tell relationship cultural size. Standard the move own threat you.
North risk determine successful gas. Force blue dark year quite kid they even.",19:15:11,DD
QJYT23073653949112,GB68IABX12043144453048,12/5/2019,22663.34,100001,Y,Utilities,SAFARI,PC,Dr,4:30:00,6:54:33,1/13/2021,67413171,9.26,1,Team require tend research wonder. Happen give strategy career. Movie morning officer over.,5:49:41,NEFT
QJYT23073653949112,GB68IABX12043144453048,12/5/2019,22654.08,100001,Y,Utilities,SAFARI,POS,Dr,11:35:18,15:49:13,1/13/2021,70905694,9.26,6,Design which side industry partner dark. Sign sing building various evening there concern. Black good that increase.,13:54:50,CHEQUE
QJYT23073653949112,GB68IABX12043144453048,12/5/2019,22644.82,100001,Y,Groceries,IE,POS,Dr,15:27:41,17:45:27,1/13/2021,27097786,9.26,1,"End attorney cover economy page.
Institution whatever actually mind land green. Wait try meeting give.",17:00:09,NEFT
QJYT23073653949112,GB68IABX12043144453048,12/5/2019,22635.56,100001,Y,Personal Care,SAFARI,PC,Dr,18:24:35,21:34:00,1/13/2021,97079101,9.26,4,"Decide they sign least huge box.
Quite seat meeting sport particularly. Option magazine own final yourself.
With so movie box also. Fine bag movement prevent.",19:47:59,UPI
QJYT23073653949112,GB68IABX12043144453048,12/5/2019,22075.21,100001,Y,Personal Care,EDGE,MOBILE,Dr,17:04:12,23:23:18,1/17/2021,68049386,560.35,5,"Its begin smile these important answer cold firm. Cover good physical surface miss wrong resource. Radio new have customer.
Truth many stage whom.",20:01:20,CARDS
QJYT23073653949112,GB68IABX12043144453048,12/5/2019,23234.18,100001,N,Credited,SAFARI,MOBILE,Cr,2:45:31,6:24:44,1/19/2021,5550036,1158.97,6,"Administration time number past. Strong whole score case successful.
Turn campaign positive only.
Government million right summer student project blue.",4:27:15,CHEQUE
QJYT23073653949112,GB68IABX12043144453048,12/5/2019,24393.15,100001,N,Credited,MI,MOBILE,Cr,6:42:27,9:32:36,1/19/2021,10281895,1158.97,2,"Myself each maybe read skin her give.
Night money own town central figure. Whole officer modern add bring wear often.",8:29:44,IMPS
QJYT23073653949112,GB68IABX12043144453048,12/5/2019,23234.18,100001,Y,Utilities,OPERA,POS,Dr,11:38:19,14:54:47,1/19/2021,3410752,1158.97,3,Husband them between position trip away. News small whatever black. Source cell federal.,13:04:11,RTGS
QJYT23073653949112,GB68IABX12043144453048,12/5/2019,22075.21,100001,Y,Insurance,EDGE,POS,Dr,17:54:48,20:59:18,1/19/2021,39670878,1158.97,4,"Stay project even last.
Production push knowledge dark. Like professor build success.
Reality he then happen serious only. Eight night agency set crime. Book this result final woman.",19:19:04,UPI
QJYT23073653949112,GB68IABX12043144453048,12/5/2019,20916.24,100001,Y,Medicals,OPERA,PC,Dr,21:06:06,24:00:41,1/19/2021,307109,1158.97,3,"Foreign entire body general before article.
Local east prepare thought that six international close. Real everybody seven none.
Customer miss animal let trouble. Behavior citizen next.",22:47:01,RTGS
QJYT23073653949112,GB68IABX12043144453048,12/5/2019,20528.93,100001,Y,Insurance,IE,POS,Dr,6:36:53,8:40:26,2/1/2021,63752274,387.31,2,Someone ground others five service amount call. Program like I and trial woman. Of value relationship born. Last the coach improve term.,7:29:18,IMPS
QJYT23073653949112,GB68IABX12043144453048,12/5/2019,20916.24,100001,N,Credited,CHROME,MOBILE,Cr,9:27:40,13:00:33,2/1/2021,29813155,387.31,5,People security performance myself issue environment. Interesting hospital rock you science next bed.,11:23:01,CARDS
QJYT23073653949112,GB68IABX12043144453048,12/5/2019,20528.93,100001,Y,Online Shopping,SAFARI,POS,Dr,12:52:37,14:44:40,2/1/2021,90906015,387.31,2,"Develop evening research big ok PM. Our positive hold better. Production else over ready.
Door ten fish worry everyone leg single. Production animal official hospital along ahead.",13:50:34,IMPS
QJYT23073653949112,GB68IABX12043144453048,12/5/2019,20916.24,100001,N,Credited,FF,PC,Cr,17:30:56,19:40:47,2/1/2021,96808825,387.31,4,"Company grow very size hot century reality. Feel director large ok write such pretty.
Everything daughter religious issue central stock until. Test above difference forward option a.",18:04:09,UPI
QJYT23073653949112,GB68IABX12043144453048,12/5/2019,21303.55,100001,N,Credited,IE,POS,Cr,22:09:37,24:36:33,2/1/2021,19423012,387.31,4,"Again peace one parent attorney. Business occur investment fear.
Medical hair Democrat data minute bad. Dinner contain far may rock approach quickly. Up receive build southern despite when condition.",23:53:38,UPI
QJYT23073653949112,GB68IABX12043144453048,12/5/2019,21736.87,100001,N,Credited,CHROME,PC,Cr,7:21:53,9:49:33,2/3/2021,26520179,433.32,2,"Woman human particularly life while without lay. Still later laugh development need matter.
Skill indeed whatever grow such improve.",8:24:48,IMPS
QJYT23073653949112,GB68IABX12043144453048,12/5/2019,22170.19,100001,N,Credited,FF,MOBILE,Cr,12:59:00,17:58:16,2/3/2021,44835644,433.32,3,"Develop thank unit out. Perform many purpose force last scientist various.
Become right instead reduce new. Wear project short choose.
Deal however second couple. Go that policy election.",15:26:15,RTGS
QJYT23073653949112,GB68IABX12043144453048,12/5/2019,22603.51,100001,N,Credited,OPERA,POS,Cr,21:07:43,24:19:31,2/3/2021,3258347,433.32,4,"Particular actually by keep.
Camera through put better. Exactly only tonight task offer power and. Produce pick ten citizen training. On development prevent image article.",22:43:57,UPI
QJYT23073653949112,GB68IABX12043144453048,12/5/2019,22350.67,100001,Y,Dining,FF,PC,Dr,10:11:00,13:48:00,2/4/2021,57465340,252.84,3,"Look leader responsibility reflect sea song. Sign general only father believe. Change try see.
Performance nearly agent that need movie husband and.",11:17:48,RTGS
QJYT23073653949112,GB68IABX12043144453048,12/5/2019,22097.83,100001,Y,Transportation,MI,POS,Dr,13:26:21,18:19:46,2/4/2021,84710291,252.84,4,Participant good night room perform court. Another our difference establish wife reality rock.,15:34:16,UPI
QJYT23073653949112,GB68IABX12043144453048,12/5/2019,22350.67,100001,N,Credited,FF,POS,Cr,16:44:07,19:30:30,2/4/2021,40811819,252.84,7,"Poor behavior deal only sometimes crime.
Moment try partner term form so. Who there ever research. Follow plant scientist season.
Doctor language bit woman.",18:07:26,DD
QJYT23073653949112,GB68IABX12043144453048,12/5/2019,23821.53,100001,N,Credited,SAFARI,POS,Cr,7:38:03,11:35:20,2/9/2021,98882151,1470.86,2,"Type provide ground join pick. Author official finish open these mind.
Fear social teach environment letter expert. Baby piece main require above yard set.",10:01:50,IMPS
QJYT23073653949112,GB68IABX12043144453048,12/5/2019,22350.67,100001,Y,Dining,IE,MOBILE,Dr,14:10:11,17:57:45,2/9/2021,14901638,1470.86,1,"Discover believe experience free ever term tell. Suddenly model attention.
Our phone not actually. Hair also participant nearly imagine world. Become north nature imagine region.",16:37:14,NEFT
QJYT23073653949112,GB68IABX12043144453048,12/5/2019,20879.81,100001,Y,Online Shopping,IE,MOBILE,Dr,20:24:44,24:02:59,2/9/2021,81601530,1470.86,1,Whole those hospital. General community region listen.,21:40:12,NEFT
QJYT23073653949112,GB68IABX12043144453048,12/5/2019,19798.93,100001,Y,Personal Care,OPERA,POS,Dr,3:09:11,5:49:13,2/17/2021,44856199,1080.88,5,"Clear many fish. Total whom term total stage truth.
Dark ready challenge peace. Center top candidate product research pick amount history.",4:41:40,CARDS
QJYT23073653949112,GB68IABX12043144453048,12/5/2019,18718.05,100001,Y,Utilities,OPERA,MOBILE,Dr,6:28:47,10:07:17,2/17/2021,39762542,1080.88,4,"So ball if especially. Check along later first. All certainly response.
House movement fall interesting field.
Agree toward order simple yet must. Difficult manage trouble skill. Relate read give.",8:11:08,UPI
QJYT23073653949112,GB68IABX12043144453048,12/5/2019,17637.17,100001,Y,Insurance,EDGE,MOBILE,Dr,12:40:55,13:49:05,2/17/2021,4296157,1080.88,2,Memory program nice idea. Action give step accept measure choice high. Today try suddenly history north major fill.,13:10:38,IMPS
QJYT23073653949112,GB68IABX12043144453048,12/5/2019,18718.05,100001,N,Credited,IE,PC,Cr,16:57:11,18:11:37,2/17/2021,42152132,1080.88,1,"Establish group send minute agreement explain. Particular base cover young fish. Very find help create.
Find pull exist perform source actually. Author appear bit beat.",17:24:40,NEFT
QJYT23073653949112,GB68IABX12043144453048,12/5/2019,17637.17,100001,Y,Rent,CHROME,PC,Dr,23:05:55,25:06:49,2/17/2021,20697617,1080.88,4,"Wife this fish movie. First avoid great. Brother mother realize.
Keep discuss protect seek sort parent cold. Message maintain part.",23:58:27,UPI
QJYT23073653949112,GB68IABX12043144453048,12/5/2019,15897.07,100001,Y,Personal Care,FF,MOBILE,Dr,4:19:45,9:00:43,2/25/2021,35954996,1740.1,7,Executive fly receive citizen. Him sport moment become fly gas. Nature her drop society loss full.,6:04:29,DD
QJYT23073653949112,GB68IABX12043144453048,12/5/2019,17637.17,100001,N,Credited,FF,MOBILE,Cr,9:41:06,15:11:04,2/25/2021,9445987,1740.1,1,"Firm view memory but now create. Whose stand serve.
Two husband street itself.",12:37:39,NEFT
QJYT23073653949112,GB68IABX12043144453048,12/5/2019,19377.27,100001,N,Credited,MI,POS,Cr,18:05:38,22:56:41,2/25/2021,87630824,1740.1,6,Serve we local community field identify improve others. End note threat resource majority sing. Trip mouth finally manage still building attorney.,20:41:26,CHEQUE
QJYT23073653949112,GB68IABX12043144453048,12/5/2019,19794.09,100001,N,Credited,SAFARI,MOBILE,Cr,12:02:49,18:51:49,3/3/2021,83212581,416.82,2,"Collection impact language assume return. Manager per Mr member product win former. Nation site tell continue similar.
Hospital exactly too sit difference occur beat. Worry ok offer strategy kind.",15:45:49,IMPS
QJYT23073653949112,GB68IABX12043144453048,12/5/2019,20210.91,100001,N,Credited,FF,MOBILE,Cr,19:15:20,25:46:43,3/3/2021,66854609,416.82,2,"Turn happen letter across them anyone after station. Well real need occur mouth.
Beyond significant time human individual.",21:48:17,IMPS
QJYT23073653949112,GB68IABX12043144453048,12/5/2019,18906.19,100001,Y,Household Consumables,CHROME,MOBILE,Dr,6:38:58,11:48:57,3/16/2021,88621463,1304.72,7,"At practice stop movement. Home may perhaps save.
Resource move concern. Story certain smile push speech. Human former great discuss station fear bit. Weight ready room know.",9:07:23,DD
QJYT23073653949112,GB68IABX12043144453048,12/5/2019,20210.91,100001,N,Credited,IE,PC,Cr,15:58:26,17:59:56,3/16/2021,53735119,1304.72,2,"Star improve factor particular perform century. Together within player until home allow per voice.
Baby matter truth nor. Project learn rest case. Movie all effect low city away discover.",16:41:06,IMPS
QJYT23073653949112,GB68IABX12043144453048,12/5/2019,21515.63,100001,N,Credited,CHROME,PC,Cr,20:54:24,24:18:06,3/16/2021,31018449,1304.72,1,Theory exist type and add structure. Usually spend response difficult join themselves establish. Participant tell bed son.,22:17:07,NEFT
QJYT23073653949112,GB68IABX12043144453048,12/5/2019,19865.02,100001,Y,Online Shopping,OPERA,POS,Dr,6:46:50,11:38:57,3/18/2021,63063394,1650.61,4,"Sign fly candidate or professional student. Speak million right adult central recognize sit. Somebody toward film general analysis. Author that home example western field.
Force key after fall.",8:13:02,UPI
QJYT23073653949112,GB68IABX12043144453048,12/5/2019,21515.63,100001,N,Credited,IE,POS,Cr,20:09:21,22:56:13,3/18/2021,93981804,1650.61,2,Week task place reality well claim company. Nearly floor push security provide own man.,21:55:26,IMPS
QJYT23073653949112,GB68IABX12043144453048,12/5/2019,20324.64,100001,Y,Transportation,CHROME,MOBILE,Dr,3:43:12,8:22:05,3/21/2021,88580579,1190.99,4,"Decision against without region white glass find.
Practice writer but behind view very whatever. About of mean quite same sing.",6:34:27,UPI
QJYT23073653949112,GB68IABX12043144453048,12/5/2019,21515.63,100001,N,Credited,OPERA,MOBILE,Cr,14:30:53,16:46:57,3/21/2021,89325537,1190.99,2,"You Congress tree professional lawyer. You country garden.
State education or return discuss. Sit room manage form federal.
Mean share able other. All beyond morning always weight.",15:20:43,IMPS
QJYT23073653949112,GB68IABX12043144453048,12/5/2019,22706.62,100001,N,Credited,IE,PC,Cr,15:56:39,20:55:43,3/21/2021,533164,1190.99,4,"Teach knowledge behavior. Every early program knowledge foot. Unit manage address performance authority off always machine.
Bill within writer last. Risk stage able wife.",18:01:23,UPI
QJYT23073653949112,GB68IABX12043144453048,12/5/2019,23808.97,100001,N,Credited,OPERA,PC,Cr,11:26:45,17:36:12,3/27/2021,4653851,1102.35,4,Ready manager interesting. Today message until among number might go what. Well base peace community moment hotel again both. Rule measure where media draw.,13:45:14,UPI
QJYT23073653949112,GB68IABX12043144453048,12/5/2019,22706.62,100001,Y,Online Shopping,IE,MOBILE,Dr,18:28:02,25:40:10,3/27/2021,78494237,1102.35,4,"Beautiful us sell want air environment shoulder. Ability become office test assume admit. Avoid detail history morning address.
Part investment Mrs whose change ok back. Huge hotel voice both blood.",21:55:13,UPI
QJYT23073653949112,GB68IABX12043144453048,12/5/2019,24317.31,100001,N,Credited,MI,PC,Cr,8:20:53,11:58:46,4/12/2021,31210034,1610.69,2,"Staff real hotel close. Upon situation able view themselves.
Budget what ready mention. Pass democratic source pay including skill. System pass worker list reach interview.",11:10:03,IMPS
QJYT23073653949112,GB68IABX12043144453048,12/5/2019,22706.62,100001,Y,Online Shopping,SAFARI,PC,Dr,15:03:29,21:23:57,4/12/2021,23256040,1610.69,1,"Use anything second two body. By issue buy also mission myself government three. Act past capital nor.
Produce go again. Act direction else clearly walk draw physical institution.",17:26:16,NEFT
QJYT23073653949112,GB68IABX12043144453048,12/5/2019,22967.42,100001,N,Credited,FF,POS,Cr,11:53:13,18:29:21,4/19/2021,35058762,260.8,3,Employee board lead drop. Production capital large probably particularly question admit. All forget have in majority surface edge prepare. Far operation head turn budget paper discuss.,15:31:33,RTGS
QJYT23073653949112,GB68IABX12043144453048,12/5/2019,22461.03,100001,Y,Utilities,EDGE,POS,Dr,11:18:32,15:06:03,4/22/2021,53424518,506.39,1,Himself produce remain camera ten tonight. Keep yard a authority animal focus out. Foreign run occur conference defense. Us rule only position long five.,13:39:45,NEFT
QJYT23073653949112,GB68IABX12043144453048,12/5/2019,21954.64,100001,Y,Groceries,SAFARI,POS,Dr,13:17:33,18:58:26,4/22/2021,75503369,506.39,5,"Doctor husband do front task trade. Cold less left now also help seven.
Law current staff artist. Head piece this kid. Walk upon where energy agreement possible.",16:46:04,CARDS
QJYT23073653949112,GB68IABX12043144453048,12/5/2019,21384.08,100001,Y,Rent,EDGE,PC,Dr,10:40:10,15:22:08,4/29/2021,81663446,570.56,6,"Feeling imagine great might. Even both heavy develop just.
Benefit age rise parent message religious.
Evening environmental consumer study energy what several. Region I artist huge training life.",14:14:56,CHEQUE
QJYT23073653949112,GB68IABX12043144453048,12/5/2019,21954.64,100001,N,Credited,OPERA,POS,Cr,19:51:54,24:41:20,4/29/2021,61720695,570.56,7,"Another share people usually address. Continue get explain dog dinner I. Per million full wear. Position think determine particularly stand.
Item less fall anything hot who.",20:45:24,DD
QJYT23073653949112,GB68IABX12043144453048,12/5/2019,21641.61,100001,Y,Insurance,FF,PC,Dr,9:46:37,15:32:03,5/4/2021,98646111,313.03,3,Individual although market structure. Term suddenly near discussion. On particular will evidence. Can so manager to north order.,13:00:31,RTGS
QJYT23073653949112,GB68IABX12043144453048,12/5/2019,21328.58,100001,Y,Dining,IE,MOBILE,Dr,19:47:24,25:46:34,5/4/2021,30298507,313.03,7,"Ten ready describe. Break term sea this our according again.
Relationship require develop apply option space protect.",23:38:42,DD
QJYT23073653949112,GB68IABX12043144453048,12/5/2019,20373.08,100001,Y,Personal Care,FF,PC,Dr,5:00:59,6:30:52,5/9/2021,32463033,955.5,3,Color century child media officer interest raise. Tough financial part nature mention which great soon. Choice from position just think.,5:48:05,RTGS
QJYT23073653949112,GB68IABX12043144453048,12/5/2019,19417.58,100001,Y,Online Shopping,IE,POS,Dr,10:52:24,12:43:06,5/9/2021,77817600,955.5,4,"Clearly arm enough pick. Their miss reveal go of have. Program question for member.
Season be parent call effect voice. Yes gas site away performance.",11:20:57,UPI
QJYT23073653949112,GB68IABX12043144453048,12/5/2019,18462.08,100001,Y,Groceries,OPERA,POS,Dr,12:06:40,13:38:20,5/9/2021,26173306,955.5,3,"Continue along decision film low draw. Impact before food prevent focus without take.
Great anything wide crime issue talk color firm. Team street police professional.",12:38:59,RTGS
QJYT23073653949112,GB68IABX12043144453048,12/5/2019,17506.58,100001,Y,Medicals,MI,MOBILE,Dr,17:55:01,19:45:55,5/9/2021,76742576,955.5,3,"Score human group would about generation. Doctor particularly boy speech during fact.
Community lay now member face note remember. Response writer image catch. Meeting gas sometimes new.",18:35:23,RTGS
QJYT23073653949112,GB68IABX12043144453048,12/5/2019,18462.08,100001,N,Credited,SAFARI,PC,Cr,20:35:24,22:06:37,5/9/2021,57143125,955.5,2,"Their price national without almost begin glass. Series special population soldier.
Near on house condition. Should analysis name song. Song up worry product.",21:31:26,IMPS
QJYT23073653949112,GB68IABX12043144453048,12/5/2019,17352.32,100001,Y,Insurance,SAFARI,MOBILE,Dr,17:59:01,26:10:28,5/26/2021,38117084,1109.76,1,Visit future as value sing. Customer practice in couple day consumer election. True special activity.,22:53:28,NEFT
QJYT23073653949112,GB68IABX12043144453048,12/5/2019,15919.68,100001,Y,Household Consumables,OPERA,MOBILE,Dr,8:54:05,12:21:19,6/1/2021,2090047,1432.64,1,Because water cut team reduce. I black religious military four. Government anything task concern in chair music test. Deep its imagine decision open body beautiful.,11:10:01,NEFT
QJYT23073653949112,GB68IABX12043144453048,12/5/2019,14487.04,100001,Y,Groceries,EDGE,MOBILE,Dr,16:12:34,21:45:16,6/1/2021,43115402,1432.64,2,Behavior oil safe possible imagine before bed now. Great full though no interest development its actually. Skill officer key movement public. Case race she another.,18:49:37,IMPS
QJYT23073653949112,GB68IABX12043144453048,12/5/2019,13254.2,100001,Y,Utilities,OPERA,PC,Dr,5:48:49,10:59:38,6/2/2021,67560097,1232.84,1,"Might skin economy. Evidence hospital traditional ten.
Surface experience idea computer land. Send image of pull memory.",8:34:06,NEFT
QJYT23073653949112,GB68IABX12043144453048,12/5/2019,14487.04,100001,N,Credited,MI,MOBILE,Cr,10:42:56,13:21:51,6/2/2021,55524254,1232.84,6,"Only still open them any specific however. Possible others main believe own.
Teach then determine. Practice reflect government between adult need.",12:16:07,CHEQUE
QJYT23073653949112,GB68IABX12043144453048,12/5/2019,13254.2,100001,Y,Insurance,FF,PC,Dr,19:02:19,23:30:10,6/2/2021,64827254,1232.84,4,Middle act share happen laugh dream. Voice rich provide language national woman million. Least become former customer brother.,21:53:39,UPI
QJYT23073653949112,GB68IABX12043144453048,12/5/2019,12738.38,100001,Y,Household Consumables,OPERA,MOBILE,Dr,8:40:31,13:00:21,6/3/2021,50147540,515.82,5,Technology office often garden. Last three treat address agree standard organization. Decision religious capital feeling nation wait doctor.,10:53:32,CARDS
QJYT23073653949112,GB68IABX12043144453048,12/5/2019,12222.56,100001,Y,Entertainment,FF,PC,Dr,13:53:05,18:41:34,6/3/2021,4080633,515.82,7,"Admit produce hope character long. Eye sing suffer important.
Culture grow difficult decide leg must night force. Stock hold election buy rather so. Scientist avoid check produce catch.",16:29:03,DD
QJYT23073653949112,GB68IABX12043144453048,12/5/2019,11706.74,100001,Y,Online Shopping,EDGE,MOBILE,Dr,18:27:48,24:09:41,6/3/2021,84082879,515.82,7,"Way raise improve into summer. Process off manage lot.
Respond leader still themselves power movie. Think economic travel eight everybody. Front somebody get newspaper enough produce.",21:12:05,DD
QJYT23073653949112,GB68IABX12043144453048,12/5/2019,12976.53,100001,N,Credited,CHROME,POS,Cr,6:54:47,10:18:56,6/6/2021,24560405,1269.79,4,"Money dinner prove machine contain. Will many become bit positive.
Instead reduce probably when catch measure. Book this nothing day would score.",9:05:45,UPI
QJYT23073653949112,GB68IABX12043144453048,12/5/2019,11706.74,100001,Y,Household Consumables,EDGE,POS,Dr,9:50:26,13:29:14,6/6/2021,5363780,1269.79,2,"Cultural accept nothing blue business political south. Difficult south media cultural science player gas.
Summer must report international. Reduce whatever eat product throughout fly interest.",12:46:22,IMPS
QJYT23073653949112,GB68IABX12043144453048,12/5/2019,10436.95,100001,Y,Groceries,OPERA,POS,Dr,17:51:01,22:20:03,6/6/2021,50046744,1269.79,7,"Buy challenge again available above else nation. Gun activity hair three smile.
Soon gas material. Force image stand those trial possible environment.",20:47:34,DD
QJYT23073653949112,GB68IABX12043144453048,12/5/2019,10241.86,100001,Y,Rent,FF,PC,Dr,5:12:13,7:56:28,6/22/2021,60981608,195.09,7,"Town two front walk discover star. Artist need goal if.
Hundred social dream do must authority main. Girl throw win decade.
Hand state effort.",7:10:55,DD
QJYT23073653949112,GB68IABX12043144453048,12/5/2019,10436.95,100001,N,Credited,IE,POS,Cr,10:39:42,12:43:28,6/22/2021,97233336,195.09,5,"Seven any even will red detail. Center administration force hotel floor study.
Behind trouble police middle raise would. Night area hit else total across.",11:13:29,CARDS
QJYT23073653949112,GB68IABX12043144453048,12/5/2019,10241.86,100001,Y,Entertainment,SAFARI,POS,Dr,17:12:07,18:25:50,6/22/2021,27331002,195.09,2,"Response decade join away everyone suggest fine smile. Left place exist five ahead.
Wall full knowledge mean. Tell mouth marriage evidence talk add kitchen. Test five offer strong ready.",17:48:15,IMPS
QJYT23073653949112,GB68IABX12043144453048,12/5/2019,10436.95,100001,N,Credited,OPERA,PC,Cr,20:44:41,23:34:59,6/22/2021,71229492,195.09,3,Race catch dog big office while bank visit. Hot travel range life statement phone. Couple foreign stock night teach party reduce.,22:40:37,RTGS
QJYT23073653949112,GB68IABX12043144453048,12/5/2019,9601.63,100001,Y,Household Consumables,EDGE,MOBILE,Dr,4:45:42,7:02:00,6/28/2021,35588641,835.32,5,"Seat strong can color. Machine husband note hope outside record.
Certainly these model arm situation charge newspaper.",6:09:46,CARDS
QJYT23073653949112,GB68IABX12043144453048,12/5/2019,10436.95,100001,N,Credited,FF,MOBILE,Cr,11:27:23,14:39:20,6/28/2021,34329993,835.32,1,"Truth choice eat father new how. Leader sure remain assume travel. Her me president news nation.
Per why smile authority. Bit consumer daughter night seem he bank present. Least eye begin blue want.",12:12:22,NEFT
QJYT23073653949112,GB68IABX12043144453048,12/5/2019,9601.63,100001,Y,Groceries,EDGE,POS,Dr,18:26:12,21:53:01,6/28/2021,44204556,835.32,3,"Family might central probably think. From raise rich against conference alone.
Option product land tree sister. Able risk most news democratic expert imagine.",19:15:00,RTGS
QJYT23073653949112,GB68IABX12043144453048,12/5/2019,9740.97,100001,N,Credited,CHROME,PC,Cr,7:30:35,9:42:37,7/1/2021,49155013,139.34,4,What structure senior man. Investment situation vote rock us party. Almost produce board.,8:17:32,UPI
QJYT23073653949112,GB68IABX12043144453048,12/5/2019,9601.63,100001,Y,Entertainment,OPERA,PC,Dr,8:58:37,10:31:32,7/1/2021,14407680,139.34,1,"Image myself service evidence player tough economy. Crime data speak whom painting manage. Social environment chair state to.
Paper figure actually exactly. Summer born wrong may parent really.",9:45:35,NEFT
QJYT23073653949112,GB68IABX12043144453048,12/5/2019,9740.97,100001,N,Credited,OPERA,PC,Cr,15:01:51,16:49:19,7/1/2021,52105562,139.34,5,"Phone agent idea article throw. Husband professor just professional. Fine both school model long item.
Cold manager finish. Morning set defense current meet happy. Performance interest mother smile.",15:46:55,CARDS
QJYT23073653949112,GB68IABX12043144453048,12/5/2019,9601.63,100001,Y,Online Shopping,CHROME,POS,Dr,18:09:34,22:36:53,7/1/2021,74826513,139.34,3,"Establish government choice. Environment record activity choice able Mrs standard.
Make require garden street case. Top miss experience about. Increase pressure single pressure admit.",20:13:43,RTGS
QJYT23073653949112,GB68IABX12043144453048,12/5/2019,7810.2,100001,Y,Rent,CHROME,MOBILE,Dr,7:19:08,8:47:25,7/7/2021,55220156,1791.43,6,"Sing inside court wrong determine.
Next serious event listen. Second tonight weight add section.",7:59:52,CHEQUE
QJYT23073653949112,GB68IABX12043144453048,12/5/2019,9601.63,100001,N,Credited,FF,PC,Cr,11:14:52,15:16:10,7/7/2021,3872635,1791.43,5,"Herself information actually relationship. Support fast no sign moment capital stand.
Dream accept seem do. Financial three still change blue yet serious. Everything art another rest.",14:02:30,CARDS
QJYT23073653949112,GB68IABX12043144453048,12/5/2019,7810.2,100001,Y,Transportation,IE,PC,Dr,19:35:57,23:15:17,7/7/2021,6575403,1791.43,1,Yard deal page. Walk continue develop knowledge. Common instead music. Affect win pull anyone fish artist.,21:33:02,NEFT
QJYT23073653949112,GB68IABX12043144453048,12/5/2019,7619.21,100001,Y,Rent,FF,MOBILE,Dr,10:09:33,14:23:53,7/20/2021,26381657,190.99,2,Wonder low food decide light establish week. Voice main analysis.,11:37:27,IMPS
QJYT23073653949112,GB68IABX12043144453048,12/5/2019,7428.22,100001,Y,Household Consumables,EDGE,MOBILE,Dr,14:12:40,16:39:42,7/20/2021,63200577,190.99,7,"Out hope choice agree mention. Stay better land stand mind control.
Poor value build in agent above.
Until nation compare benefit red kind. Meeting change raise discussion save than.",15:40:16,DD
QJYT23073653949112,GB68IABX12043144453048,12/5/2019,7237.23,100001,Y,Dining,CHROME,MOBILE,Dr,19:46:40,22:21:50,7/20/2021,62359566,190.99,6,"One position strategy increase hit we tree clearly. Service each few popular prove police keep.
Determine plant maintain anyone hour base TV. Show inside participant simple.",21:13:18,CHEQUE
QJYT23073653949112,GB68IABX12043144453048,12/5/2019,8260.68,100001,N,Credited,IE,MOBILE,Cr,13:29:39,20:23:56,7/26/2021,58072219,1023.45,7,"History much occur hair spend campaign me. Without clearly power west.
Hear beyond environmental present. Power attention compare itself.
Manage instead sound thus employee. Side its peace.",14:53:29,DD
QJYT23073653949112,GB68IABX12043144453048,12/5/2019,7461.91,100001,Y,Dining,SAFARI,POS,Dr,6:31:36,8:30:16,7/30/2021,15353375,798.77,2,Exactly information together wish realize contain. Town example provide plant fly become. Worker water officer force finally.,7:44:06,IMPS
QJYT23073653949112,GB68IABX12043144453048,12/5/2019,6663.14,100001,Y,Dining,EDGE,MOBILE,Dr,9:11:13,10:47:48,7/30/2021,39963048,798.77,1,Community ok pretty leader but company. Town administration part create teacher size provide.,10:06:59,NEFT
QJYT23073653949112,GB68IABX12043144453048,12/5/2019,5864.37,100001,Y,Utilities,IE,MOBILE,Dr,13:08:53,17:16:15,7/30/2021,67136124,798.77,2,Turn that impact himself nice. Finally huge whole special finish institution. Education candidate need Congress sit poor performance.,15:05:13,IMPS
QJYT23073653949112,GB68IABX12043144453048,12/5/2019,6663.14,100001,N,Credited,MI,PC,Cr,21:10:15,23:55:53,7/30/2021,67451197,798.77,6,"Give list science. Place good pretty them later president.
Rate indeed media several activity lead. Seven food thank call yard be form dark.",21:49:18,CHEQUE
QJYT23073653949112,GB68IABX12043144453048,12/5/2019,6760.41,100001,N,Credited,CHROME,PC,Cr,6:45:17,9:23:04,8/6/2021,70641813,97.27,5,"Technology meeting goal rate three decide bit field. It notice can man maybe director.
One indicate boy wall lose serve.",7:57:06,CARDS
QJYT23073653949112,GB68IABX12043144453048,12/5/2019,6663.14,100001,Y,Online Shopping,IE,MOBILE,Dr,8:49:07,12:31:32,8/6/2021,56672008,97.27,2,"Grow may make newspaper place majority. First PM city let.
Raise eye dinner management small she again. Dinner continue site door range yard.",10:31:05,IMPS
QJYT23073653949112,GB68IABX12043144453048,12/5/2019,6565.87,100001,Y,Transportation,SAFARI,MOBILE,Dr,13:58:07,16:22:47,8/6/2021,59342403,97.27,7,Remember fear practice form most. Full war remain performance tax. Old according drive people capital hair win law.,15:18:00,DD
QJYT23073653949112,GB68IABX12043144453048,12/5/2019,6468.6,100001,Y,Groceries,OPERA,POS,Dr,19:28:04,22:27:10,8/6/2021,97405375,97.27,7,"Let others scientist learn important. Nation officer key dream week explain present. Sort pretty smile stop throughout.
Bag city late current see receive only. Save rather woman free.",21:42:22,DD
QJYT23073653949112,GB68IABX12043144453048,12/5/2019,5386.39,100001,Y,Dining,EDGE,MOBILE,Dr,5:38:26,9:18:00,8/20/2021,19161891,1082.21,5,"Worker can increase tree have support. Because above industry state with. Edge think meeting best decision apply.
Sound away day enjoy remember end go. Poor until history ball usually yet expert.",8:10:07,CARDS
QJYT23073653949112,GB68IABX12043144453048,12/5/2019,4304.18,100001,Y,Personal Care,FF,PC,Dr,15:04:57,18:20:33,8/20/2021,81595341,1082.21,6,Six kid with truth whole exactly. Almost local model rise animal. Education risk likely eye spring. Meet keep current test.,16:23:02,CHEQUE
QJYT23073653949112,GB68IABX12043144453048,12/5/2019,3221.97,100001,Y,Rent,FF,PC,Dr,19:45:23,22:51:17,8/20/2021,39066558,1082.21,1,"Example activity pressure Republican tree. Property television movement organization theory sure thus whose.
Impact walk special hundred much door involve.",21:51:27,NEFT
QJYT23073653949112,GB68IABX12043144453048,12/5/2019,3226.55,100001,N,Credited,SAFARI,POS,Cr,12:27:21,15:04:45,8/24/2021,30051331,4.58,1,Table star consider successful. Pattern tonight one compare.,13:57:30,NEFT
QJYT23073653949112,GB68IABX12043144453048,12/5/2019,3221.97,100001,Y,Transportation,OPERA,MOBILE,Dr,20:45:03,25:50:46,8/24/2021,47066915,4.58,4,"Boy remember nor education nothing method law. Model consumer lead drug why history treat eight. Arm physical financial voice.
Alone agent ask. Process executive others state. Plan energy church box.",23:47:30,UPI
QJYT23073653949112,GB68IABX12043144453048,12/5/2019,5041.8,100001,N,Credited,MI,MOBILE,Cr,16:44:39,25:15:41,8/28/2021,41108598,1819.83,5,"Wall trip ok. Which president any manager. Practice voice sea girl project response.
End provide than she. Film lay local travel certainly image camera.",20:18:10,CARDS
QJYT23073653949112,GB68IABX12043144453048,12/5/2019,6195.68,100001,N,Credited,FF,POS,Cr,4:16:10,6:16:59,8/31/2021,55592789,1153.88,4,"Around even result friend everybody information southern. Eye thought analysis nothing help happy by return.
Wind son return economic beautiful major. Build even risk increase.",5:05:56,UPI
QJYT23073653949112,GB68IABX12043144453048,12/5/2019,5041.8,100001,Y,Household Consumables,EDGE,MOBILE,Dr,10:16:30,12:53:54,8/31/2021,65957615,1153.88,3,Tv treatment avoid popular blood yeah not alone. Letter test call role black. Contain education detail country.,11:29:21,RTGS
QJYT23073653949112,GB68IABX12043144453048,12/5/2019,3887.92,100001,Y,Utilities,OPERA,MOBILE,Dr,13:59:17,16:49:16,8/31/2021,80975533,1153.88,7,"Rule when wait name candidate this. Stand wall send look upon plan memory could.
Your think suddenly feel. Event us type score individual executive. Trip toward affect point of rock.",14:55:38,DD
QJYT23073653949112,GB68IABX12043144453048,12/5/2019,2734.04,100001,Y,Personal Care,EDGE,PC,Dr,15:51:34,17:36:34,8/31/2021,26103907,1153.88,2,Dinner together account trial test ball pick. Would break able project effort course usually kitchen. Western attorney former upon production.,16:43:55,IMPS
QJYT23073653949112,GB68IABX12043144453048,12/5/2019,3887.92,100001,N,Credited,EDGE,POS,Cr,23:14:19,24:13:22,8/31/2021,84205599,1153.88,4,"Add exactly live read. Seven later yet.
Decide whether marriage common listen bad. We focus once.
Southern kitchen against control protect. During determine price author.",23:48:27,UPI
QJYT23073653949112,GB68IABX12043144453048,12/5/2019,5274.42,100001,N,Credited,MI,POS,Cr,4:23:31,7:19:16,9/9/2021,14979354,1386.5,5,"Dream will commercial rich three close thank. Opportunity admit hit.
In continue most even.",5:48:23,CARDS
QJYT23073653949112,GB68IABX12043144453048,12/5/2019,3887.92,100001,Y,Entertainment,CHROME,POS,Dr,9:19:29,11:10:19,9/9/2021,32373776,1386.5,1,Dinner environment against position reduce effort. Ability probably effort. Stage remain truth perform resource worry practice.,10:11:22,NEFT
QJYT23073653949112,GB68IABX12043144453048,12/5/2019,2501.42,100001,Y,Transportation,IE,MOBILE,Dr,11:31:47,14:44:13,9/9/2021,98887125,1386.5,2,"Ahead record safe six else among. Hospital court TV student hundred.
Later family test station under artist stand site. Mean within as bag financial.",12:55:31,IMPS
QJYT23073653949112,GB68IABX12043144453048,12/5/2019,3887.92,100001,N,Credited,CHROME,MOBILE,Cr,17:14:14,19:36:54,9/9/2021,43591831,1386.5,3,Not language sound without everybody. Day however college bar of without raise. Large staff both west cold never. Network want glass beautiful say myself.,18:16:34,RTGS
QJYT23073653949112,GB68IABX12043144453048,12/5/2019,2501.42,100001,Y,Dining,MI,PC,Dr,20:24:18,22:08:59,9/9/2021,2381152,1386.5,7,"Policy teach thought theory next fund same.
Return grow fast night lead once. Firm animal wife investment fast only training last. Tree cut center environment we.",21:14:05,DD
QJYT23073653949112,GB68IABX12043144453048,12/5/2019,3432.38,100001,N,Credited,EDGE,POS,Cr,3:58:30,7:21:32,9/16/2021,42918035,930.96,3,"Son beyond next behind common staff. Table threat tough others eye.
Evening white finally despite center. Marriage own animal father defense letter. Plan go expect benefit mouth education need trade.",6:30:55,RTGS
QJYT23073653949112,GB68IABX12043144453048,12/5/2019,4363.34,100001,N,Credited,IE,POS,Cr,13:33:27,17:16:35,9/16/2021,43049653,930.96,1,Threat able interesting travel whom loss. Cold table value family seem day. Best establish move ever join front.,14:23:55,NEFT
QJYT23073653949112,GB68IABX12043144453048,12/5/2019,5294.3,100001,N,Credited,OPERA,PC,Cr,20:46:21,23:20:26,9/16/2021,66879916,930.96,7,Difficult occur box year after century. Color seek benefit return take behavior business send. Agency wide between gun few hit. Energy spring might notice item why real.,22:09:50,DD
QJYT23073653949112,GB68IABX12043144453048,12/5/2019,5217.69,100001,Y,Entertainment,MI,MOBILE,Dr,9:30:05,15:15:47,9/18/2021,16195172,76.61,4,"Cut each politics inside risk American. Place edge necessary bit provide reason thank.
Good order Democrat candidate. Herself country finally. List star protect win more read.",13:10:19,UPI
QJYT23073653949112,GB68IABX12043144453048,12/5/2019,5141.08,100001,Y,Groceries,FF,PC,Dr,16:29:08,20:42:40,9/18/2021,14080616,76.61,7,Side world important understand. Including single everybody. Condition growth however modern assume.,19:30:55,DD
QJYT23073653949112,GB68IABX12043144453048,12/5/2019,5275.56,100001,N,Credited,CHROME,POS,Cr,6:06:19,9:29:41,9/23/2021,88327617,134.48,4,"Government get move begin bring job least. Television sound my imagine.
Offer away why former them. Discussion look open.
Middle relate more energy.
Price fine cost. Wrong common economy stand.",8:07:07,UPI
QJYT23073653949112,GB68IABX12043144453048,12/5/2019,5141.08,100001,Y,Insurance,CHROME,PC,Dr,11:49:20,13:09:22,9/23/2021,47722033,134.48,7,"Feel difference at lawyer idea stop over. Begin short culture room enough identify.
Eight study human away. Develop resource positive Congress at. Understand without happen necessary.",12:30:26,DD
QJYT23073653949112,GB68IABX12043144453048,12/5/2019,5275.56,100001,N,Credited,CHROME,PC,Cr,18:36:35,20:46:10,9/23/2021,76345081,134.48,1,"Bag high almost create do book. Office out generation. Win industry network hour expect.
Free receive industry. Return thousand think organization ahead western.
Charge your body remain no race.",19:08:09,NEFT
QJYT23073653949112,GB68IABX12043144453048,12/5/2019,5141.08,100001,Y,Groceries,FF,POS,Dr,21:55:52,23:43:12,9/23/2021,30836662,134.48,3,Practice only talk education theory clearly. Need page future whom song member occur. Season own stay enough to would leg.,22:47:22,RTGS
QJYT23073653949112,GB68IABX12043144453048,12/5/2019,5646.82,100001,N,Credited,SAFARI,MOBILE,Cr,12:50:53,17:11:47,9/25/2021,51014506,505.74,7,"Front agree practice move do prove.
Room edge end vote. Follow campaign some all ten none child listen.
Modern girl strong unit. Adult find sea box our.",15:37:19,DD
QJYT23073653949112,GB68IABX12043144453048,12/5/2019,6152.56,100001,N,Credited,CHROME,POS,Cr,17:00:06,23:42:12,9/25/2021,70972726,505.74,7,"Hospital method her energy finally. Indicate card to more theory scene. Group attack fall.
Source kind apply win debate design art. Society record body speak those. Eye and face pick.",20:21:15,DD
QJYT23073653949112,GB68IABX12043144453048,12/5/2019,8136.64,100001,N,Credited,CHROME,POS,Cr,5:59:52,8:07:22,9/27/2021,25499674,1984.08,3,Deep government safe. Program cover what person single ball set. Could mother send serve wide candidate whatever explain.,7:43:14,RTGS
QJYT23073653949112,GB68IABX12043144453048,12/5/2019,10120.72,100001,N,Credited,CHROME,PC,Cr,10:23:32,13:18:04,9/27/2021,52715914,1984.08,6,"Or before Democrat remain. Trip character information gas thousand some.
Whether attack step almost sing seem. Future third both mention. Unit rather movie guess game.",11:37:13,CHEQUE
QJYT23073653949112,GB68IABX12043144453048,12/5/2019,8136.64,100001,Y,Groceries,FF,PC,Dr,13:20:41,16:36:45,9/27/2021,49025668,1984.08,3,"Hear decision writer information simple investment. Even statement vote six.
At become maybe soldier up draw. Song among not foreign name like easy. Meet house goal smile certainly exactly involve.",14:49:41,RTGS
QJYT23073653949112,GB68IABX12043144453048,12/5/2019,6152.56,100001,Y,Personal Care,OPERA,MOBILE,Dr,17:28:26,19:56:55,9/27/2021,92719255,1984.08,4,"Produce without between member need certainly. Inside city kind increase claim.
Myself here above power. Car training computer dream beautiful.
Quite see worry though break card business price.",18:13:25,UPI
QJYT23073653949112,GB68IABX12043144453048,12/5/2019,4168.48,100001,Y,Online Shopping,OPERA,PC,Dr,21:22:21,24:05:34,9/27/2021,71270852,1984.08,1,"Especially remain home hard from receive final. Room direction memory. Star mean network near character capital may.
On year site interesting.",22:39:14,NEFT
QJYT23073653949112,GB68IABX12043144453048,12/5/2019,2472.91,100001,Y,Rent,MI,PC,Dr,4:21:16,7:12:03,9/28/2021,85783188,1695.57,2,And newspaper out free around night food. Fine single wall report discussion. Staff impact possible recent often charge.,6:01:45,IMPS
QJYT23073653949112,GB68IABX12043144453048,12/5/2019,4168.48,100001,N,Credited,SAFARI,POS,Cr,9:57:33,13:40:15,9/28/2021,95219455,1695.57,4,"Month growth exist general lose policy building. Man seven draw thank ahead air page in.
Various data main environmental team far. Church author the difficult expert.
Food happy consumer walk report.",12:13:12,UPI
QJYT23073653949112,GB68IABX12043144453048,12/5/2019,2472.91,100001,Y,Transportation,MI,MOBILE,Dr,14:54:41,18:16:22,9/28/2021,95071640,1695.57,2,Big black whom follow message than difficult perform. Region contain current radio sound letter believe.,17:13:02,IMPS
QJYT23073653949112,GB68IABX12043144453048,12/5/2019,777.34,100001,Y,Entertainment,MI,PC,Dr,19:58:30,23:14:31,9/28/2021,9149687,1695.57,5,"Win cost yeah oil bag environment process my. Nation ask lay.
Car think factor fly billion morning computer investment. Difficult movie lead example popular plan.
Draw money memory three care.",21:52:59,CARDS
QJYT23073653949112,GB68IABX12043144453048,12/5/2019,2522.96,100001,N,Credited,OPERA,PC,Cr,5:13:33,12:07:07,9/30/2021,84654793,1745.62,4,"Impact network sit become buy. Government drug head which situation between.
Get old nature price. Two employee major back movie. Own condition give area.",8:17:45,UPI
QJYT23073653949112,GB68IABX12043144453048,12/5/2019,4268.58,100001,N,Credited,FF,PC,Cr,13:00:04,17:10:03,9/30/2021,75903473,1745.62,3,"Owner by right food couple cause. Nature gun future quite find. Hour war authority human.
Hand such live small business agree word reason.",16:15:21,RTGS
QJYT23073653949112,GB68IABX12043144453048,12/5/2019,4499.77,100001,N,Credited,MI,POS,Cr,4:07:40,6:43:40,10/1/2021,41352526,231.19,7,"Cover challenge first coach direction almost. Charge time skill as often else.
Leave night feeling dream tough memory interesting. We whole office issue hot history.",5:45:36,DD
QJYT23073653949112,GB68IABX12043144453048,12/5/2019,4730.96,100001,N,Credited,OPERA,MOBILE,Cr,11:13:29,13:51:54,10/1/2021,91665928,231.19,1,"Window run summer audience learn take set. His prevent state line size gas.
Operation account section old trip election. Else officer message ok.",12:29:44,NEFT
QJYT23073653949112,GB68IABX12043144453048,12/5/2019,4962.15,100001,N,Credited,CHROME,MOBILE,Cr,17:26:16,20:51:31,10/1/2021,85028678,231.19,5,"Meeting admit impact reality letter staff. Dog positive generation indeed model American. This law he writer.
Imagine stay test hundred product data. According drug effect wear analysis our space.",18:40:56,CARDS
QJYT23073653949112,GB68IABX12043144453048,12/5/2019,5193.34,100001,N,Credited,CHROME,PC,Cr,21:30:09,25:41:38,10/1/2021,29806492,231.19,1,"Ten color between peace account civil billion miss. Already trial increase small sort by.
Skill present focus institution family. Democrat population shoulder really compare listen report they.",23:29:26,NEFT
QJYT23073653949112,GB68IABX12043144453048,12/5/2019,5914.57,100001,N,Credited,FF,POS,Cr,4:14:35,7:14:06,10/10/2021,18733730,721.23,5,Leg education record gun work teach. Member message season get experience south. Image structure much understand.,6:15:38,CARDS
QJYT23073653949112,GB68IABX12043144453048,12/5/2019,5193.34,100001,Y,Household Consumables,OPERA,MOBILE,Dr,15:47:28,18:39:40,10/10/2021,16026407,721.23,7,My experience side over power pattern deal. News across attorney cut beautiful. Near official bring over choose capital.,16:49:21,DD
QJYT23073653949112,GB68IABX12043144453048,12/5/2019,5914.57,100001,N,Credited,OPERA,PC,Cr,17:50:30,22:41:41,10/10/2021,17885171,721.23,2,Try pattern professional long perhaps. Everything ever accept. Happy soon our when performance draw rise.,20:22:39,IMPS
DCTX14808940860840,GB94WWYR43460145320993,1/28/2015,930.72,100001,N,Credited,OPERA,PC,Cr,19:34:08,26:24:38,1/8/2016,77410344,645.52,6,"Off bad table threat community and there. Individual him ball chance likely.
Middle positive admit sure officer. Indicate impact build window meeting room.",21:07:08,CHEQUE
DCTX14808940860840,GB94WWYR43460145320993,1/28/2015,2519.77,100001,N,Credited,MI,PC,Cr,17:27:55,19:31:20,1/17/2016,67484515,1589.05,2,"Five ever whose well difference image.
Production avoid appear recently color state. Against walk once green relationship wind treatment walk. Professional everyone movement town.",18:22:28,IMPS
DCTX14808940860840,GB94WWYR43460145320993,1/28/2015,930.72,100001,Y,Groceries,CHROME,MOBILE,Dr,20:07:35,23:02:01,1/17/2016,87549683,1589.05,3,"Wife imagine politics why a during always read. Tend bank wear this fine treat country. Hour win cup significant position safe.
Enter program give cut. Myself agency position raise.",21:27:38,RTGS
DCTX14808940860840,GB94WWYR43460145320993,1/28/2015,2243.88,100001,N,Credited,OPERA,MOBILE,Cr,18:38:30,27:46:15,1/19/2016,7858697,1313.16,6,"Year power know address life. Commercial artist agency how. Young notice wind personal more return son staff.
Not you perhaps throw study why effort. Many home she Mrs travel.",23:43:20,CHEQUE
DCTX14808940860840,GB94WWYR43460145320993,1/28/2015,981.08,100001,Y,Transportation,SAFARI,MOBILE,Dr,5:34:39,8:09:08,1/22/2016,82895648,1262.8,4,Side board food knowledge. Field necessary marriage exactly candidate maintain.,6:16:20,UPI
DCTX14808940860840,GB94WWYR43460145320993,1/28/2015,2243.88,100001,N,Credited,CHROME,PC,Cr,11:36:04,17:03:37,1/22/2016,50302161,1262.8,6,During usually dream natural. Network behind under sport market collection step anyone. Me space kind strategy key finish account film.,14:19:00,CHEQUE
DCTX14808940860840,GB94WWYR43460145320993,1/28/2015,3506.68,100001,N,Credited,EDGE,PC,Cr,16:17:09,19:07:48,1/22/2016,20903602,1262.8,4,"Painting condition offer bring box international. Decide smile man drive. Only feeling how room firm.
Eight senior how without try. Type about plan in debate watch else.",18:29:02,UPI
DCTX14808940860840,GB94WWYR43460145320993,1/28/2015,2731.9,100001,Y,Personal Care,CHROME,MOBILE,Dr,8:31:21,15:22:39,1/23/2016,72912829,774.78,2,"Moment line position culture certainly play. Analysis court want go together.
Society law I area floor interesting. Structure four even speak simply pick. Democratic range sport fine along four.",11:34:42,IMPS
DCTX14808940860840,GB94WWYR43460145320993,1/28/2015,3506.68,100001,N,Credited,OPERA,POS,Cr,20:31:19,23:48:24,1/23/2016,305952,774.78,7,"Ok common quality responsibility man stop want why.
Forward wall require establish likely wall as whom. Pm Republican wife fund. Live leg become between central station technology.",21:56:37,DD
DCTX14808940860840,GB94WWYR43460145320993,1/28/2015,3533.77,100001,N,Credited,SAFARI,POS,Cr,4:05:26,6:59:31,2/10/2016,51256012,27.09,4,Standard not nice picture beat have everything. Officer try partner open else decade stay. Describe star action since word almost.,5:48:51,UPI
DCTX14808940860840,GB94WWYR43460145320993,1/28/2015,3506.68,100001,Y,Household Consumables,FF,POS,Dr,9:05:59,11:50:39,2/10/2016,42813156,27.09,3,Your available partner simple wall. Agreement offer president decide ago activity deal. Collection western ten oil real price.,9:56:05,RTGS
DCTX14808940860840,GB94WWYR43460145320993,1/28/2015,3533.77,100001,N,Credited,IE,POS,Cr,11:24:15,13:17:18,2/10/2016,92180680,27.09,3,"Big remain shoulder best. Maintain travel sea herself choice.
Relate I can market. Kitchen soldier person same a.
Me allow heavy draw. Drop weight add imagine truth serious.",12:27:09,RTGS
DCTX14808940860840,GB94WWYR43460145320993,1/28/2015,3506.68,100001,Y,Online Shopping,OPERA,MOBILE,Dr,14:51:45,18:20:00,2/10/2016,70504255,27.09,2,Task according television less. Management technology have up executive pattern without according. Area experience skin look.,16:47:04,IMPS
DCTX14808940860840,GB94WWYR43460145320993,1/28/2015,3479.59,100001,Y,Household Consumables,EDGE,POS,Dr,20:36:31,24:05:17,2/10/2016,89726884,27.09,1,Them green threat feel goal natural shoulder. Commercial style throw method. Lose event suggest different.,22:10:17,NEFT
DCTX14808940860840,GB94WWYR43460145320993,1/28/2015,4852.81,100001,N,Credited,MI,MOBILE,Cr,3:08:21,6:58:38,2/12/2016,3143247,1373.22,7,"Director start you party network sea.
Trial get music. Action main particularly at according. Position bed effort dream network plant.",5:02:30,DD
DCTX14808940860840,GB94WWYR43460145320993,1/28/2015,3479.59,100001,Y,Utilities,IE,POS,Dr,11:07:47,12:41:06,2/12/2016,60260345,1373.22,3,Seem section appear traditional could. Much must election gun wall. Finish that exactly quite president. Floor full week time institution board.,11:58:08,RTGS
DCTX14808940860840,GB94WWYR43460145320993,1/28/2015,4852.81,100001,N,Credited,FF,PC,Cr,13:33:41,17:07:08,2/12/2016,66194033,1373.22,6,"Protect not management position speech many spend. Even life particularly room.
Task cover land team identify become after structure. Cold reach deal.",15:28:59,CHEQUE
DCTX14808940860840,GB94WWYR43460145320993,1/28/2015,6226.03,100001,N,Credited,FF,MOBILE,Cr,14:25:13,16:34:34,2/12/2016,95427874,1373.22,2,"Cut enter war event. Behind off TV work above. Film civil return certainly those.
Personal girl wall growth whole product. Player movie camera sing. Model available catch reflect human drug.",16:04:19,IMPS
DCTX14808940860840,GB94WWYR43460145320993,1/28/2015,4852.81,100001,Y,Household Consumables,OPERA,POS,Dr,20:37:49,21:57:57,2/12/2016,25172775,1373.22,6,"Young ask discussion thank per. Outside guy sure.
Again issue project commercial. Area most base thank sister miss. Attention study one.",21:29:56,CHEQUE
DCTX14808940860840,GB94WWYR43460145320993,1/28/2015,5121.93,100001,N,Credited,OPERA,PC,Cr,10:09:07,16:40:49,2/24/2016,59236863,269.12,1,List number generation site late cultural real. Participant response always whom dark shoulder quite.,14:07:25,NEFT
DCTX14808940860840,GB94WWYR43460145320993,1/28/2015,4852.81,100001,Y,Dining,MI,MOBILE,Dr,20:51:32,25:57:20,2/24/2016,46470942,269.12,2,"Kid choice decade set either situation. Board leg long. Ever message against plant less also base.
Road resource next up. Close charge need sign choose. Several career impact ago guess test.",22:02:31,IMPS
DCTX14808940860840,GB94WWYR43460145320993,1/28/2015,2894.98,100001,Y,Utilities,SAFARI,POS,Dr,5:52:06,9:05:21,3/8/2016,12434213,1957.83,7,Point must power hair stand force field. End teach building quite. Public appear message ten quality.,7:58:12,DD
DCTX14808940860840,GB94WWYR43460145320993,1/28/2015,937.15,100001,Y,Personal Care,OPERA,PC,Dr,8:45:52,12:56:57,3/8/2016,84866189,1957.83,3,Hope medical draw capital foreign blue. Develop form hair person true production right local. Serious strong society challenge although that production. Where process person top.,10:38:12,RTGS
DCTX14808940860840,GB94WWYR43460145320993,1/28/2015,2894.98,100001,N,Credited,EDGE,MOBILE,Cr,16:48:17,18:43:03,3/8/2016,76591815,1957.83,2,"Audience structure out begin. Land development yourself buy activity.
Want note oil low. Fish prepare fund through four prove.
Speech there short possible situation business. Right energy three.",17:42:48,IMPS
DCTX14808940860840,GB94WWYR43460145320993,1/28/2015,937.15,100001,Y,Transportation,IE,MOBILE,Dr,19:34:53,21:03:58,3/8/2016,16555426,1957.83,7,"Star try measure fight. Than people ball customer or thing.
No old pretty everyone learn prove. Right miss room edge six.",20:17:42,DD
DCTX14808940860840,GB94WWYR43460145320993,1/28/2015,1556.21,100001,N,Credited,MI,PC,Cr,8:01:04,11:02:23,3/16/2016,77978738,619.06,1,"Mission fight really soon. Wait that discuss site.
Travel growth our.",10:09:12,NEFT
DCTX14808940860840,GB94WWYR43460145320993,1/28/2015,2175.27,100001,N,Credited,SAFARI,MOBILE,Cr,16:36:07,20:58:02,3/16/2016,16993440,619.06,2,"Firm best language night capital themselves stop. Situation drop senior foreign spend western near.
Tend hope citizen Mrs film often. Others third section different TV challenge strategy.",17:44:44,IMPS
DCTX14808940860840,GB94WWYR43460145320993,1/28/2015,2256.42,100001,N,Credited,OPERA,MOBILE,Cr,5:21:46,10:37:51,3/24/2016,47711518,81.15,6,"There later east language trade argue stay.
Degree under institution interest case draw attention. Affect admit stage blue push stock room. Under foot lot six shoulder paper summer.",8:02:07,CHEQUE
DCTX14808940860840,GB94WWYR43460145320993,1/28/2015,2175.27,100001,Y,Utilities,IE,POS,Dr,16:16:31,18:38:14,3/24/2016,20276263,81.15,5,"Blood leave risk actually two reduce now.
Social arrive page. Beyond true blood bad.
Arm along lot. Here stuff near indicate exactly project worry. Ever condition garden itself land us.",17:52:01,CARDS
DCTX14808940860840,GB94WWYR43460145320993,1/28/2015,2256.42,100001,N,Credited,EDGE,PC,Cr,16:17:25,20:04:17,3/24/2016,99172,81.15,3,Fish window local father probably thousand most. Yourself life organization including carry probably still. Create gun treat southern.,18:01:02,RTGS
DCTX14808940860840,GB94WWYR43460145320993,1/28/2015,3233,100001,N,Credited,IE,MOBILE,Cr,3:29:06,5:31:46,4/1/2016,28566540,976.58,3,History writer back production meet. Thing remember evening probably teach answer positive pick. Town reason have use.,4:43:55,RTGS
DCTX14808940860840,GB94WWYR43460145320993,1/28/2015,2256.42,100001,Y,Groceries,SAFARI,PC,Dr,9:08:54,11:26:05,4/1/2016,92815315,976.58,7,"Employee paper lay. Song happy race force word hear clear. Onto such campaign answer green.
Evening finally what. Reduce reason team customer better peace. Fact Mr result he brother.",9:47:29,DD
DCTX14808940860840,GB94WWYR43460145320993,1/28/2015,3233,100001,N,Credited,IE,POS,Cr,11:54:39,14:20:17,4/1/2016,67368730,976.58,2,"Rich her professor upon. You onto young particular reach serve. Leg attorney control his let.
Wish vote item address upon step young. Stand include truth evening toward wear.",13:24:31,IMPS
DCTX14808940860840,GB94WWYR43460145320993,1/28/2015,2256.42,100001,Y,Groceries,MI,MOBILE,Dr,17:56:54,19:19:49,4/1/2016,11786757,976.58,2,"War assume guy drug machine.
Coach same time account. Study force only difference think music.",18:23:22,IMPS
DCTX14808940860840,GB94WWYR43460145320993,1/28/2015,3233,100001,N,Credited,FF,POS,Cr,18:01:56,21:19:04,4/1/2016,27298992,976.58,2,Level family participant send reason animal. Single build customer at floor later. Move each thought then generation attention.,20:00:38,IMPS
DCTX14808940860840,GB94WWYR43460145320993,1/28/2015,2525.17,100001,Y,Personal Care,SAFARI,PC,Dr,3:08:30,6:02:30,4/4/2016,18561609,707.83,3,"Whatever nor require career sign fine. Career under feel individual least.
Whose card perhaps as free factor family remain. Here dark data the. Bad central source who.",4:55:52,RTGS
DCTX14808940860840,GB94WWYR43460145320993,1/28/2015,3233,100001,N,Credited,MI,MOBILE,Cr,13:04:21,14:39:12,4/4/2016,29995233,707.83,3,"Drop car throughout executive should fear piece. Include your help pay various month town. Yourself relate yes third.
Significant thousand officer nearly. Dinner politics politics.",13:35:47,RTGS
DCTX14808940860840,GB94WWYR43460145320993,1/28/2015,3940.83,100001,N,Credited,EDGE,PC,Cr,14:05:29,16:44:06,4/4/2016,34241424,707.83,2,"Without above idea.
Finish fill state open. Notice number statement traditional if bar game.
Image include these cause. Choice structure anything whose provide. Source inside rich easy.",15:34:49,IMPS
DCTX14808940860840,GB94WWYR43460145320993,1/28/2015,3233,100001,Y,Medicals,SAFARI,POS,Dr,20:58:08,24:12:09,4/4/2016,51046187,707.83,3,Gas south key cup. Our trial pull you mother. Not different him cost article.,22:41:38,RTGS
DCTX14808940860840,GB94WWYR43460145320993,1/28/2015,3037.8,100001,Y,Utilities,FF,MOBILE,Dr,8:42:37,12:30:15,4/15/2016,51140427,195.2,4,"Since thousand power thing state way.
Police guy first author. Light town however particularly issue hot.
Visit new grow recently past war. Region again present. Ground figure free than.",10:05:50,UPI
DCTX14808940860840,GB94WWYR43460145320993,1/28/2015,2842.6,100001,Y,Medicals,IE,POS,Dr,13:30:42,16:57:52,4/15/2016,49695212,195.2,6,"Save point hotel benefit detail front hear. Too sound class treatment help weight thing under.
Phone different choose service. Life deal significant such.",16:00:26,CHEQUE
DCTX14808940860840,GB94WWYR43460145320993,1/28/2015,2338.6,100001,Y,Utilities,OPERA,PC,Dr,9:59:30,15:52:28,4/18/2016,64460222,504,3,"But minute yourself within.
High save important could. Hope figure television similar better threat.
Ever respond student five contain but. How professional move. Hair difference newspaper career.",13:13:29,RTGS
DCTX14808940860840,GB94WWYR43460145320993,1/28/2015,1834.6,100001,Y,Medicals,EDGE,PC,Dr,17:42:29,23:07:23,4/18/2016,35481454,504,3,Matter consider firm Mr prevent interview writer bring. Discussion arrive range explain only list.,20:56:16,RTGS
DCTX14808940860840,GB94WWYR43460145320993,1/28/2015,582.91,100001,Y,Insurance,OPERA,MOBILE,Dr,7:36:53,11:21:54,4/19/2016,41197516,1251.69,1,Save special car. Senior concern understand child company. Both wife tend appear.,10:35:58,NEFT
DCTX14808940860840,GB94WWYR43460145320993,1/28/2015,1834.6,100001,N,Credited,MI,POS,Cr,16:39:17,21:20:56,4/19/2016,46457974,1251.69,1,"Old suggest recent claim four. Employee mother society.
Fish sea outside deep. Move region human. Hold forget nice hope. Husband also business world.",18:51:54,NEFT
DCTX14808940860840,GB94WWYR43460145320993,1/28/2015,692.02,100001,Y,Rent,OPERA,MOBILE,Dr,6:23:44,9:08:10,4/23/2016,98471676,1142.58,2,"Art win each day bad war network. Television training east happen behavior.
Who manager assume no nation. Body sort or government hold like next.",8:38:21,IMPS
DCTX14808940860840,GB94WWYR43460145320993,1/28/2015,1073.24,100001,N,Credited,CHROME,POS,Cr,9:48:36,14:27:50,4/28/2016,74991143,381.22,4,"Day whom administration resource new blue usually. Author suffer decide employee.
Drug professor kind science. Until appear far to fall.",11:32:40,UPI
DCTX14808940860840,GB94WWYR43460145320993,1/28/2015,692.02,100001,Y,Insurance,EDGE,MOBILE,Dr,13:43:59,18:08:07,4/28/2016,41454510,381.22,1,Finish garden success everybody doctor. Matter research time. Everything test reason including. Meet hot interesting energy involve ever accept.,15:13:17,NEFT
DCTX14808940860840,GB94WWYR43460145320993,1/28/2015,310.8,100001,Y,Groceries,FF,PC,Dr,22:18:06,25:41:41,4/28/2016,66351832,381.22,4,"Difficult for require strategy blue happen. Reflect think question not everybody more.
Record source eye affect policy activity. Community south both. Account until too relate detail.",23:54:32,UPI
DCTX14808940860840,GB94WWYR43460145320993,1/28/2015,58.41,100001,Y,Personal Care,IE,POS,Dr,5:20:53,10:14:34,4/29/2016,32093841,252.39,6,"Region enough rise whose consider same to. Analysis pressure compare yard. Chance step watch peace eye the.
Wind likely third everyone writer least.",8:59:52,CHEQUE
DCTX14808940860840,GB94WWYR43460145320993,1/28/2015,1414.51,100001,N,Credited,OPERA,POS,Cr,6:29:40,10:18:28,5/25/2016,96582817,1356.1,1,Third read skin name. Individual challenge society remember worry hot face. Thus speech worker financial.,8:20:48,NEFT
DCTX14808940860840,GB94WWYR43460145320993,1/28/2015,58.41,100001,Y,Rent,IE,POS,Dr,17:07:54,22:09:01,5/25/2016,30908406,1356.1,1,Job middle thousand right safe performance step. Get give tonight someone person during phone approach. Opportunity peace experience war effort where.,20:55:14,NEFT
DCTX14808940860840,GB94WWYR43460145320993,1/28/2015,825.21,100001,N,Credited,IE,MOBILE,Cr,5:16:32,8:29:43,6/7/2016,51934446,766.8,6,Parent dream security miss success surface. Chance single company city official direction cause. Also decision personal history international environmental language study.,6:41:50,CHEQUE
DCTX14808940860840,GB94WWYR43460145320993,1/28/2015,58.41,100001,Y,Household Consumables,CHROME,POS,Dr,9:39:51,12:58:22,6/7/2016,59829379,766.8,6,"Feeling the chance his threat feel. Land full share reveal opportunity kind. Knowledge increase fish along.
Doctor ok whether us program. Sign require recent worker resource movie behavior.",11:15:08,CHEQUE
DCTX14808940860840,GB94WWYR43460145320993,1/28/2015,825.21,100001,N,Credited,MI,POS,Cr,18:42:59,22:57:35,6/7/2016,2285320,766.8,4,Difference perform wear some lawyer reduce. Financial evening election specific record really. Require information chance item accept serve what forward.,20:35:30,UPI
DCTX14808940860840,GB94WWYR43460145320993,1/28/2015,468.15,100001,Y,Entertainment,OPERA,POS,Dr,4:30:05,5:48:42,6/10/2016,60301543,357.06,6,"East large first every threat increase family. Statement father occur fast. To run official keep huge.
Lay against happy. Next include church available certain quickly necessary.",5:01:37,CHEQUE
DCTX14808940860840,GB94WWYR43460145320993,1/28/2015,825.21,100001,N,Credited,IE,POS,Cr,8:27:33,10:24:38,6/10/2016,93262682,357.06,5,"Already trial discover four feeling always movie soldier. Record husband so explain and between why.
Picture protect mouth. Save necessary control heart.",9:23:14,CARDS
DCTX14808940860840,GB94WWYR43460145320993,1/28/2015,468.15,100001,Y,Online Shopping,EDGE,MOBILE,Dr,11:06:10,12:55:33,6/10/2016,1044096,357.06,5,"Charge role owner maintain now movie certain. Finally word agent child.
Sign happen rock thank reveal quality. Popular tend great sense seat shake. Small turn nature any.",12:09:57,CARDS
DCTX14808940860840,GB94WWYR43460145320993,1/28/2015,111.09,100001,Y,Medicals,MI,PC,Dr,16:03:59,18:46:58,6/10/2016,91624673,357.06,7,"Financial across answer ask. Myself effect carry show economy not these from. She PM cell only charge yeah range.
Including yourself cause article of member. The style summer success south look live.",17:53:07,DD
DCTX14808940860840,GB94WWYR43460145320993,1/28/2015,468.15,100001,N,Credited,MI,POS,Cr,20:09:30,21:57:40,6/10/2016,57298436,357.06,2,Good hour draw ask provide economy. Let main successful these science your sure.,20:48:59,IMPS
DCTX14808940860840,GB94WWYR43460145320993,1/28/2015,472,100001,N,Credited,CHROME,MOBILE,Cr,6:43:40,10:07:38,6/16/2016,94179842,3.85,1,"Happy write agree employee store. Off record bad still.
Recognize drop film card list page. Finally wait we big serious media. Ok arrive city this.
Matter happen occur case price.",8:26:07,NEFT
DCTX14808940860840,GB94WWYR43460145320993,1/28/2015,475.85,100001,N,Credited,CHROME,PC,Cr,11:27:35,14:56:25,6/16/2016,66333210,3.85,7,Perhaps push low attention though manager reach. Before international health dream power.,13:12:13,DD
DCTX14808940860840,GB94WWYR43460145320993,1/28/2015,472,100001,Y,Groceries,CHROME,PC,Dr,16:08:41,20:28:13,6/16/2016,69245336,3.85,2,Answer indicate traditional trial development later carry need. Day environmental since compare teach design. Admit radio own race.,18:24:46,IMPS
DCTX14808940860840,GB94WWYR43460145320993,1/28/2015,468.15,100001,Y,Personal Care,SAFARI,PC,Dr,19:42:59,22:35:11,6/16/2016,57684314,3.85,6,"Thought Mrs score off.
Inside process start want.
Agency PM might television hope per. Floor issue decision these. Leader note approach day could technology.",21:23:10,CHEQUE
DCTX14808940860840,GB94WWYR43460145320993,1/28/2015,1360.59,100001,N,Credited,IE,POS,Cr,6:29:40,9:53:41,6/20/2016,52259142,892.44,7,"Company professional fast professor. Difficult team pretty different.
Affect always hope enjoy treatment common dinner.
Drug wrong why magazine coach chair enough. Congress how risk nor issue.",8:14:10,DD
DCTX14808940860840,GB94WWYR43460145320993,1/28/2015,468.15,100001,Y,Household Consumables,EDGE,PC,Dr,8:49:47,11:19:07,6/20/2016,76040382,892.44,1,"Party budget player share compare huge structure. Involve agency top doctor.
Notice order end power. Impact present how development son front. Measure law discuss member.",10:44:24,NEFT
DCTX14808940860840,GB94WWYR43460145320993,1/28/2015,1595.67,100001,N,Credited,SAFARI,MOBILE,Cr,17:36:33,20:49:47,6/28/2016,70197686,1127.52,6,"Crime change development defense. Attorney court commercial source better somebody.
Religious involve now likely. Upon while real. Rise agreement citizen result particularly art.",18:56:26,CHEQUE
DCTX14808940860840,GB94WWYR43460145320993,1/28/2015,2925.27,100001,N,Credited,CHROME,PC,Cr,6:27:09,8:46:12,7/11/2016,96083253,1329.6,5,"Capital authority within. Pay number whole get. Risk add write not one.
Memory director majority up strategy move evening. Along remain street table since put.",7:23:32,CARDS
DCTX14808940860840,GB94WWYR43460145320993,1/28/2015,1595.67,100001,Y,Personal Care,CHROME,MOBILE,Dr,8:58:00,12:07:39,7/11/2016,20022976,1329.6,1,Certain ground environment role early wrong box. Really Mrs positive budget mention. Give specific choice.,10:12:57,NEFT
DCTX14808940860840,GB94WWYR43460145320993,1/28/2015,266.07,100001,Y,Household Consumables,SAFARI,PC,Dr,13:34:41,15:43:36,7/11/2016,89385258,1329.6,2,"Stock other vote tree. Late upon table social. Office open hotel how.
Level despite camera economy.",15:17:24,IMPS
DCTX14808940860840,GB94WWYR43460145320993,1/28/2015,1595.67,100001,N,Credited,FF,MOBILE,Cr,14:23:35,17:52:28,7/11/2016,21624773,1329.6,6,Keep own both from PM Mrs themselves. Official although morning step strong effort be. Animal reflect see east tend out glass.,16:22:43,CHEQUE
DCTX14808940860840,GB94WWYR43460145320993,1/28/2015,266.07,100001,Y,Insurance,FF,MOBILE,Dr,20:04:27,22:32:04,7/11/2016,91706805,1329.6,1,"Force lawyer yard kind.
Social study threat story. Of minute consumer.",22:00:00,NEFT
DCTX14808940860840,GB94WWYR43460145320993,1/28/2015,1374.44,100001,N,Credited,IE,POS,Cr,10:25:12,15:53:31,7/17/2016,89637715,1108.37,1,"Community notice best necessary meeting. Movement girl main citizen next local.
Thus social measure. Successful magazine task join goal.",13:32:59,NEFT
DCTX14808940860840,GB94WWYR43460145320993,1/28/2015,2482.81,100001,N,Credited,OPERA,MOBILE,Cr,19:33:26,25:51:21,7/17/2016,34624210,1108.37,5,"Growth he leg strategy. Unit television protect sport hope tree own medical.
Leader per act floor Mrs forward. Create activity form finish score.",22:26:31,CARDS
DCTX14808940860840,GB94WWYR43460145320993,1/28/2015,4293.89,100001,N,Credited,CHROME,MOBILE,Cr,9:25:52,15:00:08,7/24/2016,96199657,1811.08,6,"Information actually low hospital effect remember family. Mother son security art attention social.
Purpose whatever here argue read just. Point themselves language tell.",13:11:29,CHEQUE
DCTX14808940860840,GB94WWYR43460145320993,1/28/2015,6104.97,100001,N,Credited,CHROME,POS,Cr,17:31:14,22:41:23,7/24/2016,76246821,1811.08,4,Team deep everyone. Garden them word worker. Fly move traditional. Mrs arrive relationship great increase realize follow.,20:12:18,UPI
DCTX14808940860840,GB94WWYR43460145320993,1/28/2015,5177.89,100001,Y,Utilities,SAFARI,MOBILE,Dr,5:20:31,6:23:55,7/25/2016,303446,927.08,3,"Could director particular beyond good. Traditional despite within different. Situation show myself information growth.
Skill serious suffer ever describe.",5:55:00,RTGS
DCTX14808940860840,GB94WWYR43460145320993,1/28/2015,4250.81,100001,Y,Dining,SAFARI,POS,Dr,10:53:18,14:20:35,7/25/2016,36038237,927.08,6,"Suffer life least that kitchen. Economic country free report civil main gas professor.
Both media throw thought future matter remain. Majority partner until laugh focus.",12:05:29,CHEQUE
DCTX14808940860840,GB94WWYR43460145320993,1/28/2015,3323.73,100001,Y,Dining,MI,PC,Dr,17:46:51,20:39:34,7/25/2016,17654869,927.08,3,Home current for identify movement. Once watch factor week arrive company American. Policy play listen chance huge buy data.,18:22:12,RTGS
DCTX14808940860840,GB94WWYR43460145320993,1/28/2015,2396.65,100001,Y,Rent,IE,PC,Dr,18:36:43,22:00:13,7/25/2016,46917386,927.08,2,"Music benefit father nature particular large believe future. National writer tend any.
Several all food explain during. Least campaign tough seem think seek they mention.",20:17:10,IMPS
DCTX14808940860840,GB94WWYR43460145320993,1/28/2015,3046.41,100001,N,Credited,EDGE,POS,Cr,5:17:49,9:08:58,8/5/2016,60557483,649.76,5,"Dinner send action. Back toward case game close center.
Little blue although point court. His prove bit factor.",7:17:12,CARDS
DCTX14808940860840,GB94WWYR43460145320993,1/28/2015,3696.17,100001,N,Credited,CHROME,PC,Cr,16:33:28,20:13:17,8/5/2016,54596436,649.76,5,"Member enter wide message television benefit leader. House sometimes study forget reach budget authority.
News pass rule only. Wear cause capital turn stuff mouth. And involve so rise business.",17:21:57,CARDS
DCTX14808940860840,GB94WWYR43460145320993,1/28/2015,3046.41,100001,Y,Rent,CHROME,PC,Dr,21:41:17,24:23:49,8/5/2016,84186621,649.76,5,Far resource white mother see condition suffer. Attack debate probably now raise blood another. Law pay treatment guess point total.,22:46:30,CARDS
DCTX14808940860840,GB94WWYR43460145320993,1/28/2015,3411.45,100001,N,Credited,FF,POS,Cr,8:07:08,13:02:19,8/8/2016,66668954,365.04,5,"Various them dream every management much. Author sit easy new small.
Idea later everyone knowledge. Life might high.
Before follow baby reduce. During hospital community strategy increase fish.",10:35:20,CARDS
DCTX14808940860840,GB94WWYR43460145320993,1/28/2015,3046.41,100001,Y,Rent,IE,PC,Dr,10:58:09,13:12:55,8/8/2016,90420900,365.04,1,"Serve white book never. The work anything that. Family weight financial site. Bank focus lose lose ever staff.
Box gun today along thing. Human offer fire wall up personal free.",12:28:35,NEFT
DCTX14808940860840,GB94WWYR43460145320993,1/28/2015,3411.45,100001,N,Credited,SAFARI,PC,Cr,18:38:08,22:02:36,8/8/2016,57044651,365.04,7,"Community indeed next away. Five art election during guy do Mrs state.
Girl site away. Sure important beat.",19:33:29,DD
DCTX14808940860840,GB94WWYR43460145320993,1/28/2015,3023.93,100001,Y,Rent,MI,PC,Dr,7:22:16,10:24:28,8/16/2016,58791837,387.52,4,"Support be he deep serious might. Large must capital.
Answer change law seven method buy. Worker know campaign provide million.",8:53:21,UPI
DCTX14808940860840,GB94WWYR43460145320993,1/28/2015,2636.41,100001,Y,Rent,CHROME,PC,Dr,11:33:54,14:41:02,8/16/2016,31020138,387.52,5,"Concern trouble yourself any throw. Forget practice son left material drop tax lawyer. Yet dog allow both reveal.
Record figure work environmental offer control pass. Put store it traditional week.",12:20:09,CARDS
DCTX14808940860840,GB94WWYR43460145320993,1/28/2015,3023.93,100001,N,Credited,CHROME,MOBILE,Cr,21:00:45,26:11:00,8/16/2016,49053074,387.52,6,"Best peace finally education.
Development herself with national letter service up. Debate left agency product himself character but building.",23:40:20,CHEQUE
DCTX14808940860840,GB94WWYR43460145320993,1/28/2015,3457.05,100001,N,Credited,FF,POS,Cr,15:44:30,23:05:59,8/22/2016,97017790,433.12,2,"War why represent stage world. Call born general recent increase movie still.
Tough particular expert early. Center charge often bad movie police. Design direction company.",17:55:22,IMPS
DCTX14808940860840,GB94WWYR43460145320993,1/28/2015,3307.63,100001,Y,Household Consumables,MI,PC,Dr,9:53:19,16:08:43,8/31/2016,71556994,149.42,6,On put now decide. Threat its four allow. Stage reduce eye run. By support physical mean.,13:41:29,CHEQUE
DCTX14808940860840,GB94WWYR43460145320993,1/28/2015,3158.21,100001,Y,Medicals,SAFARI,MOBILE,Dr,22:21:50,27:20:10,8/31/2016,69376955,149.42,6,Hospital single gas author song beat rate. State possible become your. Interesting of up age require. Network say us natural guess.,23:32:12,CHEQUE
DCTX14808940860840,GB94WWYR43460145320993,1/28/2015,3079.35,100001,Y,Medicals,MI,MOBILE,Dr,10:00:34,15:39:47,9/1/2016,53235077,78.86,5,Boy cut interesting least crime. Trip purpose what story. Travel finally deal hear. Program special radio here nice staff other throw.,12:48:45,CARDS
DCTX14808940860840,GB94WWYR43460145320993,1/28/2015,3000.49,100001,Y,Insurance,OPERA,MOBILE,Dr,19:10:50,25:28:17,9/1/2016,69771941,78.86,5,"Onto across day us understand. Election discussion allow.
Finally nor song north fast.
Before nor sing or able land available. Occur base eye read conference difference.",22:29:27,CARDS
DCTX14808940860840,GB94WWYR43460145320993,1/28/2015,2565.53,100001,Y,Entertainment,EDGE,MOBILE,Dr,16:20:30,24:45:04,9/4/2016,8126252,434.96,5,"Life attention method personal play peace. Through work heavy course college.
It size rate red although. Team number president low eight conference learn the.",21:36:09,CARDS
DCTX14808940860840,GB94WWYR43460145320993,1/28/2015,1455.3,100001,Y,Rent,IE,MOBILE,Dr,5:25:39,7:23:27,9/6/2016,41081488,1110.23,1,"Participant trial still full smile. His course small fact new before.
Ever focus space dog participant. Player which teacher move bad whatever then position. Camera indicate various old human feel.",6:34:18,NEFT
DCTX14808940860840,GB94WWYR43460145320993,1/28/2015,345.07,100001,Y,Personal Care,EDGE,PC,Dr,14:57:09,18:32:52,9/6/2016,39169075,1110.23,7,"State create race. Huge fly seem suffer cultural population site. Challenge bit society board white lay.
Wrong owner billion firm. Man total high well with game sort.",16:58:46,DD
DCTX14808940860840,GB94WWYR43460145320993,1/28/2015,2284.97,100001,N,Credited,FF,PC,Cr,21:45:26,25:47:13,9/7/2016,11469247,1939.9,1,"Site gun particularly morning. Build past trip nation. Game cup official most.
Discover forget air probably water though.
Allow watch beyond person energy. Second office have through certainly order.",23:44:43,NEFT
DCTX14808940860840,GB94WWYR43460145320993,1/28/2015,1482.55,100001,Y,Entertainment,OPERA,MOBILE,Dr,6:22:50,9:07:02,9/12/2016,23438590,802.42,4,Level technology few. Often successful college contain. Perform power pick fire.,7:57:23,UPI
DCTX14808940860840,GB94WWYR43460145320993,1/28/2015,2284.97,100001,N,Credited,IE,MOBILE,Cr,7:54:29,12:18:36,9/12/2016,64174440,802.42,2,"Hear her matter hour attention may. Say fear plant fine. Brother hair change and mother.
Forget western adult after. Especially kitchen fear opportunity. Training television from others generation.",10:18:00,IMPS
DCTX14808940860840,GB94WWYR43460145320993,1/28/2015,1482.55,100001,Y,Transportation,EDGE,POS,Dr,12:51:51,16:06:49,9/12/2016,88435732,802.42,3,"Fish concern stand letter above. Provide trip herself us consider.
Better here believe free total market. Civil money two. Floor piece quite another.",14:49:11,RTGS
DCTX14808940860840,GB94WWYR43460145320993,1/28/2015,2284.97,100001,N,Credited,EDGE,POS,Cr,20:19:36,23:59:33,9/12/2016,90698545,802.42,7,"Thank read rich affect us might continue. Choice son for above thought fight.
Skill common feeling fast suddenly force back. Attention hit drug their. Professor imagine coach character several for.",22:34:55,DD
DCTX14808940860840,GB94WWYR43460145320993,1/28/2015,3559.52,100001,N,Credited,CHROME,POS,Cr,10:34:05,16:26:08,9/21/2016,71619699,1274.55,4,"Food movie however technology join sense either. War sense crime test. Just pull purpose two.
Factor over officer middle. System card couple experience local. Magazine discuss discuss.",14:23:03,UPI
DCTX14808940860840,GB94WWYR43460145320993,1/28/2015,2284.97,100001,Y,Transportation,CHROME,MOBILE,Dr,18:09:24,23:29:45,9/21/2016,84113894,1274.55,5,"Else worry human they practice consider. Candidate building thank certain first to. First time system suddenly.
Close hold half control consider recent over. Wind station front him.",19:46:16,CARDS
DCTX14808940860840,GB94WWYR43460145320993,1/28/2015,3737.11,100001,N,Credited,SAFARI,PC,Cr,7:02:44,8:08:10,9/23/2016,81303861,1452.14,2,Must thought east purpose article pull relationship. According purpose attack perform wonder. Onto cause meeting avoid.,7:35:00,IMPS
DCTX14808940860840,GB94WWYR43460145320993,1/28/2015,2284.97,100001,Y,Rent,SAFARI,MOBILE,Dr,9:08:10,11:52:34,9/23/2016,38202421,1452.14,4,"Billion indicate myself at. Kitchen five language billion charge manager ten.
Realize heart whose name budget. Lose player bag new police instead probably fire. Scientist with after itself enough.",10:57:33,UPI
DCTX14808940860840,GB94WWYR43460145320993,1/28/2015,3737.11,100001,N,Credited,FF,MOBILE,Cr,11:27:46,13:42:26,9/23/2016,46665539,1452.14,4,"Make choose total news. Magazine wide population out risk ahead question. Mother once wife world measure another.
Church him bank however crime song. Kind certain certain four out American enough.",12:54:22,UPI
DCTX14808940860840,GB94WWYR43460145320993,1/28/2015,5189.25,100001,N,Credited,EDGE,POS,Cr,19:27:48,20:51:05,9/23/2016,45729768,1452.14,5,"Carry situation exactly pretty. Five Democrat happen professor style early toward ability.
Experience pass officer there.
Data me push. Along year difference thus site civil talk.",19:51:55,CARDS
DCTX14808940860840,GB94WWYR43460145320993,1/28/2015,3737.11,100001,Y,Entertainment,EDGE,POS,Dr,19:25:05,22:09:30,9/23/2016,38139253,1452.14,1,Glass cause term security report speak who. Rich near also charge once special really.,20:55:34,NEFT
DCTX14808940860840,GB94WWYR43460145320993,1/28/2015,3413.42,100001,Y,Medicals,CHROME,MOBILE,Dr,5:45:08,8:38:04,9/25/2016,98286805,323.69,6,"Reach country bar. Maybe small reduce later amount. Wear year lawyer anything with.
Method old manager two resource radio. Leader hair dinner. Despite issue fall.",7:06:07,CHEQUE
DCTX14808940860840,GB94WWYR43460145320993,1/28/2015,3089.73,100001,Y,Utilities,FF,POS,Dr,9:32:53,11:45:39,9/25/2016,51592141,323.69,7,Difficult reach long range me traditional. Movement hotel drop safe somebody win. Notice type mention other research available.,10:56:34,DD
DCTX14808940860840,GB94WWYR43460145320993,1/28/2015,3413.42,100001,N,Credited,CHROME,PC,Cr,11:04:47,14:05:40,9/25/2016,87674293,323.69,2,Suddenly step can same something federal. Level born well it. Guy present financial see newspaper hospital hard establish.,12:11:31,IMPS
DCTX14808940860840,GB94WWYR43460145320993,1/28/2015,3737.11,100001,N,Credited,EDGE,PC,Cr,17:31:41,20:25:18,9/25/2016,15501189,323.69,2,"Force story face law. Would result be. Produce rate various.
Feeling morning senior. Arrive father clearly hour concern.",19:30:26,IMPS
DCTX14808940860840,GB94WWYR43460145320993,1/28/2015,3413.42,100001,Y,Entertainment,FF,MOBILE,Dr,20:30:51,23:51:56,9/25/2016,27937280,323.69,5,"Compare product form pick whom bit tax. Until several small any sure.
Off person light right local morning. Medical should life throughout difficult much.",22:12:26,CARDS
DCTX14808940860840,GB94WWYR43460145320993,1/28/2015,4904.46,100001,N,Credited,OPERA,MOBILE,Cr,18:22:41,26:54:36,9/30/2016,1261820,1491.04,2,"Interview no painting man. Opportunity happy gun.
Expert kind remain southern trial arm. Home receive much all generation thing. Trade environment newspaper.",23:33:06,IMPS
DCTX14808940860840,GB94WWYR43460145320993,1/28/2015,5075.86,100001,N,Credited,CHROME,POS,Cr,3:08:04,4:57:06,10/5/2016,72361375,171.4,7,Pretty type field dog. Treat question only action then open boy.,4:22:04,DD
DCTX14808940860840,GB94WWYR43460145320993,1/28/2015,5247.26,100001,N,Credited,SAFARI,MOBILE,Cr,8:02:26,10:23:31,10/5/2016,39219015,171.4,1,"Nor really former visit. Itself idea stage sit. Sense fund section.
Maintain charge pass staff become very west director. Game guess accept entire occur go open.",9:06:31,NEFT
DCTX14808940860840,GB94WWYR43460145320993,1/28/2015,5418.66,100001,N,Credited,OPERA,POS,Cr,13:48:34,16:11:04,10/5/2016,94189865,171.4,4,"Blood oil run receive. Join way real say society identify. Thing stop add production.
Beyond smile box tell. Easy use enough wonder west open.",15:36:06,UPI
DCTX14808940860840,GB94WWYR43460145320993,1/28/2015,5247.26,100001,Y,Dining,EDGE,PC,Dr,14:58:35,17:41:48,10/5/2016,77252418,171.4,7,"Despite choice change however least Congress past. Various middle cell student through challenge.
Computer little point rest action situation skin risk. Increase serve capital deep center.",16:03:31,DD
DCTX14808940860840,GB94WWYR43460145320993,1/28/2015,5075.86,100001,Y,Utilities,FF,MOBILE,Dr,21:20:52,23:26:05,10/5/2016,35692232,171.4,2,"Final list trial matter media pay score. News center box science whose.
Against walk plant list expert without none system. Radio serve set send other. Doctor wait he eat computer country.",22:06:15,IMPS
DCTX14808940860840,GB94WWYR43460145320993,1/28/2015,6377.74,100001,N,Credited,EDGE,PC,Cr,5:33:47,7:46:28,10/9/2016,75279875,1301.88,2,"Never listen mention south year act. White watch fund yeah. Reason any shoulder forget.
Edge finish why. Part sign why purpose. Late kind reveal general measure.",7:08:56,IMPS
DCTX14808940860840,GB94WWYR43460145320993,1/28/2015,7679.62,100001,N,Credited,EDGE,PC,Cr,6:59:55,10:25:40,10/9/2016,75270209,1301.88,3,"People enter these environmental issue development house garden. Media money color consumer.
Single story there few. Bad certainly present ten say institution.",8:31:11,RTGS
DCTX14808940860840,GB94WWYR43460145320993,1/28/2015,8981.5,100001,N,Credited,CHROME,PC,Cr,14:48:43,16:40:07,10/9/2016,47026612,1301.88,7,"Billion couple cup purpose. Term create reality series president exist.
Great game experience could garden hand. Whom factor bill language type follow camera. Baby question soon contain.",15:36:34,DD
DCTX14808940860840,GB94WWYR43460145320993,1/28/2015,10283.38,100001,N,Credited,FF,MOBILE,Cr,17:31:57,18:50:49,10/9/2016,53327628,1301.88,4,"Father since hot produce most itself set town. System like thank collection to. During system public officer practice college.
Personal last able responsibility cause. Draw exactly wear.",18:07:29,UPI
DCTX14808940860840,GB94WWYR43460145320993,1/28/2015,11585.26,100001,N,Credited,EDGE,MOBILE,Cr,21:45:35,23:46:42,10/9/2016,71753478,1301.88,1,"Agreement position easy maybe better them usually.
Still simply win foreign spring head. Federal reach specific to class perform shoulder.",22:35:13,NEFT
DCTX14808940860840,GB94WWYR43460145320993,1/28/2015,13287.06,100001,N,Credited,IE,MOBILE,Cr,4:53:44,8:29:49,10/10/2016,402088,1701.8,6,"Herself few stay everybody run. Ten compare better goal message term your new. Region our road seem.
Woman window eye statement. Popular across smile game authority.",7:17:01,CHEQUE
DCTX14808940860840,GB94WWYR43460145320993,1/28/2015,11585.26,100001,Y,Personal Care,MI,PC,Dr,9:46:05,11:45:54,10/10/2016,2656526,1701.8,7,"Explain argue good foreign. Evidence anyone ok significant life.
Grow follow number realize. Style indeed computer trip. More tell wind nature thousand move.",10:30:21,DD
DCTX14808940860840,GB94WWYR43460145320993,1/28/2015,9883.46,100001,Y,Entertainment,CHROME,PC,Dr,15:41:12,17:17:34,10/10/2016,44711559,1701.8,4,"Treat people cold owner compare when few. Drug position partner movie box open.
Likely difficult within meeting since next owner including. Box manage doctor defense after cover show staff.",16:38:42,UPI
DCTX14808940860840,GB94WWYR43460145320993,1/28/2015,8181.66,100001,Y,Utilities,OPERA,PC,Dr,17:19:16,21:28:38,10/10/2016,3608494,1701.8,7,"Onto live language company us environmental.
Radio government could shake. Himself guess administration local analysis. Right kid record say success.",19:21:35,DD
DCTX14808940860840,GB94WWYR43460145320993,1/28/2015,6426.86,100001,Y,Medicals,MI,POS,Dr,3:31:39,6:32:02,10/13/2016,81950003,1754.8,5,Near perform least act. Present example leg certainly region opportunity behavior try. Stand important above class evening. Fly read may born get open.,4:33:31,CARDS
DCTX14808940860840,GB94WWYR43460145320993,1/28/2015,8181.66,100001,N,Credited,IE,PC,Cr,8:50:40,10:55:15,10/13/2016,3700020,1754.8,3,"Heavy reach myself them purpose. Culture many with American.
Chair ever you college power. Professor chance book save argue health always easy. International any argue but.",9:15:59,RTGS
DCTX14808940860840,GB94WWYR43460145320993,1/28/2015,6426.86,100001,Y,Personal Care,OPERA,PC,Dr,11:06:57,13:35:48,10/13/2016,47132771,1754.8,6,"Vote build old somebody. Nature miss discover several. Consider above peace herself which who early.
Value well poor film. Assume meet expert police especially sure.",12:50:29,CHEQUE
DCTX14808940860840,GB94WWYR43460145320993,1/28/2015,8181.66,100001,N,Credited,OPERA,PC,Cr,16:54:28,19:08:16,10/13/2016,81587650,1754.8,6,Sound maybe life spend could until though level. Everything resource friend interview especially dark only structure. Purpose street after rather son meeting blood.,18:43:50,CHEQUE
DCTX14808940860840,GB94WWYR43460145320993,1/28/2015,9936.46,100001,N,Credited,FF,POS,Cr,21:54:54,23:20:30,10/13/2016,50705412,1754.8,5,"Environment blue range receive. Trouble message receive race age.
Political remember main reduce read song. Decide growth great about never. Coach focus rise leader admit.",22:48:31,CARDS
DCTX14808940860840,GB94WWYR43460145320993,1/28/2015,10089.74,100001,N,Credited,FF,MOBILE,Cr,11:10:25,16:47:26,10/20/2016,77942616,153.28,3,"Purpose work talk military. Open subject far option visit street.
Media seven open wrong above fall girl. Music individual must expert season leave military station. Letter campaign million.",13:46:12,RTGS
DCTX14808940860840,GB94WWYR43460145320993,1/28/2015,9006.67,100001,Y,Online Shopping,CHROME,PC,Dr,7:28:52,9:50:22,10/24/2016,17394307,1083.07,1,"Artist different real political above very news action. Issue base hair.
Sea discussion plant agreement series scientist. A generation walk strategy.",8:40:07,NEFT
DCTX14808940860840,GB94WWYR43460145320993,1/28/2015,7923.6,100001,Y,Household Consumables,SAFARI,POS,Dr,10:36:31,13:15:40,10/24/2016,17832748,1083.07,4,"American although add clear Democrat factor. Activity design make measure.
Be community white second drug. Take ready music.",12:05:16,UPI
DCTX14808940860840,GB94WWYR43460145320993,1/28/2015,9006.67,100001,N,Credited,FF,MOBILE,Cr,13:47:58,17:03:18,10/24/2016,78198364,1083.07,6,"Owner his question. Reality fall can month language late. Church buy put natural from.
Hope sometimes base performance town. Land her maybe pull.",15:28:25,CHEQUE
DCTX14808940860840,GB94WWYR43460145320993,1/28/2015,7923.6,100001,Y,Utilities,FF,POS,Dr,20:32:17,22:56:24,10/24/2016,44881436,1083.07,7,"Race more expect hear. Thus matter after reveal offer.
Way agreement figure hear less join song. Listen detail similar expert president material step. Participant today appear know.",21:46:54,DD
DCTX14808940860840,GB94WWYR43460145320993,1/28/2015,6468.4,100001,Y,Personal Care,SAFARI,MOBILE,Dr,5:07:53,7:41:43,11/2/2016,59059455,1455.2,5,"Discuss rise commercial free. Miss analysis whole rate.
Still financial generation west policy staff view. Rest church would brother what wish.
Standard record old million increase.",6:32:32,CARDS
DCTX14808940860840,GB94WWYR43460145320993,1/28/2015,7923.6,100001,N,Credited,IE,POS,Cr,10:59:36,13:44:13,11/2/2016,69189661,1455.2,7,"Top political we month but loss. Reflect us investment window down. Once record personal fill begin side.
State expert machine reduce character third see. Level she green instead.",12:23:00,DD
DCTX14808940860840,GB94WWYR43460145320993,1/28/2015,6468.4,100001,Y,Utilities,IE,MOBILE,Dr,17:29:11,19:54:05,11/2/2016,17961110,1455.2,7,Hour three best back. Investment best suddenly very however approach gun. Reveal time production image college those. Article do site impact always common.,18:15:35,DD
DCTX14808940860840,GB94WWYR43460145320993,1/28/2015,7923.6,100001,N,Credited,CHROME,POS,Cr,20:50:31,24:38:26,11/2/2016,47919037,1455.2,5,Hair stuff you talk simple side attorney scientist. Statement produce develop imagine recently similar. Direction beautiful local face action own federal.,23:05:20,CARDS
DCTX14808940860840,GB94WWYR43460145320993,1/28/2015,8054.68,100001,N,Credited,SAFARI,POS,Cr,10:36:22,14:36:50,11/8/2016,90874475,131.08,6,Pretty even provide write fine. Environmental stage carry television especially relationship.,11:55:19,CHEQUE
DCTX14808940860840,GB94WWYR43460145320993,1/28/2015,7923.6,100001,Y,Dining,IE,POS,Dr,12:08:41,15:00:23,11/8/2016,41898918,131.08,6,"Mother nice impact about floor than save old. Pass many member left social teacher sure evidence.
Seat girl could hold point close.",13:03:57,CHEQUE
DCTX14808940860840,GB94WWYR43460145320993,1/28/2015,8054.68,100001,N,Credited,MI,PC,Cr,18:49:05,22:40:32,11/8/2016,21455889,131.08,7,"Area forget next rise sell. No among control whom amount consider region. Much score agree which position structure knowledge.
Blue drop friend pull in natural. National win wife direction well.",20:31:16,DD
DCTX14808940860840,GB94WWYR43460145320993,1/28/2015,8829.54,100001,N,Credited,OPERA,POS,Cr,6:42:47,12:03:11,11/13/2016,33698724,774.86,6,"Couple unit best yes realize. Political data remember. Successful big newspaper age.
Reflect official relationship book garden design natural. Effort development great act worker wide kid.",9:53:06,CHEQUE
DCTX14808940860840,GB94WWYR43460145320993,1/28/2015,9604.4,100001,N,Credited,SAFARI,PC,Cr,13:37:56,18:53:34,11/13/2016,44764371,774.86,3,Really reach once most. Him bring mission then. Agency car forget somebody mention commercial later.,17:00:39,RTGS
DCTX14808940860840,GB94WWYR43460145320993,1/28/2015,10010.94,100001,N,Credited,SAFARI,POS,Cr,8:28:31,11:12:04,11/16/2016,29974733,406.54,5,Century buy step statement its and. Industry class rate air. Bill drop toward. Area through record result everything town building left.,9:17:07,CARDS
DCTX14808940860840,GB94WWYR43460145320993,1/28/2015,10417.48,100001,N,Credited,IE,MOBILE,Cr,16:02:38,18:29:26,11/16/2016,58507162,406.54,7,"Realize action today every structure. Evening camera vote agency lot wear.
Best raise executive again industry. Very turn company. Writer page be option.",17:02:23,DD
DCTX14808940860840,GB94WWYR43460145320993,1/28/2015,10824.02,100001,N,Credited,OPERA,MOBILE,Cr,22:30:09,26:05:16,11/16/2016,7270116,406.54,6,"Especially system lawyer. American care same research part site knowledge.
Better suddenly son authority bring skin business. Figure rule agency us institution follow. Speak drive with world.",23:40:18,CHEQUE
DCTX14808940860840,GB94WWYR43460145320993,1/28/2015,11540.88,100001,N,Credited,CHROME,PC,Cr,10:10:01,14:35:16,11/19/2016,27150504,716.86,3,Resource meeting themselves yard thank economy voice. Somebody others unit difficult. However condition nor get might cause natural.,11:37:29,RTGS
DCTX14808940860840,GB94WWYR43460145320993,1/28/2015,10824.02,100001,Y,Utilities,EDGE,POS,Dr,11:14:03,14:14:04,11/19/2016,63089660,716.86,1,Network upon thing instead. Force state above night north. Teacher collection wall today focus west choose. Half meet continue theory social.,13:01:37,NEFT
DCTX14808940860840,GB94WWYR43460145320993,1/28/2015,11540.88,100001,N,Credited,SAFARI,MOBILE,Cr,19:15:34,22:52:46,11/19/2016,28443025,716.86,2,Film seem industry campaign admit young. Nothing necessary rest evening. Dream artist moment black apply north red. Activity yourself even.,20:31:53,IMPS
DCTX14808940860840,GB94WWYR43460145320993,1/28/2015,11748.78,100001,N,Credited,CHROME,MOBILE,Cr,3:44:01,7:16:48,12/2/2016,85701359,207.9,4,Age grow film like serve pressure study. Least method me edge surface radio per itself. Cold at phone must watch.,5:47:14,UPI
DCTX14808940860840,GB94WWYR43460145320993,1/28/2015,11956.68,100001,N,Credited,OPERA,POS,Cr,12:10:13,15:24:09,12/2/2016,94193039,207.9,5,Study often age upon. Why fine produce clearly any here local. Cost not short structure factor year.,14:23:35,CARDS
DCTX14808940860840,GB94WWYR43460145320993,1/28/2015,12164.58,100001,N,Credited,SAFARI,MOBILE,Cr,15:06:34,17:02:19,12/2/2016,87943474,207.9,1,Practice bill democratic position several. Both value tax method central. Hear attention third protect.,16:30:47,NEFT
DCTX14808940860840,GB94WWYR43460145320993,1/28/2015,12372.48,100001,N,Credited,IE,MOBILE,Cr,20:27:16,22:12:24,12/2/2016,24342148,207.9,7,The environmental executive watch several. Hot available while. Recently some reveal put choose.,21:26:38,DD
DCTX14808940860840,GB94WWYR43460145320993,1/28/2015,13057.82,100001,N,Credited,MI,POS,Cr,3:04:38,6:52:53,12/13/2016,95106472,685.34,6,Agency in evidence structure drive. Let ahead citizen value. Guy suddenly it college choice center author.,5:03:36,CHEQUE
DCTX14808940860840,GB94WWYR43460145320993,1/28/2015,12372.48,100001,Y,Personal Care,FF,PC,Dr,9:29:31,13:03:13,12/13/2016,53094582,685.34,7,"Full hour amount follow. Candidate side skin option. Class child me thought successful election heart quickly. Enough raise space without.
Base study analysis you. Bar term of line specific everyone.",10:50:39,DD
DCTX14808940860840,GB94WWYR43460145320993,1/28/2015,13057.82,100001,N,Credited,SAFARI,PC,Cr,16:10:32,20:20:38,12/13/2016,87386165,685.34,5,Detail ball provide. Hotel wrong coach month conference pull. Audience suggest send rock road share inside ever. Rich board commercial drive notice hot.,17:59:25,CARDS
DCTX14808940860840,GB94WWYR43460145320993,1/28/2015,12372.48,100001,Y,Groceries,CHROME,POS,Dr,21:39:56,25:13:43,12/13/2016,45113109,685.34,6,"Follow use land out style. Budget ahead impact. Toward participant available better.
Eye who bring your cultural. My room drop few figure.",23:39:10,CHEQUE
DCTX14808940860840,GB94WWYR43460145320993,1/28/2015,13060.38,100001,N,Credited,SAFARI,MOBILE,Cr,5:24:31,8:49:24,12/14/2016,21494253,687.9,4,Step east seat Democrat whom hundred. Southern shoulder especially debate across leave right.,7:13:36,UPI
DCTX14808940860840,GB94WWYR43460145320993,1/28/2015,12372.48,100001,Y,Medicals,SAFARI,POS,Dr,15:27:04,18:03:27,12/14/2016,92704459,687.9,7,"Member color boy question painting. On education way wish third.
Dream case direction key left. Business cup establish determine. Not back standard direction adult. Market push idea maintain near.",16:38:13,DD
DCTX14808940860840,GB94WWYR43460145320993,1/28/2015,11684.58,100001,Y,Entertainment,OPERA,POS,Dr,20:39:38,23:59:30,12/14/2016,87296501,687.9,4,"Campaign who benefit prepare vote a. Where policy style husband.
Score career already detail author. Me agency person act style. Could fire amount look author through.",21:24:15,UPI
DCTX14808940860840,GB94WWYR43460145320993,1/28/2015,13387.61,100001,N,Credited,CHROME,PC,Cr,6:20:21,9:20:42,12/22/2016,70916591,1703.03,2,"Until civil final might chance certainly. Southern several leg while learn discuss.
Trouble you daughter record nor.",8:00:11,IMPS
DCTX14808940860840,GB94WWYR43460145320993,1/28/2015,15090.64,100001,N,Credited,FF,PC,Cr,10:43:22,13:06:48,12/22/2016,96313893,1703.03,4,"Population after fear economic. Nice then down boy. Responsibility fact deal building skill lay weight.
Whether character shake defense question simply yourself free. Into TV realize necessary.",11:16:58,UPI
DCTX14808940860840,GB94WWYR43460145320993,1/28/2015,16793.67,100001,N,Credited,EDGE,MOBILE,Cr,15:12:16,16:53:26,12/22/2016,46700759,1703.03,5,Agree feeling apply quality population sea agree. Chance simply can exist should someone American position.,15:53:57,CARDS
DCTX14808940860840,GB94WWYR43460145320993,1/28/2015,18496.7,100001,N,Credited,IE,POS,Cr,18:45:04,22:41:11,12/22/2016,67095674,1703.03,4,"Care reason reflect pass if. Discuss maintain computer simple.
Article method current bank market avoid reason say. List owner leader strong half. Against fire drop discuss appear make bring.",20:50:49,UPI
DCTX14808940860840,GB94WWYR43460145320993,1/28/2015,19903.61,100001,N,Credited,SAFARI,MOBILE,Cr,9:47:17,13:59:38,12/28/2016,34097397,1406.91,3,Along movement kitchen raise people bad rest.,11:41:08,RTGS
DCTX14808940860840,GB94WWYR43460145320993,1/28/2015,18496.7,100001,Y,Dining,FF,PC,Dr,14:55:21,20:56:07,12/28/2016,30115231,1406.91,6,"Very theory until southern fight bag east. Movement direction surface yeah.
Daughter lot represent agree action. Light especially almost suddenly road make begin.",18:02:44,CHEQUE
DCTX14808940860840,GB94WWYR43460145320993,1/28/2015,18383.2,100001,Y,Rent,CHROME,POS,Dr,2:29:55,6:04:05,1/7/2017,79179737,113.5,3,"Feel right also.
Color area news rise executive community. Safe action get light.
Boy produce nice value know how. Interesting do push challenge.",4:06:18,RTGS
DCTX14808940860840,GB94WWYR43460145320993,1/28/2015,18496.7,100001,N,Credited,IE,POS,Cr,8:59:52,11:33:02,1/7/2017,43538454,113.5,3,"Conference such former.
Stage time own cold I.
See information both wish my develop. Foot art knowledge fill well. Prepare probably sure environment language amount.",10:01:32,RTGS
DCTX14808940860840,GB94WWYR43460145320993,1/28/2015,18610.2,100001,N,Credited,IE,POS,Cr,14:05:19,16:41:04,1/7/2017,39158079,113.5,7,Job both apply positive figure commercial. Animal say across this. My somebody nature its use program.,14:59:12,DD
DCTX14808940860840,GB94WWYR43460145320993,1/28/2015,18723.7,100001,N,Credited,FF,MOBILE,Cr,17:46:29,20:58:03,1/7/2017,87624120,113.5,1,"Standard friend material left ago network goal. Action hotel food western choose improve successful.
Toward land defense move Mrs public. Usually one face standard dream this many.",19:28:00,NEFT
DCTX14808940860840,GB94WWYR43460145320993,1/28/2015,18610.2,100001,Y,Transportation,MI,POS,Dr,23:03:57,25:14:51,1/7/2017,2689616,113.5,5,With best above citizen. Large become always dinner very sound.,23:41:36,CARDS
DCTX14808940860840,GB94WWYR43460145320993,1/28/2015,19071.62,100001,N,Credited,EDGE,PC,Cr,12:23:15,24:12:04,1/12/2017,84148971,461.42,6,"Cost I share. Everyone themselves southern structure claim that throw.
Big citizen so wide. Sport of Mrs institution. Specific deal operation around meeting product game.",18:15:18,CHEQUE
DCTX14808940860840,GB94WWYR43460145320993,1/28/2015,17282.94,100001,Y,Transportation,OPERA,PC,Dr,5:12:36,6:41:16,1/25/2017,52147531,1788.68,7,"Certain write move explain history situation home. Within feel stay.
Stock student toward stop expert none. Whom at bring wear discover. Act eye attack if red your partner garden.",5:37:41,DD
DCTX14808940860840,GB94WWYR43460145320993,1/28/2015,19071.62,100001,N,Credited,OPERA,POS,Cr,8:00:41,10:41:56,1/25/2017,99670276,1788.68,1,"Remember still thousand think. Actually on and much. Its much will help.
Also about here prepare. Statement performance medical course small bring carry.",9:41:53,NEFT
DCTX14808940860840,GB94WWYR43460145320993,1/28/2015,20860.3,100001,N,Credited,FF,POS,Cr,12:55:10,16:02:39,1/25/2017,90919053,1788.68,6,"Plant commercial daughter spend style able husband.
Shake cost present hot little. Consider social some you. Bill discuss population hit include magazine floor.",14:36:11,CHEQUE
DCTX14808940860840,GB94WWYR43460145320993,1/28/2015,22648.98,100001,N,Credited,MI,POS,Cr,16:01:35,19:29:02,1/25/2017,90288807,1788.68,1,Father little commercial international position cover. Him television stop choice receive. Congress sound senior star toward direction.,17:44:51,NEFT
DCTX14808940860840,GB94WWYR43460145320993,1/28/2015,24437.66,100001,N,Credited,MI,MOBILE,Cr,21:07:06,23:03:57,1/25/2017,79706834,1788.68,3,Hospital law student certain fly physical voice. Ahead course year affect grow fund especially point. Raise school explain machine base those. Full value while prevent body measure discover.,21:44:42,RTGS
DCTX14808940860840,GB94WWYR43460145320993,1/28/2015,22498.88,100001,Y,Entertainment,SAFARI,MOBILE,Dr,5:08:19,8:02:41,1/31/2017,81352821,1938.78,7,"Beautiful from each over like even. Number such agreement you. Child least sea question difficult simple.
Article call care. Last onto office. Sell blood against like PM to minute.",7:07:44,DD
DCTX14808940860840,GB94WWYR43460145320993,1/28/2015,24437.66,100001,N,Credited,MI,MOBILE,Cr,14:39:44,17:44:15,1/31/2017,86835572,1938.78,6,"Goal light learn.
These identify hundred hair. Mouth information friend audience same of. Sport treatment her bag.",15:46:36,CHEQUE
DCTX14808940860840,GB94WWYR43460145320993,1/28/2015,22498.88,100001,Y,Dining,MI,MOBILE,Dr,19:51:22,24:28:00,1/31/2017,46127242,1938.78,2,"Indicate industry save.
Early buy half this yet. Federal party manage summer imagine close.
Set any red add page against. Feeling if between whole room across.",22:32:26,IMPS
DCTX14808940860840,GB94WWYR43460145320993,1/28/2015,21248.09,100001,Y,Transportation,OPERA,POS,Dr,15:41:34,23:41:56,2/13/2017,91335166,1250.79,2,"Partner dog five wait product require area. Chair provide it. Else life often write dream data as care.
Arm successful rate inside inside write. Work include its expert.",21:22:57,IMPS
DCTX14808940860840,GB94WWYR43460145320993,1/28/2015,22781.69,100001,N,Credited,OPERA,POS,Cr,6:22:52,9:07:00,2/17/2017,8111708,1533.6,2,Perform maintain picture process. Difficult offer individual something.,7:16:48,IMPS
DCTX14808940860840,GB94WWYR43460145320993,1/28/2015,21248.09,100001,Y,Medicals,EDGE,PC,Dr,10:35:17,13:12:13,2/17/2017,17897259,1533.6,3,"Travel alone public better enjoy knowledge part lose. Opportunity remember there seven.
Nature senior her. Former reduce social indicate who picture operation author.",11:54:55,RTGS
DCTX14808940860840,GB94WWYR43460145320993,1/28/2015,22781.69,100001,N,Credited,SAFARI,MOBILE,Cr,11:33:28,12:41:38,2/17/2017,6791537,1533.6,3,"Impact simple hope. Poor education five movement live.
Off that chance beat. Discuss since page image know.
Area city of cause six society that. Case cut perform we fire early. Bag smile plan pretty.",12:01:02,RTGS
DCTX14808940860840,GB94WWYR43460145320993,1/28/2015,21248.09,100001,Y,Utilities,OPERA,POS,Dr,16:18:53,19:01:52,2/17/2017,32224702,1533.6,4,"Staff summer account year cold remember. Letter address forward top across not modern.
Image yes court begin ready peace. Author nice range which air interview.",18:14:27,UPI
DCTX14808940860840,GB94WWYR43460145320993,1/28/2015,22781.69,100001,N,Credited,SAFARI,MOBILE,Cr,20:51:18,22:17:16,2/17/2017,41616987,1533.6,4,"Move animal theory. South audience bar still outside itself.
Itself strategy assume mention firm best sure. Onto interview start page card safe. Decide really child cut development.",21:37:45,UPI
DCTX14808940860840,GB94WWYR43460145320993,1/28/2015,22381.22,100001,Y,Transportation,MI,MOBILE,Dr,7:49:21,13:58:26,3/10/2017,26844831,400.47,1,"Its defense beat section hotel. Idea military office participant. Than its foreign reach what out.
Drug although professor four debate bring want improve. Once try past hospital.",11:04:57,NEFT
DCTX14808940860840,GB94WWYR43460145320993,1/28/2015,22781.69,100001,N,Credited,IE,MOBILE,Cr,18:48:36,24:54:55,3/10/2017,49975857,400.47,2,Ask society land. Walk including foreign tough hold. World hope different sort quality level exist.,21:53:01,IMPS
DCTX14808940860840,GB94WWYR43460145320993,1/28/2015,21848.71,100001,Y,Online Shopping,IE,PC,Dr,5:54:30,9:11:33,3/17/2017,95169583,932.98,2,Republican service eye talk officer amount from often. Assume build both here adult do. Chair knowledge action someone politics sea air.,7:02:53,IMPS
DCTX14808940860840,GB94WWYR43460145320993,1/28/2015,20915.73,100001,Y,Insurance,EDGE,PC,Dr,14:00:24,18:35:03,3/17/2017,30731219,932.98,4,Ok night lay process first structure. International strategy cell tree high minute clear. Management similar building I wait window.,15:51:33,UPI
DCTX14808940860840,GB94WWYR43460145320993,1/28/2015,19982.75,100001,Y,Entertainment,IE,POS,Dr,17:27:43,20:23:46,3/17/2017,25975611,932.98,7,Window affect couple cultural wear building a. Their pattern cultural could. Guess sometimes put green produce tend. Scientist notice political bill lay quality other.,19:04:51,DD
DCTX14808940860840,GB94WWYR43460145320993,1/28/2015,20123.08,100001,N,Credited,SAFARI,POS,Cr,3:53:30,6:17:55,3/27/2017,58826089,140.33,7,"Meet them measure consumer however. Me time rule. Writer or set.
Agent never college. Hope line why finish continue.",5:23:56,DD
DCTX14808940860840,GB94WWYR43460145320993,1/28/2015,20263.41,100001,N,Credited,FF,PC,Cr,10:56:51,13:29:47,3/27/2017,48302289,140.33,5,"Process writer bring yourself human room control.
Church beautiful kind whom without. Door much produce peace trial sometimes manager.",11:29:22,CARDS
DCTX14808940860840,GB94WWYR43460145320993,1/28/2015,20123.08,100001,Y,Online Shopping,MI,PC,Dr,14:36:01,17:51:17,3/27/2017,72807811,140.33,4,"Assume decision well team anyone remember kid. Red try series.
Heavy early voice build participant population. Suffer hold shoulder prevent own current whatever. Fire crime send little series artist.",16:10:45,UPI
DCTX14808940860840,GB94WWYR43460145320993,1/28/2015,19982.75,100001,Y,Medicals,FF,PC,Dr,18:36:09,21:39:49,3/27/2017,84074058,140.33,4,Occur blue beyond site indeed little crime treatment. True small upon gun. Real become simply quickly quite for apply.,20:39:44,UPI
DCTX14808940860840,GB94WWYR43460145320993,1/28/2015,19828.97,100001,Y,Transportation,MI,MOBILE,Dr,7:55:47,11:44:08,3/28/2017,30391772,153.78,6,"Child little suffer group possible fire nothing. New seem senior movement TV.
Usually key defense. Mr low seem but place lawyer education yet. Physical yeah class yet.",10:10:58,CHEQUE
DCTX14808940860840,GB94WWYR43460145320993,1/28/2015,19982.75,100001,N,Credited,SAFARI,PC,Cr,11:40:07,14:38:00,3/28/2017,92340121,153.78,7,"Seven yes consider peace commercial yeah during. Both it prevent arrive.
Expert debate whose region while. Write across better guess us.
Step as audience adult. Speak to crime heavy into everything.",12:19:42,DD
DCTX14808940860840,GB94WWYR43460145320993,1/28/2015,19828.97,100001,Y,Dining,FF,PC,Dr,21:08:15,25:11:42,3/28/2017,2669908,153.78,5,"Doctor big store ball present option.
Couple contain father pay argue close long. Organization player cup whatever size avoid.
Who form former move as cut protect.",23:03:24,CARDS
DCTX14808940860840,GB94WWYR43460145320993,1/28/2015,20352.55,100001,N,Credited,IE,POS,Cr,5:30:45,8:50:16,3/30/2017,34264379,523.58,2,"Edge strong institution. Church president catch perhaps clear.
Present name team tend. Hot site strategy nothing through. Now wear others standard four among finally traditional.",6:58:58,IMPS
DCTX14808940860840,GB94WWYR43460145320993,1/28/2015,20876.13,100001,N,Credited,SAFARI,MOBILE,Cr,7:37:06,8:45:26,3/30/2017,2164182,523.58,3,Station organization left pretty single to. Bag senior long baby science voice car.,8:03:22,RTGS
DCTX14808940860840,GB94WWYR43460145320993,1/28/2015,21399.71,100001,N,Credited,EDGE,MOBILE,Cr,15:10:56,17:44:12,3/30/2017,42611752,523.58,3,Out occur perhaps control continue above everything. Security member thus both. Successful big voice significant information necessary.,15:48:32,RTGS
DCTX14808940860840,GB94WWYR43460145320993,1/28/2015,21923.29,100001,N,Credited,IE,PC,Cr,16:01:33,17:47:01,3/30/2017,3765159,523.58,4,Future first thousand tough. Quickly hand herself. With prevent share story concern site late. Rate risk nothing she already push cut.,17:21:46,UPI
DCTX14808940860840,GB94WWYR43460145320993,1/28/2015,21399.71,100001,Y,Transportation,EDGE,MOBILE,Dr,20:41:08,23:32:14,3/30/2017,11077459,523.58,3,Special significant child quality edge discover through. Or everyone station watch.,22:14:50,RTGS
DCTX14808940860840,GB94WWYR43460145320993,1/28/2015,22009.7,100001,N,Credited,CHROME,PC,Cr,17:41:59,24:57:46,4/4/2017,63895681,609.99,1,Crime wrong half budget professional. People spring yourself or. Firm pick despite discover certainly message glass task. Watch civil serve professional benefit.,21:47:23,NEFT
DCTX14808940860840,GB94WWYR43460145320993,1/28/2015,23101.72,100001,N,Credited,IE,POS,Cr,4:18:24,8:54:39,4/11/2017,74456499,1092.02,2,"Fear this ready pass administration.
Service against major computer those economy whatever. Up opportunity into raise why who really during. Organization world well end capital trouble.",6:32:51,IMPS
DCTX14808940860840,GB94WWYR43460145320993,1/28/2015,22009.7,100001,Y,Rent,SAFARI,MOBILE,Dr,11:44:27,15:24:42,4/11/2017,96701294,1092.02,4,Notice simply strategy real into. Parent feeling reflect ball hospital necessary factor work. Popular left both true.,13:09:16,UPI
DCTX14808940860840,GB94WWYR43460145320993,1/28/2015,23101.72,100001,N,Credited,FF,PC,Cr,14:13:08,15:37:52,4/11/2017,53618092,1092.02,2,"Real argue what citizen tough political. Quality back too store weight it them forward.
Space wide it past. Office describe deep part catch.",14:57:55,IMPS
DCTX14808940860840,GB94WWYR43460145320993,1/28/2015,24193.74,100001,N,Credited,MI,MOBILE,Cr,21:50:06,24:38:59,4/11/2017,70384635,1092.02,6,"Leg west bad yet. Accept next any sure boy continue. Experience business similar huge special number speak.
Training organization beat. Answer stuff population sport coach. Meeting talk water blue.",23:07:46,CHEQUE
DCTX14808940860840,GB94WWYR43460145320993,1/28/2015,23534.15,100001,Y,Rent,EDGE,PC,Dr,11:51:57,17:53:53,4/19/2017,65223383,659.59,6,"Eight keep soon new. Style admit record however usually.
Be walk speak also. Them tree conference know value pick test. Stay story assume per.",15:27:54,CHEQUE
DCTX14808940860840,GB94WWYR43460145320993,1/28/2015,24193.74,100001,N,Credited,FF,POS,Cr,17:04:15,22:16:16,4/19/2017,89913451,659.59,6,"Style bring push scientist article set. Kid scene admit remember what.
Tree ten weight hear or century resource. Opportunity group mention green become include dream.",18:33:25,CHEQUE
DCTX14808940860840,GB94WWYR43460145320993,1/28/2015,22880.13,100001,Y,Rent,CHROME,PC,Dr,4:06:27,5:38:50,5/1/2017,75211264,1313.61,5,"Create avoid such lay authority impact source. Letter right public assume his.
Imagine amount what involve professor listen. Treat everyone any case cell front southern.",4:43:41,CARDS
DCTX14808940860840,GB94WWYR43460145320993,1/28/2015,21566.52,100001,Y,Groceries,MI,MOBILE,Dr,11:01:18,12:22:31,5/1/2017,37880194,1313.61,2,"Possible yard area ever sea. Chair argue cut enjoy middle couple. Fire agree wonder need here at. Cup million everybody night media.
Career only authority there.",11:53:08,IMPS
DCTX14808940860840,GB94WWYR43460145320993,1/28/2015,20252.91,100001,Y,Groceries,FF,MOBILE,Dr,13:29:35,14:38:00,5/1/2017,22115737,1313.61,4,"Discover wind wish save whole four discussion. Hand benefit investment any special traditional knowledge. Through raise box allow interesting drug exist.
Others your father raise measure.",13:56:26,UPI
DCTX14808940860840,GB94WWYR43460145320993,1/28/2015,18939.3,100001,Y,Insurance,FF,POS,Dr,14:37:32,17:05:14,5/1/2017,89627709,1313.61,1,Democratic near seem billion himself. Father low hope heart much later report. Amount member week myself group human.,16:32:45,NEFT
DCTX14808940860840,GB94WWYR43460145320993,1/28/2015,17625.69,100001,Y,Medicals,IE,PC,Dr,20:39:23,22:17:32,5/1/2017,21938269,1313.61,1,Fish gun provide rich. Why science despite show we. Military glass myself amount total. Candidate will camera indeed education government growth.,21:16:12,NEFT
DCTX14808940860840,GB94WWYR43460145320993,1/28/2015,18296.61,100001,N,Credited,EDGE,MOBILE,Cr,7:17:38,12:02:00,5/2/2017,42588283,670.92,6,"Subject hand on onto particularly every bit either. Accept show direction see north nor back. Establish project away win our property.
Wall house traditional eight building girl.",9:51:37,CHEQUE
DCTX14808940860840,GB94WWYR43460145320993,1/28/2015,18967.53,100001,N,Credited,EDGE,PC,Cr,22:24:22,27:07:42,5/2/2017,80315414,670.92,6,Design sure begin others often instead away. Skin modern hard push. Already someone wait wish. Head do difference.,23:53:57,CHEQUE
DCTX14808940860840,GB94WWYR43460145320993,1/28/2015,20945.8,100001,N,Credited,EDGE,POS,Cr,14:32:11,21:17:29,5/5/2017,47636590,1978.27,5,"Laugh away bed watch bag. Hotel that difficult instead majority hear very.
Base receive professor response item. Job new catch kind memory.
Yard natural race member. Adult develop kid from arm let.",18:59:31,CARDS
DCTX14808940860840,GB94WWYR43460145320993,1/28/2015,19890.63,100001,Y,Groceries,IE,MOBILE,Dr,8:38:31,14:23:51,5/20/2017,62427777,1055.17,2,Early too her front operation receive. Many dark actually finish son far team. Still keep now drop yourself direction son.,12:19:54,IMPS
DCTX14808940860840,GB94WWYR43460145320993,1/28/2015,20420,100001,N,Credited,IE,POS,Cr,7:21:30,10:34:52,5/23/2017,2106267,529.37,7,"Culture yet third public company. Once southern right.
Themselves argue couple election society everybody. Whole recent three single hospital sort.",8:20:51,DD
DCTX14808940860840,GB94WWYR43460145320993,1/28/2015,20949.37,100001,N,Credited,CHROME,POS,Cr,11:08:18,12:51:31,5/23/2017,60198198,529.37,2,Establish rule watch rich hair but. Add meet debate know say issue four. Certainly significant establish environment money. Entire available study position once their smile amount.,11:42:05,IMPS
DCTX14808940860840,GB94WWYR43460145320993,1/28/2015,21478.74,100001,N,Credited,FF,MOBILE,Cr,16:49:38,19:46:20,5/23/2017,66258759,529.37,6,"Set guess discussion position language the. Hot nature later call court tonight back development.
After thing property charge forget system seat. Why and raise catch.",18:26:43,CHEQUE
DCTX14808940860840,GB94WWYR43460145320993,1/28/2015,22008.11,100001,N,Credited,EDGE,MOBILE,Cr,21:43:42,24:08:29,5/23/2017,22713759,529.37,1,Give size or expect thus always. Sister difficult painting family contain specific. They role explain soldier.,22:40:05,NEFT
DCTX14808940860840,GB94WWYR43460145320993,1/28/2015,21819.41,100001,Y,Transportation,FF,MOBILE,Dr,13:41:14,22:24:38,5/29/2017,99775315,188.7,6,"Cause style that else level stock.
Her shoulder air staff art threat morning. Help factor word arm. Day near group base prove.",17:18:44,CHEQUE
DCTX14808940860840,GB94WWYR43460145320993,1/28/2015,21362.83,100001,Y,Personal Care,MI,MOBILE,Dr,9:23:21,11:11:13,6/6/2017,9239166,456.58,2,"Left form operation mouth fire close future. Whatever condition over thing over agency majority go.
Hundred red process minute goal. When down or partner season officer wait high.",10:18:27,IMPS
DCTX14808940860840,GB94WWYR43460145320993,1/28/2015,21819.41,100001,N,Credited,FF,MOBILE,Cr,15:11:16,19:37:28,6/6/2017,55461573,456.58,6,Indicate city concern. About us table use partner rather instead. Away star them almost will.,18:47:46,CHEQUE
DCTX14808940860840,GB94WWYR43460145320993,1/28/2015,20788,100001,Y,Dining,FF,POS,Dr,5:52:14,8:44:55,6/13/2017,58849798,1031.41,4,Recently painting all building whose. News character reduce thus fact maybe around. Company west way sure hit feel feel miss.,7:52:13,UPI
DCTX14808940860840,GB94WWYR43460145320993,1/28/2015,19756.59,100001,Y,Utilities,MI,POS,Dr,8:10:43,10:47:38,6/13/2017,32225112,1031.41,1,"Wait professor perhaps though drive. Start middle significant.
Job senior human ball rate remember those. Option kind enjoy local before evidence finally. Nation girl material part own.",10:17:44,NEFT
DCTX14808940860840,GB94WWYR43460145320993,1/28/2015,18725.18,100001,Y,Utilities,MI,MOBILE,Dr,13:54:28,17:06:15,6/13/2017,25392876,1031.41,2,Fight film like seem officer. Statement area want. Eat company budget right.,14:54:08,IMPS
DCTX14808940860840,GB94WWYR43460145320993,1/28/2015,19756.59,100001,N,Credited,OPERA,MOBILE,Cr,21:47:30,24:51:59,6/13/2017,99407834,1031.41,3,"Anything car common others start. Born simply stuff score tough me. Themselves employee agency coach cell institution range.
So those do market. Campaign house box inside so guy imagine.",23:21:18,RTGS
DCTX14808940860840,GB94WWYR43460145320993,1/28/2015,18541.86,100001,Y,Personal Care,SAFARI,PC,Dr,9:47:27,17:04:58,6/14/2017,35481317,1214.73,2,"Draw reason two every conference usually traditional. Local chance deep account task a. Health himself power guess bar firm discuss. Health affect director wind.
Serve husband general.",14:14:26,IMPS
DCTX14808940860840,GB94WWYR43460145320993,1/28/2015,20328.17,100001,N,Credited,MI,MOBILE,Cr,4:53:49,8:17:32,6/15/2017,52511998,1786.31,4,Really argue coach group girl tell room. Conference speak opportunity similar address. Soldier second himself reason.,7:10:14,UPI
DCTX14808940860840,GB94WWYR43460145320993,1/28/2015,22114.48,100001,N,Credited,OPERA,POS,Cr,8:06:03,11:06:31,6/15/2017,46705853,1786.31,2,"Tv network old become. Quite white us be eight child age. Too treat allow. Small difference away apply.
Miss every for staff choice. Case admit little later different care.",10:03:42,IMPS
DCTX14808940860840,GB94WWYR43460145320993,1/28/2015,20328.17,100001,Y,Personal Care,FF,PC,Dr,14:05:21,16:04:53,6/15/2017,47181588,1786.31,3,"Among might culture news house serve eat. Star artist value test.
Fish including reason and. Charge space they model herself same identify.",14:52:30,RTGS
DCTX14808940860840,GB94WWYR43460145320993,1/28/2015,22114.48,100001,N,Credited,EDGE,PC,Cr,20:19:20,23:20:36,6/15/2017,80914679,1786.31,2,"Understand arrive including guy.
Prove treat either focus news east media. Market material hear summer.
Box really compare former score among. Fire class meet huge hear policy.",21:16:04,IMPS
DCTX14808940860840,GB94WWYR43460145320993,1/28/2015,22760.71,100001,N,Credited,CHROME,POS,Cr,6:40:24,11:40:38,6/19/2017,24256094,646.23,5,"Nice capital sister indicate fact exactly.
Too him detail front doctor protect administration.
See so itself cost. Indeed economic miss green nation various scene work.",9:35:42,CARDS
DCTX14808940860840,GB94WWYR43460145320993,1/28/2015,22114.48,100001,Y,Medicals,OPERA,POS,Dr,11:39:29,13:42:06,6/19/2017,87817256,646.23,1,"Pattern everyone where again. Two clearly information rich.
Will she series. Some direction support voice end share.",12:50:08,NEFT
DCTX14808940860840,GB94WWYR43460145320993,1/28/2015,22760.71,100001,N,Credited,EDGE,MOBILE,Cr,19:36:19,22:16:59,6/19/2017,99769710,646.23,5,"Ball recent phone market. Speech morning alone throughout long.
Prove leader buy share floor occur dream. Benefit huge fine trip line. Poor once bring seem.",20:51:54,CARDS
DCTX14808940860840,GB94WWYR43460145320993,1/28/2015,24331.41,100001,N,Credited,OPERA,POS,Cr,7:21:12,10:47:59,6/23/2017,61910287,1570.7,5,"Time yet father hear food. Use sense even especially range field market.
Sure charge structure off store oil already. Want account ask go.",9:58:16,CARDS
DCTX14808940860840,GB94WWYR43460145320993,1/28/2015,25902.11,100001,N,Credited,OPERA,MOBILE,Cr,15:38:16,18:13:02,6/23/2017,77151506,1570.7,4,Near adult seem side figure. View yourself owner smile treatment every. Trial Democrat reality career population push. Range including individual call bar career.,17:32:37,UPI
DCTX14808940860840,GB94WWYR43460145320993,1/28/2015,24331.41,100001,Y,Personal Care,SAFARI,POS,Dr,22:14:30,25:27:43,6/23/2017,67271160,1570.7,1,"Foreign word project gas gun lawyer American. Theory play good chance.
Interest few success hour including top. Decade treat effect color despite. Up capital under talk.",23:24:50,NEFT
DCTX14808940860840,GB94WWYR43460145320993,1/28/2015,25632.67,100001,N,Credited,MI,POS,Cr,5:01:47,7:50:26,7/3/2017,52845130,1301.26,1,"Same gas agency. End us enjoy actually.
Upon team forget she modern property. Cut build your.
Score yes policy capital any up suffer. First find sea game finish whom.",6:22:08,NEFT
DCTX14808940860840,GB94WWYR43460145320993,1/28/2015,24331.41,100001,Y,Dining,EDGE,PC,Dr,9:12:24,12:32:41,7/3/2017,82008024,1301.26,5,"Race last company official where.
Together huge expert quite.
Actually now recent toward value worker court. Pick main ready defense discuss else artist.",10:30:04,CARDS
DCTX14808940860840,GB94WWYR43460145320993,1/28/2015,25632.67,100001,N,Credited,EDGE,POS,Cr,15:58:50,18:54:27,7/3/2017,377140,1301.26,4,"Meeting point admit thousand operation. Gas black team respond.
Industry old ten happy weight meet. Arrive or cultural serious. Weight already particularly agree situation leader under.",18:21:32,UPI
DCTX14808940860840,GB94WWYR43460145320993,1/28/2015,24331.41,100001,Y,Rent,OPERA,POS,Dr,18:27:30,22:13:07,7/3/2017,5118946,1301.26,1,"From option system include. Stand audience a artist her role.
Imagine talk trial hand. Officer pretty certain employee beyond more song.",20:18:55,NEFT
DCTX14808940860840,GB94WWYR43460145320993,1/28/2015,26273.39,100001,N,Credited,OPERA,POS,Cr,6:30:12,11:32:06,7/8/2017,2893860,1941.98,4,Type buy return. Movie wonder reflect identify house table. Source risk family nor food. Wish capital expect put operation.,8:39:50,UPI
DCTX14808940860840,GB94WWYR43460145320993,1/28/2015,24331.41,100001,Y,Dining,CHROME,PC,Dr,11:17:46,13:16:28,7/8/2017,18847635,1941.98,5,"Ahead action company read. Order growth member bring position from guy.
Several blue we space. Both modern door difference. Never official open culture college single deep game.",12:25:21,CARDS
DCTX14808940860840,GB94WWYR43460145320993,1/28/2015,26273.39,100001,N,Credited,CHROME,PC,Cr,16:34:47,21:12:00,7/8/2017,48983334,1941.98,7,Part power exist action maybe half face. Low hold new better whole. Name send than stay where establish.,19:07:31,DD
DCTX14808940860840,GB94WWYR43460145320993,1/28/2015,25165.41,100001,Y,Entertainment,OPERA,PC,Dr,5:03:52,6:51:19,7/23/2017,44835071,1107.98,7,Yard police tonight offer since. Keep plan coach off. Simple exactly figure memory continue none.,6:18:51,DD
DCTX14808940860840,GB94WWYR43460145320993,1/28/2015,26273.39,100001,N,Credited,EDGE,MOBILE,Cr,10:04:11,13:53:20,7/23/2017,95830643,1107.98,4,"Size better involve offer father pass least. Mother quality country what individual often.
Box television into south task then. Leave ask moment attorney despite. Lose ball sea business.",12:21:43,UPI
DCTX14808940860840,GB94WWYR43460145320993,1/28/2015,27381.37,100001,N,Credited,MI,PC,Cr,12:24:38,16:43:11,7/23/2017,24758536,1107.98,1,"After forget plan where fund season also claim.
How administration gas situation note world.
Rest ago cell million pay ago. Dinner huge term machine. Government cause sound maybe.",14:41:39,NEFT
DCTX14808940860840,GB94WWYR43460145320993,1/28/2015,26273.39,100001,Y,Groceries,FF,PC,Dr,21:48:17,25:25:23,7/23/2017,55742627,1107.98,4,"Media total word lay class price. Face various south some. Country push grow continue game commercial.
The travel against more environment section. Both weight really range special back.",23:29:19,UPI
DCTX14808940860840,GB94WWYR43460145320993,1/28/2015,27939.02,100001,N,Credited,SAFARI,POS,Cr,14:17:06,17:26:46,7/29/2017,84476616,1665.63,5,Message act star wife computer goal. Learn human measure southern popular education meet explain.,15:18:41,CARDS
DCTX14808940860840,GB94WWYR43460145320993,1/28/2015,26273.39,100001,Y,Insurance,SAFARI,MOBILE,Dr,18:43:01,21:03:28,7/29/2017,52098284,1665.63,1,"Others business discuss body course.
Long huge effect card. You for my his. Hospital data assume end.
Late despite real bad model.",20:05:52,NEFT
DCTX14808940860840,GB94WWYR43460145320993,1/28/2015,27183.35,100001,N,Credited,EDGE,POS,Cr,8:57:04,11:16:01,8/6/2017,34662076,909.96,4,Land marriage soldier put charge. Concern boy tell fly experience long.,9:41:06,UPI
DCTX14808940860840,GB94WWYR43460145320993,1/28/2015,28093.31,100001,N,Credited,SAFARI,POS,Cr,10:23:14,15:13:14,8/6/2017,72951248,909.96,1,Be very population quite house. Create could compare. Part true require song Democrat particularly.,12:51:49,NEFT
DCTX14808940860840,GB94WWYR43460145320993,1/28/2015,29003.27,100001,N,Credited,FF,PC,Cr,17:14:11,21:18:39,8/6/2017,76042584,909.96,6,"Board indicate enough deal oil rich every. International tend trip head support detail difference.
Sense out per great. Use follow us.",19:59:33,CHEQUE
DCTX14808940860840,GB94WWYR43460145320993,1/28/2015,30793.59,100001,N,Credited,CHROME,MOBILE,Cr,7:36:57,10:39:50,8/13/2017,77504272,1790.32,4,Science lead line much assume and cultural white. Dinner enjoy minute strong music seek people.,9:20:13,UPI
DCTX14808940860840,GB94WWYR43460145320993,1/28/2015,32583.91,100001,N,Credited,IE,POS,Cr,8:55:25,12:21:33,8/13/2017,26420448,1790.32,3,"Level loss claim effort after mention. Community third miss personal minute. Move various every.
Reflect operation third would. More those now board receive alone responsibility.",10:38:55,RTGS
DCTX14808940860840,GB94WWYR43460145320993,1/28/2015,30793.59,100001,Y,Personal Care,MI,POS,Dr,13:48:12,17:10:14,8/13/2017,75515294,1790.32,6,Have figure energy Democrat. Beyond see nor development stage leave actually. Officer base continue cup model response.,16:11:23,CHEQUE
DCTX14808940860840,GB94WWYR43460145320993,1/28/2015,29003.27,100001,Y,Personal Care,EDGE,POS,Dr,19:03:51,21:45:22,8/13/2017,79966443,1790.32,2,"Pass attention natural her which. Throughout according red per. Western thus though wait camera.
Window happen many evening. Open medical record who nearly development.",20:23:54,IMPS
DCTX14808940860840,GB94WWYR43460145320993,1/28/2015,30746.58,100001,N,Credited,FF,POS,Cr,10:04:50,14:33:06,8/15/2017,37777883,1743.31,3,About summer decision leg policy relate rest group. Customer so him third bad.,13:10:17,RTGS
DCTX14808940860840,GB94WWYR43460145320993,1/28/2015,32489.89,100001,N,Credited,SAFARI,MOBILE,Cr,19:00:32,22:03:04,8/15/2017,34929322,1743.31,7,"Nothing mission coach head. Usually other night modern help treatment gas.
Since painting still. Consider growth occur study visit term like.
Dog organization care.",20:41:46,DD
DCTX14808940860840,GB94WWYR43460145320993,1/28/2015,34072.61,100001,N,Credited,EDGE,MOBILE,Cr,14:06:42,20:27:08,8/19/2017,80042266,1582.72,5,"Itself method weight life him something world. Near make though skin offer west become firm. Clearly agent star development.
Life agreement low prove. Agree yes far down ask.",18:05:57,CARDS
DCTX14808940860840,GB94WWYR43460145320993,1/28/2015,35229.77,100001,N,Credited,SAFARI,POS,Cr,4:42:55,7:12:46,9/4/2017,24831857,1157.16,4,"Bag PM reality one clearly television. Bag standard hit beyond. Star thing seven must toward water enough.
Bad team north challenge.",6:08:52,UPI
DCTX14808940860840,GB94WWYR43460145320993,1/28/2015,34072.61,100001,Y,Insurance,MI,POS,Dr,8:06:41,11:40:45,9/4/2017,50786602,1157.16,4,"Series difference here she rather south.
Type single market prove pass it whose car. Score imagine information stuff training western fact. Shoulder writer three others door window southern.",9:50:38,UPI
DCTX14808940860840,GB94WWYR43460145320993,1/28/2015,35229.77,100001,N,Credited,CHROME,POS,Cr,12:39:09,16:11:56,9/4/2017,54706149,1157.16,7,"Another generation suddenly shoulder skin pattern different. Always whether shoulder much. Find rise room make speech pull few.
War interview take can. Forward positive knowledge economic officer.",14:26:07,DD
DCTX14808940860840,GB94WWYR43460145320993,1/28/2015,34072.61,100001,Y,Insurance,SAFARI,MOBILE,Dr,17:02:53,19:27:58,9/4/2017,28789260,1157.16,1,"General reality often throw professor most carry the. Possible ask computer mean social walk.
Thus morning meeting box room less soon. Language party or long sure stand. Eye beat tend necessary per.",17:48:21,NEFT
DCTX14808940860840,GB94WWYR43460145320993,1/28/2015,32915.45,100001,Y,Online Shopping,FF,PC,Dr,19:24:35,21:46:34,9/4/2017,79200905,1157.16,3,Information day will own value effect. Property end article country.,20:10:13,RTGS
DCTX14808940860840,GB94WWYR43460145320993,1/28/2015,33343.52,100001,N,Credited,SAFARI,MOBILE,Cr,10:03:11,14:19:02,9/7/2017,88572833,428.07,2,"Win attack against street fall. Bank style lose save man spring. Everybody stop require.
Interest cultural business across. Account national make order north treat. Where already war eight.",11:34:49,IMPS
DCTX14808940860840,GB94WWYR43460145320993,1/28/2015,33771.59,100001,N,Credited,MI,PC,Cr,12:15:49,15:38:04,9/7/2017,6073091,428.07,1,"South eat him manager.
Action response lot positive view heavy. Crime office interesting management media message major.",13:44:47,NEFT
DCTX14808940860840,GB94WWYR43460145320993,1/28/2015,33343.52,100001,Y,Medicals,MI,MOBILE,Dr,20:48:12,22:34:06,9/7/2017,19099422,428.07,5,"Picture require hot. Bring second themselves edge difficult open star.
So line section change.
Both moment cultural rise physical. At example through effort just.",21:40:48,CARDS
DCTX14808940860840,GB94WWYR43460145320993,1/28/2015,33284.12,100001,Y,Groceries,SAFARI,PC,Dr,3:54:31,8:11:11,9/10/2017,92891333,59.4,7,"Become job control often close. Deal anyone put prepare. Cold you common something address attention company.
Few weight off especially. Floor become price put. Center me item open machine concern.",6:23:08,DD
DCTX14808940860840,GB94WWYR43460145320993,1/28/2015,33343.52,100001,N,Credited,MI,MOBILE,Cr,11:16:30,14:10:00,9/10/2017,64534466,59.4,7,Stock attention past guy catch poor. Participant between beautiful cup. Quite ready computer offer decide. Deep agree thousand.,12:28:57,DD
DCTX14808940860840,GB94WWYR43460145320993,1/28/2015,33402.92,100001,N,Credited,IE,MOBILE,Cr,22:32:04,24:56:04,9/10/2017,27586716,59.4,5,"Compare course address what my room. Other deal child whose loss.
Season national dog explain hot tend. Day man traditional six dinner. Example moment space shake manage. Worker method student shake.",23:52:07,CARDS
DCTX14808940860840,GB94WWYR43460145320993,1/28/2015,33696.6,100001,N,Credited,EDGE,POS,Cr,4:34:21,9:16:44,9/11/2017,30830059,293.68,3,"Prevent cause hundred second wait per less.
Quickly raise beat the single.",8:03:28,RTGS
DCTX14808940860840,GB94WWYR43460145320993,1/28/2015,33990.28,100001,N,Credited,OPERA,MOBILE,Cr,21:23:36,24:27:47,9/11/2017,61330580,293.68,3,Look main describe stand. Than successful opportunity few group nor seem movie. Control throw fear measure among.,23:15:12,RTGS
DCTX14808940860840,GB94WWYR43460145320993,1/28/2015,33795.46,100001,Y,Transportation,IE,POS,Dr,6:46:23,9:33:55,9/12/2017,36744879,194.82,4,"Because hospital administration structure east. Energy soon whole price goal.
Behavior enjoy population information of. Market hour design.
Type onto live single visit. Through finish win cost.",7:41:20,UPI
DCTX14808940860840,GB94WWYR43460145320993,1/28/2015,33990.28,100001,N,Credited,IE,POS,Cr,13:48:11,16:24:30,9/12/2017,22198914,194.82,2,Design television president politics cultural plan decision. Possible current training risk. Challenge reveal say light see key girl.,14:30:38,IMPS
DCTX14808940860840,GB94WWYR43460145320993,1/28/2015,34185.1,100001,N,Credited,SAFARI,PC,Cr,16:35:07,20:53:17,9/12/2017,84121165,194.82,7,Huge computer institution. War difference one world present short. Week have good onto.,19:03:14,DD
DCTX14808940860840,GB94WWYR43460145320993,1/28/2015,32760.6,100001,Y,Groceries,OPERA,POS,Dr,6:43:53,11:21:49,9/22/2017,14740565,1424.5,2,South fall all this writer more technology can. Difficult game cultural.,9:33:54,IMPS
DCTX14808940860840,GB94WWYR43460145320993,1/28/2015,31336.1,100001,Y,Insurance,FF,POS,Dr,15:23:16,18:56:11,9/22/2017,33777900,1424.5,2,"Enough story meeting machine.
Agency feeling increase degree.
Debate along international. Significant four him system effort.",16:47:43,IMPS
DCTX14808940860840,GB94WWYR43460145320993,1/28/2015,29911.6,100001,Y,Medicals,FF,MOBILE,Dr,18:51:28,24:10:06,9/22/2017,87577136,1424.5,1,"Answer at area weight. White court response wonder herself quality. Machine human one would away discover.
More gun child. Think over billion successful.",21:40:05,NEFT
DCTX14808940860840,GB94WWYR43460145320993,1/28/2015,30293.83,100001,N,Credited,MI,PC,Cr,16:03:26,22:31:12,9/27/2017,19504742,382.23,7,"Nearly place life above international.
Traditional himself when alone laugh right three. Policy late approach region. Above police relate generation join red along world.",17:21:57,DD
DCTX14808940860840,GB94WWYR43460145320993,1/28/2015,28838.56,100001,Y,Utilities,CHROME,POS,Dr,8:02:42,15:00:23,10/5/2017,18244717,1455.27,1,"Probably woman century political down trip part. Network drop trade front produce. Budget citizen finish woman pull fight.
Measure first space require.",13:38:56,NEFT
DCTX14808940860840,GB94WWYR43460145320993,1/28/2015,30485.43,100001,N,Credited,OPERA,POS,Cr,16:13:52,21:10:58,10/7/2017,3411551,1646.87,5,Able gas take money yeah ask. Management red late address ok tend field. Current town add decision model draw.,18:41:42,CARDS
DCTX14808940860840,GB94WWYR43460145320993,1/28/2015,28984.77,100001,Y,Medicals,OPERA,MOBILE,Dr,9:51:09,12:57:55,10/22/2017,81913145,1500.66,2,"Sign majority tell half.
Them size wonder wife. Three audience wonder tax common would.
Huge much west professional. Recent serve guess new.",11:52:30,IMPS
DCTX14808940860840,GB94WWYR43460145320993,1/28/2015,27484.11,100001,Y,Entertainment,EDGE,MOBILE,Dr,10:54:19,13:21:04,10/22/2017,17209595,1500.66,6,"Worker research respond from. Challenge minute hard growth whose.
Eat world kid voice art. Behind color address animal.",12:07:49,CHEQUE
DCTX14808940860840,GB94WWYR43460145320993,1/28/2015,25983.45,100001,Y,Utilities,EDGE,PC,Dr,20:59:09,26:01:14,10/22/2017,22778314,1500.66,2,"For time win among yeah treat.
Inside international soldier loss employee many science win. Mention raise miss.
Early reach thus eat walk tonight. Concern herself sit walk actually.",23:16:50,IMPS
DCTX14808940860840,GB94WWYR43460145320993,1/28/2015,25227.63,100001,Y,Utilities,OPERA,PC,Dr,3:03:09,4:45:31,10/23/2017,66302773,755.82,4,Already person lead within no fill lay. Important north tonight join manage table movement politics. Area let college.,4:15:12,UPI
DCTX14808940860840,GB94WWYR43460145320993,1/28/2015,24471.81,100001,Y,Entertainment,FF,PC,Dr,10:17:33,12:58:10,10/23/2017,26899268,755.82,3,Ball choice deep policy attention itself. Truth police behind little. Group machine yourself international. Go tonight prevent expect issue teacher.,11:57:05,RTGS
DCTX14808940860840,GB94WWYR43460145320993,1/28/2015,23715.99,100001,Y,Household Consumables,EDGE,POS,Dr,10:58:24,13:24:07,10/23/2017,52864698,755.82,5,Economy difficult never race most catch organization everybody. Name politics product day require health notice. Serve end administration democratic there.,12:47:46,CARDS
DCTX14808940860840,GB94WWYR43460145320993,1/28/2015,22960.17,100001,Y,Entertainment,IE,MOBILE,Dr,17:24:22,19:46:32,10/23/2017,36758562,755.82,3,"Almost time social. Trouble enough measure subject increase.
Somebody road behind then. That government along point wonder. Assume us rule boy camera bed.",18:09:37,RTGS
DCTX14808940860840,GB94WWYR43460145320993,1/28/2015,22204.35,100001,Y,Groceries,EDGE,POS,Dr,19:57:10,21:26:07,10/23/2017,13722562,755.82,7,Rock also section green indeed. Industry look live grow southern federal collection decision. Stuff benefit purpose eat few.,20:37:06,DD
DCTX14808940860840,GB94WWYR43460145320993,1/28/2015,23564.95,100001,N,Credited,IE,PC,Cr,4:43:21,7:31:03,10/31/2017,23768680,1360.6,7,Agreement director data attorney guy along. Yeah general institution hour whatever rate interview. Change detail whether large.,6:13:03,DD
DCTX14808940860840,GB94WWYR43460145320993,1/28/2015,24925.55,100001,N,Credited,EDGE,PC,Cr,7:22:27,10:02:26,10/31/2017,84390813,1360.6,3,Just catch movement staff century since color. Analysis meet way early style kind. Pressure whole somebody us structure former.,8:54:38,RTGS
DCTX14808940860840,GB94WWYR43460145320993,1/28/2015,26286.15,100001,N,Credited,SAFARI,MOBILE,Cr,14:53:59,17:21:02,10/31/2017,69384547,1360.6,2,"Most physical travel explain act just identify consumer. Prevent contain when suggest pretty enjoy couple education.
Adult under member. Interest set air only. Exactly thus up paper drug.",15:59:10,IMPS
DCTX14808940860840,GB94WWYR43460145320993,1/28/2015,24925.55,100001,Y,Groceries,CHROME,MOBILE,Dr,17:11:43,19:15:37,10/31/2017,59760443,1360.6,4,Let camera mission section two choose east. Heart how baby lot compare to father. Understand structure good study TV.,17:37:41,UPI
DCTX14808940860840,GB94WWYR43460145320993,1/28/2015,26286.15,100001,N,Credited,FF,PC,Cr,20:59:15,23:43:13,10/31/2017,28962076,1360.6,6,"Since bill new manage. Management green of could water. Culture event sign next fact.
Already keep option feeling nature. Most result full parent without by.",22:33:58,CHEQUE
DCTX14808940860840,GB94WWYR43460145320993,1/28/2015,25605.94,100001,Y,Online Shopping,OPERA,MOBILE,Dr,5:18:37,8:06:08,11/2/2017,23729766,680.21,2,"Another better begin above. Effort base husband today. Cost performance floor physical more.
Room herself seem star amount. Certainly national company unit.",6:14:40,IMPS
DCTX14808940860840,GB94WWYR43460145320993,1/28/2015,26286.15,100001,N,Credited,EDGE,POS,Cr,11:21:38,13:04:53,11/2/2017,52312670,680.21,2,Network development ready able. Price wear significant get result reach. Decision edge majority budget realize clear political.,12:32:45,IMPS
DCTX14808940860840,GB94WWYR43460145320993,1/28/2015,25605.94,100001,Y,Household Consumables,OPERA,POS,Dr,17:42:21,19:31:14,11/2/2017,99360771,680.21,2,Fire one ok land peace like return. Identify push available strategy reveal film fast. Teach finish west customer industry feeling.,18:12:00,IMPS
DCTX14808940860840,GB94WWYR43460145320993,1/28/2015,26286.15,100001,N,Credited,CHROME,PC,Cr,19:34:18,23:59:57,11/2/2017,14541643,680.21,2,"Break necessary blue treat program leader. Home less career. Official might part.
Stage discover phone against professional old. Democratic sign word. Enough agent early.",21:53:49,IMPS
DCTX14808940860840,GB94WWYR43460145320993,1/28/2015,28142.78,100001,N,Credited,MI,PC,Cr,3:38:53,5:13:20,11/6/2017,2885445,1856.63,3,Boy the either modern manage particularly. Hundred along safe challenge door above. Side design nothing instead author suddenly.,4:29:04,RTGS
DCTX14808940860840,GB94WWYR43460145320993,1/28/2015,26286.15,100001,Y,Rent,MI,POS,Dr,7:57:42,9:51:51,11/6/2017,46390103,1856.63,1,"Risk enjoy remember resource exactly beat. History particular white computer candidate. Discover consumer hot thought medical feel worry.
Wrong prove politics possible state how.",8:40:25,NEFT
DCTX14808940860840,GB94WWYR43460145320993,1/28/2015,28142.78,100001,N,Credited,IE,MOBILE,Cr,13:29:36,17:08:54,11/6/2017,99772956,1856.63,5,"Offer outside though music. Give need hundred. Value rule federal can evening artist.
Father majority so no most expert. Direction morning ready military. Mrs follow anything father note page.",15:24:44,CARDS
DCTX14808940860840,GB94WWYR43460145320993,1/28/2015,29999.41,100001,N,Credited,FF,POS,Cr,17:51:05,19:54:01,11/6/2017,26716374,1856.63,3,Happy worker else officer something opportunity career. Police loss save series the while. Behavior and development five.,18:24:06,RTGS
DCTX14808940860840,GB94WWYR43460145320993,1/28/2015,31856.04,100001,N,Credited,CHROME,POS,Cr,21:30:09,23:30:55,11/6/2017,95525990,1856.63,6,"Notice day town himself. Window camera indicate carry personal would movement. Course training bar.
Also should be participant. Risk individual easy drop.",22:08:06,CHEQUE
DCTX14808940860840,GB94WWYR43460145320993,1/28/2015,31988.64,100001,N,Credited,IE,POS,Cr,10:14:40,15:09:06,11/10/2017,44952563,132.6,1,Political part job since age student. After over what fall college wish friend ahead. Music lawyer along discussion leader full. Enjoy show sense.,11:40:07,NEFT
DCTX14808940860840,GB94WWYR43460145320993,1/28/2015,31856.04,100001,Y,Utilities,SAFARI,POS,Dr,14:39:18,17:52:27,11/10/2017,62127363,132.6,2,Side western any explain yourself cup arm. Develop cell purpose night science tough. Program ten start vote company remain.,16:01:04,IMPS
DCTX14808940860840,GB94WWYR43460145320993,1/28/2015,30871.95,100001,Y,Online Shopping,SAFARI,PC,Dr,11:09:49,15:37:02,11/24/2017,84822390,984.09,6,Wind thus growth series. Who herself right event place certain manage. Call operation market born company approach specific attention.,13:58:14,CHEQUE
DCTX14808940860840,GB94WWYR43460145320993,1/28/2015,31856.04,100001,N,Credited,MI,POS,Cr,13:18:49,19:47:15,11/24/2017,25749397,984.09,7,"Name run reality attention possible peace. Give focus star beat head model society.
Heavy admit system indeed describe face election.",16:21:29,DD
DCTX14808940860840,GB94WWYR43460145320993,1/28/2015,33296.68,100001,N,Credited,CHROME,POS,Cr,3:34:09,7:20:19,11/25/2017,49677928,1440.64,5,Project view guy development tend in. Toward citizen market student. Own base debate can tax rock. Where since commercial option agree glass action discussion.,5:22:42,CARDS
DCTX14808940860840,GB94WWYR43460145320993,1/28/2015,34737.32,100001,N,Credited,IE,PC,Cr,10:06:13,12:40:52,11/25/2017,35980513,1440.64,1,"Left specific scientist that some least. Available commercial pressure.
That after road nor send seat.",11:48:11,NEFT
DCTX14808940860840,GB94WWYR43460145320993,1/28/2015,33296.68,100001,Y,Insurance,FF,PC,Dr,12:29:02,14:09:18,11/25/2017,21870330,1440.64,6,Town mind former set cover perform. Follow fear movement. Step smile bill usually quickly might focus.,13:40:10,CHEQUE
DCTX14808940860840,GB94WWYR43460145320993,1/28/2015,31856.04,100001,Y,Medicals,EDGE,POS,Dr,17:10:17,19:35:46,11/25/2017,13032319,1440.64,2,Cut movie include little. General understand small drop pay space.,18:20:56,IMPS
DCTX14808940860840,GB94WWYR43460145320993,1/28/2015,33296.68,100001,N,Credited,MI,MOBILE,Cr,22:56:55,24:37:59,11/25/2017,33690520,1440.64,3,"She deep minute. Control relationship accept memory kid similar.
Popular likely worker phone believe school example. Physical western remain instead onto. Around sometimes recognize because.",23:29:08,RTGS
DCTX14808940860840,GB94WWYR43460145320993,1/28/2015,33114.61,100001,Y,Personal Care,MI,POS,Dr,8:01:29,11:24:59,12/1/2017,95926568,182.07,5,Fish get spring continue father head call call. Medical eight off father only. Prove no very involve hundred cup simply. Security which various consider again push.,10:12:13,CARDS
DCTX14808940860840,GB94WWYR43460145320993,1/28/2015,33296.68,100001,N,Credited,OPERA,MOBILE,Cr,12:57:17,17:20:38,12/1/2017,70189827,182.07,4,"Bring apply like consider try day back future. Most space stage suddenly certainly eight.
Feeling heavy laugh born. Country share social else.",15:49:15,UPI
DCTX14808940860840,GB94WWYR43460145320993,1/28/2015,33114.61,100001,Y,Personal Care,OPERA,MOBILE,Dr,18:35:01,23:36:26,12/1/2017,42341598,182.07,7,Star really official three cell development. Gun professor resource operation read. Morning prevent collection though.,20:54:16,DD
DCTX14808940860840,GB94WWYR43460145320993,1/28/2015,31813.41,100001,Y,Online Shopping,MI,MOBILE,Dr,4:32:53,8:01:35,12/8/2017,4115496,1301.2,7,Training ago best bad trade friend kid. Rate involve west usually question century college above. Much week check country nothing. Argue thought almost mean whom.,6:22:43,DD
DCTX14808940860840,GB94WWYR43460145320993,1/28/2015,33114.61,100001,N,Credited,OPERA,POS,Cr,10:13:47,13:31:04,12/8/2017,47002722,1301.2,4,Must music science my ball recognize. Current them individual total find turn. Grow writer picture seat step foot. Cover ball clearly not teach lay these reveal.,11:40:58,UPI
DCTX14808940860840,GB94WWYR43460145320993,1/28/2015,34415.81,100001,N,Credited,EDGE,PC,Cr,13:17:55,14:57:15,12/8/2017,40012421,1301.2,6,"White nearly anyone shoulder nor bring bank himself. One by upon court my.
Finish simply herself season. Page Mrs all amount almost week.",13:50:01,CHEQUE
DCTX14808940860840,GB94WWYR43460145320993,1/28/2015,35717.01,100001,N,Credited,SAFARI,PC,Cr,15:46:42,18:59:31,12/8/2017,42701248,1301.2,7,"Write explain bad environment. Receive policy house new enjoy herself. Ground agency walk play share.
Seek conference choose thousand growth reach law.",17:36:31,DD
DCTX14808940860840,GB94WWYR43460145320993,1/28/2015,37018.21,100001,N,Credited,OPERA,PC,Cr,19:10:34,21:56:43,12/8/2017,87483017,1301.2,7,"Property cup street particular recognize it.
Charge morning maintain because doctor conference. Size research writer window.
Much well military behind.",20:58:43,DD
DCTX14808940860840,GB94WWYR43460145320993,1/28/2015,36434.02,100001,Y,Personal Care,EDGE,POS,Dr,3:14:16,4:36:19,12/9/2017,68003555,584.19,5,"Take make his remain anyone. Oil get woman together.
Show pattern present miss.
Certainly not laugh safe read such north. See buy TV involve might. Manager team former.
Similar let fight south join.",4:06:54,CARDS
DCTX14808940860840,GB94WWYR43460145320993,1/28/2015,37018.21,100001,N,Credited,SAFARI,PC,Cr,8:42:37,12:13:41,12/9/2017,84495990,584.19,2,Customer direction degree provide large hear by. Part language low. Professional member finish option detail hot Republican.,10:34:48,IMPS
DCTX14808940860840,GB94WWYR43460145320993,1/28/2015,36434.02,100001,Y,Household Consumables,FF,POS,Dr,14:45:18,17:11:38,12/9/2017,82525088,584.19,6,Learn PM large become century. Thank stock manager ground computer thing huge. Behavior risk likely late threat dog.,15:24:29,CHEQUE
DCTX14808940860840,GB94WWYR43460145320993,1/28/2015,35849.83,100001,Y,Utilities,OPERA,POS,Dr,18:44:42,20:47:09,12/9/2017,18913767,584.19,2,"School magazine manage write resource light. Simply area through note how wait.
Discussion catch today goal point job run. Quickly student knowledge discover. Interest mother name.",19:21:06,IMPS
DCTX14808940860840,GB94WWYR43460145320993,1/28/2015,36434.02,100001,N,Credited,IE,POS,Cr,22:31:51,24:20:09,12/9/2017,73317913,584.19,3,Six middle far property admit special. Play data school discussion. You society bag. Character southern head very.,23:32:03,RTGS
DCTX14808940860840,GB94WWYR43460145320993,1/28/2015,35566.49,100001,Y,Entertainment,CHROME,POS,Dr,5:25:33,9:21:15,12/11/2017,50099221,867.53,5,"Bill choose occur ago. Morning home sound detail perform.
Road community account. Ever different his treat treatment firm. Give should fly cup.",7:15:27,CARDS
DCTX14808940860840,GB94WWYR43460145320993,1/28/2015,36434.02,100001,N,Credited,EDGE,POS,Cr,15:51:04,19:07:56,12/11/2017,18860993,867.53,3,"Similar personal radio long PM. New could Democrat deal response worry get.
Civil left smile discussion. Fly dark half measure. Pass wear whose them three network.",17:02:39,RTGS
DCTX14808940860840,GB94WWYR43460145320993,1/28/2015,35566.49,100001,Y,Dining,OPERA,POS,Dr,22:56:10,24:39:59,12/11/2017,34677391,867.53,5,Anyone public apply environmental yeah always area. Her six involve. Here account situation because. Blue political computer no.,23:55:46,CARDS
DCTX14808940860840,GB94WWYR43460145320993,1/28/2015,36989.05,100001,N,Credited,FF,MOBILE,Cr,6:24:15,11:35:20,12/17/2017,27410127,1422.56,4,"Generation blood lose movie computer. By strong use significant. Economy reveal report product despite say occur.
Especially financial others. Exist hold away shoulder.",9:29:43,UPI
DCTX14808940860840,GB94WWYR43460145320993,1/28/2015,38411.61,100001,N,Credited,FF,MOBILE,Cr,15:09:43,19:33:52,12/17/2017,7572333,1422.56,1,Office trip chance plan and. Kitchen space less one grow throughout page. Card pass director out hotel management.,16:40:58,NEFT
DCTX14808940860840,GB94WWYR43460145320993,1/28/2015,38135.58,100001,Y,Insurance,MI,PC,Dr,5:30:08,7:13:09,12/20/2017,8049544,276.03,7,"Especially shake admit camera various official need there. Or report later citizen.
Several than thank range. Foreign recent many tend.",6:20:50,DD
DCTX14808940860840,GB94WWYR43460145320993,1/28/2015,38411.61,100001,N,Credited,FF,PC,Cr,9:23:40,12:35:27,12/20/2017,21555367,276.03,7,"Democratic move our trade student half. Change marriage stay.
Language mouth later finish environment. Role about middle sing recognize organization.",10:44:28,DD
DCTX14808940860840,GB94WWYR43460145320993,1/28/2015,38135.58,100001,Y,Online Shopping,CHROME,PC,Dr,13:48:00,16:16:27,12/20/2017,3602928,276.03,6,"Official itself change including.
Growth choose blue try here account summer. Rate include from bring responsibility deep music.",14:18:52,CHEQUE
DCTX14808940860840,GB94WWYR43460145320993,1/28/2015,38411.61,100001,N,Credited,OPERA,PC,Cr,14:17:46,17:16:02,12/20/2017,26944487,276.03,2,"Wrong information nothing inside thus force. Machine drop protect. Campaign describe speech lawyer beyond tell.
Gun health daughter large fine on series. Indeed past dark half check.",16:02:03,IMPS
DCTX14808940860840,GB94WWYR43460145320993,1/28/2015,38135.58,100001,Y,Dining,SAFARI,MOBILE,Dr,21:37:46,23:39:26,12/20/2017,80497172,276.03,2,"Operation interest itself education simple. Ago cup performance six such challenge.
Recent land floor fire statement return. Environment every current.",22:41:22,IMPS
DCTX14808940860840,GB94WWYR43460145320993,1/28/2015,37474.66,100001,Y,Transportation,EDGE,MOBILE,Dr,9:42:02,17:10:28,1/1/2018,60096395,660.92,6,Offer particularly trip remember coach hotel week per. Thought maintain produce wait land room. Serve business paper air firm.,13:30:44,CHEQUE
DCTX14808940860840,GB94WWYR43460145320993,1/28/2015,36721.07,100001,Y,Personal Care,SAFARI,PC,Dr,3:26:32,6:01:17,1/2/2018,73812968,753.59,2,"Face manage easy exist remain lawyer environmental. Country hit range tonight drop. Cultural truth Mr everybody customer hair.
Shoulder make public high sometimes. Can no put country will image.",4:38:25,IMPS
DCTX14808940860840,GB94WWYR43460145320993,1/28/2015,37474.66,100001,N,Credited,IE,POS,Cr,8:56:32,11:17:11,1/2/2018,40698960,753.59,5,Professional special easy hear rich outside election. Story history every interview consumer low. President oil decade politics. Receive ask heart section audience shoulder least.,10:40:41,CARDS
DCTX14808940860840,GB94WWYR43460145320993,1/28/2015,36721.07,100001,Y,Online Shopping,OPERA,PC,Dr,12:41:00,14:38:05,1/2/2018,13797591,753.59,2,Answer sign discussion road enter. Pressure article I pay. Member pattern avoid shoulder evening human listen increase.,13:29:02,IMPS
DCTX14808940860840,GB94WWYR43460145320993,1/28/2015,35967.48,100001,Y,Transportation,OPERA,POS,Dr,16:56:10,19:38:22,1/2/2018,94933611,753.59,3,"Trip quality good. Experience practice appear various for.
Factor hot moment record. It right finally day focus near.",18:07:21,RTGS
DCTX14808940860840,GB94WWYR43460145320993,1/28/2015,36721.07,100001,N,Credited,MI,POS,Cr,23:09:11,25:22:14,1/2/2018,25520712,753.59,2,"Government technology pattern pretty word parent. Property condition which person.
Third response action increase billion. Recognize also large provide staff himself. Best score rich born seek.",23:58:33,IMPS
DCTX14808940860840,GB94WWYR43460145320993,1/28/2015,35062.69,100001,Y,Personal Care,SAFARI,MOBILE,Dr,14:01:25,19:44:30,1/4/2018,96546406,1658.38,1,Must serve job hair. Or threat should. Another morning wonder right.,16:30:51,NEFT
DCTX14808940860840,GB94WWYR43460145320993,1/28/2015,35702.42,100001,N,Credited,SAFARI,PC,Cr,3:23:29,5:57:05,1/7/2018,42115977,639.73,6,"Late executive protect city dark listen however. See major watch black of gas.
Growth before theory task carry mean. Money realize opportunity yes minute. Administration nothing seek.",4:35:32,CHEQUE
DCTX14808940860840,GB94WWYR43460145320993,1/28/2015,35062.69,100001,Y,Groceries,SAFARI,PC,Dr,10:56:29,13:39:51,1/7/2018,59239536,639.73,5,Tonight now door series. Family send order summer movement. Economy plant final employee off.,11:40:42,CARDS
DCTX14808940860840,GB94WWYR43460145320993,1/28/2015,34422.96,100001,Y,Personal Care,OPERA,MOBILE,Dr,12:13:33,14:59:20,1/7/2018,38858949,639.73,2,"Language themselves necessary successful.
Speak popular financial rather eat dream option. Onto experience check stand agree prove perhaps. Executive more concern attack government.",13:54:46,IMPS
DCTX14808940860840,GB94WWYR43460145320993,1/28/2015,35062.69,100001,N,Credited,FF,POS,Cr,17:09:37,19:35:10,1/7/2018,82068752,639.73,3,"Reach gun phone size likely opportunity art. Should camera finally.
Food word evening crime claim modern. About Republican prove ability detail against sense.",18:45:30,RTGS
DCTX14808940860840,GB94WWYR43460145320993,1/28/2015,34422.96,100001,Y,Groceries,CHROME,POS,Dr,20:58:24,23:18:50,1/7/2018,46314130,639.73,7,Out car north unit cost. Never institution truth two magazine care.,21:39:05,DD
DCTX14808940860840,GB94WWYR43460145320993,1/28/2015,33936,100001,Y,Groceries,FF,POS,Dr,5:16:50,7:02:03,1/12/2018,35413868,486.96,7,"Actually team none defense view hold. Card century car list himself which.
Action notice customer young cultural would weight. Suggest piece available.",6:14:08,DD
DCTX14808940860840,GB94WWYR43460145320993,1/28/2015,33449.04,100001,Y,Medicals,SAFARI,POS,Dr,11:23:02,13:31:52,1/12/2018,65618592,486.96,4,"Street team assume seem woman project serious. Share case Mr focus.
Talk offer maintain language key take heart. Capital hope these. Somebody short believe response forget staff.",12:02:26,UPI
DCTX14808940860840,GB94WWYR43460145320993,1/28/2015,33936,100001,N,Credited,SAFARI,MOBILE,Cr,19:38:27,22:15:22,1/12/2018,74475407,486.96,6,"Newspaper her enter.
Perhaps for if reach party. Trouble nature time add.",20:17:24,CHEQUE
DCTX14808940860840,GB94WWYR43460145320993,1/28/2015,33917.15,100001,Y,Personal Care,EDGE,POS,Dr,3:52:05,7:11:02,1/26/2018,53912749,18.85,6,"Spend various energy Democrat. Dog exist collection staff team level hold. Until political he black cup start.
Everybody away moment energy rather today then also. Write ask place compare.",5:28:30,CHEQUE
DCTX14808940860840,GB94WWYR43460145320993,1/28/2015,33898.3,100001,Y,Medicals,FF,POS,Dr,9:07:10,11:00:22,1/26/2018,50152063,18.85,5,"Result change against environment memory serious within.
National speak before remember no term education. Best catch possible city. Few change sport financial collection.",10:20:24,CARDS
DCTX14808940860840,GB94WWYR43460145320993,1/28/2015,33879.45,100001,Y,Dining,MI,PC,Dr,13:12:34,15:30:32,1/26/2018,95560519,18.85,7,"Oil contain type social often. Author laugh stay white.
Difficult drug after away support.
These never discuss physical teach. Range official recent call including.",13:44:49,DD
DCTX14808940860840,GB94WWYR43460145320993,1/28/2015,33898.3,100001,N,Credited,FF,POS,Cr,17:41:48,19:22:23,1/26/2018,84936899,18.85,7,Evening show direction build director candidate. Anyone direction miss as article themselves. Your stock back picture kind.,18:49:57,DD
DCTX14808940860840,GB94WWYR43460145320993,1/28/2015,33917.15,100001,N,Credited,OPERA,PC,Cr,19:28:45,22:48:49,1/26/2018,26217284,18.85,5,Order whatever national second. These response car dog. Night few develop situation compare service.,20:53:44,CARDS
DCTX14808940860840,GB94WWYR43460145320993,1/28/2015,32096.26,100001,Y,Entertainment,FF,MOBILE,Dr,11:47:58,17:25:53,1/28/2018,20353414,1820.89,1,Ahead national low need strong buy well within. Save use measure pressure kitchen point. Large according data send you computer.,14:01:22,NEFT
DCTX14808940860840,GB94WWYR43460145320993,1/28/2015,30275.37,100001,Y,Insurance,CHROME,POS,Dr,14:22:15,18:49:46,1/28/2018,83312663,1820.89,2,"Majority one as quite claim heart issue. Today attorney Mr watch partner exist either manage.
Gas form network. Hospital main real industry military. Per will be expect particularly debate sense.",16:54:54,IMPS
DCTX14808940860840,GB94WWYR43460145320993,1/28/2015,29221.89,100001,Y,Household Consumables,MI,MOBILE,Dr,6:12:41,8:22:07,2/11/2018,94645316,1053.48,5,"Reason subject say law. Sure knowledge join program. Single learn to gun senior whatever tend.
Gun age so strategy although. Newspaper see last.",7:00:06,CARDS
DCTX14808940860840,GB94WWYR43460145320993,1/28/2015,28168.41,100001,Y,Household Consumables,SAFARI,PC,Dr,11:16:16,15:44:48,2/11/2018,54927506,1053.48,4,"Sign there share various my decide.
Ok buy subject whose feel hundred. Might next window participant soldier.",13:29:48,UPI
DCTX14808940860840,GB94WWYR43460145320993,1/28/2015,29221.89,100001,N,Credited,IE,MOBILE,Cr,17:00:20,19:53:33,2/11/2018,40470672,1053.48,7,"Sing instead defense cut. Enough couple these hair maintain probably question. Base eight bring fear.
For knowledge view direction clearly. Thus understand specific increase level.",18:05:14,DD
DCTX14808940860840,GB94WWYR43460145320993,1/28/2015,30275.37,100001,N,Credited,OPERA,MOBILE,Cr,21:45:33,23:58:14,2/11/2018,58146132,1053.48,6,"Or one research course any key bit.
Artist manage edge people age realize challenge. Style cost ground step.
Second daughter force term. Put quality group every skill.",22:44:16,CHEQUE
DCTX14808940860840,GB94WWYR43460145320993,1/28/2015,28974.98,100001,Y,Entertainment,EDGE,PC,Dr,9:23:33,15:36:58,2/22/2018,26217048,1300.39,7,"Represent bring garden read mind account. Although character modern.
Summer woman firm a guy. Sort group ten check teach.",13:07:54,DD
DCTX14808940860840,GB94WWYR43460145320993,1/28/2015,30275.37,100001,N,Credited,EDGE,POS,Cr,19:51:56,23:56:23,2/22/2018,5903030,1300.39,5,"Know night wall high clear national. Read key foreign rather.
Great find sing tree. Data successful analysis choice shoulder reason shake. Onto on can section.",21:07:53,CARDS
DCTX14808940860840,GB94WWYR43460145320993,1/28/2015,32236.79,100001,N,Credited,FF,MOBILE,Cr,3:47:57,6:37:22,3/12/2018,14941184,1961.42,5,Majority reveal himself church often yourself assume. Set action score truth. Thank purpose light picture development.,5:15:58,CARDS
DCTX14808940860840,GB94WWYR43460145320993,1/28/2015,30275.37,100001,Y,Dining,MI,POS,Dr,9:09:27,12:15:49,3/12/2018,41721810,1961.42,6,"Fish argue catch exactly produce goal. Consider late start table machine throw his.
Value begin war sometimes red quite.
Impact what hospital fill. Boy machine newspaper town sometimes.",10:20:36,CHEQUE
DCTX14808940860840,GB94WWYR43460145320993,1/28/2015,32236.79,100001,N,Credited,EDGE,POS,Cr,13:51:46,16:10:16,3/12/2018,67177943,1961.42,5,"Maybe democratic structure play defense. Walk lose cultural fear eight. Artist new generation phone.
Drug program travel majority when use because. Science true phone worry blood voice.",15:11:12,CARDS
DCTX14808940860840,GB94WWYR43460145320993,1/28/2015,30275.37,100001,Y,Dining,FF,PC,Dr,18:38:49,21:22:04,3/12/2018,73088264,1961.42,7,Meet sure record rock agreement director international. Open oil cost standard. Individual collection impact before part brother.,19:22:33,DD
DCTX14808940860840,GB94WWYR43460145320993,1/28/2015,28313.95,100001,Y,Groceries,EDGE,MOBILE,Dr,19:39:16,22:15:28,3/12/2018,28293750,1961.42,5,Ahead anyone themselves month. Human foot small. Task author project behind education another technology.,20:36:48,CARDS
DCTX14808940860840,GB94WWYR43460145320993,1/28/2015,26987.01,100001,Y,Household Consumables,EDGE,PC,Dr,6:09:35,9:38:39,3/19/2018,16017344,1326.94,5,"Over class relate. Recognize crime better interview leader.
Western girl do right question interest. Special key list happy movie.",7:17:11,CARDS
DCTX14808940860840,GB94WWYR43460145320993,1/28/2015,28313.95,100001,N,Credited,CHROME,POS,Cr,10:23:02,13:11:38,3/19/2018,3750650,1326.94,5,"Continue seven source. Charge capital young already your next.
Manage design white kid sometimes leave score. Remember certainly physical apply happy. Open owner son. Particular person list note.",12:23:11,CARDS
DCTX14808940860840,GB94WWYR43460145320993,1/28/2015,29640.89,100001,N,Credited,OPERA,POS,Cr,16:31:34,19:34:23,3/19/2018,62708142,1326.94,3,Exist despite consider realize cultural region amount. Dinner hard sister purpose statement unit stand pressure. Begin next professor shoulder style everybody. Run sing suddenly moment.,17:58:49,RTGS
DCTX14808940860840,GB94WWYR43460145320993,1/28/2015,30967.83,100001,N,Credited,MI,PC,Cr,20:34:01,23:43:11,3/19/2018,96097205,1326.94,5,"Improve life reason necessary leg writer need. Laugh budget song local.
Claim a last morning amount ability sell. Phone billion hard agent single station late institution.",22:11:56,CARDS
DCTX14808940860840,GB94WWYR43460145320993,1/28/2015,30133.79,100001,Y,Medicals,OPERA,MOBILE,Dr,5:51:56,7:18:46,3/22/2018,74531721,834.04,1,"Good boy professional. Than already father onto. Like these score majority believe range claim.
Behavior process ahead personal during increase.",6:27:58,NEFT
DCTX14808940860840,GB94WWYR43460145320993,1/28/2015,30967.83,100001,N,Credited,FF,PC,Cr,8:44:21,11:25:54,3/22/2018,87727913,834.04,7,"Someone economic receive stop identify edge should. Record end during improve debate. Catch course without fight.
Learn its method training bill. Analysis stuff fall boy various.",9:36:44,DD
DCTX14808940860840,GB94WWYR43460145320993,1/28/2015,31801.87,100001,N,Credited,OPERA,PC,Cr,11:15:10,14:58:26,3/22/2018,58673959,834.04,3,"Sea next wrong performance into series music.
Evidence step firm. Measure federal pass word when near traditional.",13:00:32,RTGS
DCTX14808940860840,GB94WWYR43460145320993,1/28/2015,30967.83,100001,Y,Household Consumables,FF,POS,Dr,18:09:52,21:40:00,3/22/2018,27144923,834.04,1,"Focus explain firm. Face here fill enter. True box truth significant sure education. West computer most benefit.
Police push east guess score. Form collection down draw rise few.",19:45:30,NEFT
DCTX14808940860840,GB94WWYR43460145320993,1/28/2015,30133.79,100001,Y,Groceries,MI,MOBILE,Dr,22:54:15,25:08:15,3/22/2018,82516321,834.04,7,"Story few base never energy fire. Especially say involve civil. Among board age.
Key under Mr beat apply cover because. Price deal offer accept protect media glass still.",23:28:17,DD
DCTX14808940860840,GB94WWYR43460145320993,1/28/2015,28176.05,100001,Y,Rent,OPERA,MOBILE,Dr,18:10:48,26:36:16,4/3/2018,89248256,1957.74,6,"Animal business same weight cultural fact you. Politics two hand safe raise own. Standard perform foot.
Somebody of chair mind paper so newspaper. Kind single key century blue high get.",20:44:22,CHEQUE
DCTX14808940860840,GB94WWYR43460145320993,1/28/2015,28218.45,100001,N,Credited,EDGE,POS,Cr,6:15:20,8:37:59,4/4/2018,12008261,42.4,7,"Reveal son later former. Chance hospital grow eat. Language prepare it less market.
Notice seek truth hot safe TV.
Rock human avoid generation pressure daughter peace eye. Film think foreign arm.",7:33:48,DD
DCTX14808940860840,GB94WWYR43460145320993,1/28/2015,28260.85,100001,N,Credited,SAFARI,PC,Cr,10:52:59,14:15:45,4/4/2018,86945318,42.4,7,"Will growth theory one often direction color. Role allow happy get account serve town.
That institution might kid apply pass. Section toward oil charge record staff decision apply.",12:05:42,DD
DCTX14808940860840,GB94WWYR43460145320993,1/28/2015,28218.45,100001,Y,Utilities,MI,POS,Dr,17:27:17,21:09:25,4/4/2018,17671262,42.4,4,"Mrs mouth family site world despite. Argue total model stuff follow series against. Number interesting suddenly.
Your two door hand truth guy. With speak would modern wonder college day.",20:19:23,UPI
DCTX14808940860840,GB94WWYR43460145320993,1/28/2015,29455.12,100001,N,Credited,SAFARI,POS,Cr,12:41:31,19:41:57,4/7/2018,64828183,1236.67,6,Reduce law artist for pull. Others keep performance Republican now media. Only yard cut figure.,17:01:54,CHEQUE
DCTX14808940860840,GB94WWYR43460145320993,1/28/2015,31162.24,100001,N,Credited,EDGE,MOBILE,Cr,7:14:43,10:56:04,4/14/2018,6306632,1707.12,1,"Usually land prepare bank remain. Set sort appear mouth help.
Fight voice tend prevent. Nearly scientist far religious my order night. Blood nearly business true play without travel.",9:54:07,NEFT
DCTX14808940860840,GB94WWYR43460145320993,1/28/2015,32869.36,100001,N,Credited,SAFARI,POS,Cr,12:02:10,15:52:56,4/14/2018,89334034,1707.12,7,"Long set everyone. Establish since interest study out.
Professor lose everyone thus stock tell. Best college stage new.",14:08:32,DD
DCTX14808940860840,GB94WWYR43460145320993,1/28/2015,31162.24,100001,Y,Insurance,FF,PC,Dr,16:53:59,21:12:05,4/14/2018,87093575,1707.12,1,However eat study father determine radio clearly. Necessary issue audience scientist. Could leave any reflect before.,19:34:11,NEFT
DCTX14808940860840,GB94WWYR43460145320993,1/28/2015,31028.31,100001,Y,Rent,EDGE,POS,Dr,5:43:34,8:01:08,4/15/2018,95661735,133.93,2,Community sense service what contain up. Line debate land front. So quite choose determine.,6:36:31,IMPS
DCTX14808940860840,GB94WWYR43460145320993,1/28/2015,31162.24,100001,N,Credited,CHROME,POS,Cr,8:25:43,10:19:32,4/15/2018,57468907,133.93,6,"Work building town raise shake. Its take want hot.
Condition break about. Tax although again box more community himself.",9:31:00,CHEQUE
DCTX14808940860840,GB94WWYR43460145320993,1/28/2015,31028.31,100001,Y,Groceries,EDGE,PC,Dr,11:19:06,13:44:12,4/15/2018,36339235,133.93,3,Teacher throughout behind thousand either. Cell join east finally later.,12:38:21,RTGS
DCTX14808940860840,GB94WWYR43460145320993,1/28/2015,30894.38,100001,Y,Utilities,IE,POS,Dr,15:27:51,18:18:58,4/15/2018,5848355,133.93,5,"Population must born figure throw middle. Bad economic look oil remain range.
Same from see so. Word reflect bit brother whether. Same off vote also cold.",16:56:56,CARDS
DCTX14808940860840,GB94WWYR43460145320993,1/28/2015,31028.31,100001,N,Credited,OPERA,PC,Cr,18:42:17,22:23:06,4/15/2018,56771237,133.93,7,"Tonight question behavior certainly property speech health. Name she minute middle civil buy young.
Office occur reduce human soon. Wear child news much. Course base hour.",20:40:15,DD
DCTX14808940860840,GB94WWYR43460145320993,1/28/2015,31280.97,100001,N,Credited,EDGE,POS,Cr,7:19:51,10:28:44,4/20/2018,11709152,252.66,6,Mr wish low kind political. Forward wife claim once wall box sing. Computer man back behavior traditional.,8:52:15,CHEQUE
DCTX14808940860840,GB94WWYR43460145320993,1/28/2015,31028.31,100001,Y,Insurance,EDGE,POS,Dr,10:33:42,12:33:27,4/20/2018,98784684,252.66,6,"Time after seek whole. Modern test read subject suggest miss reduce.
Trouble throw gas trip. Near leader modern well although outside.",11:27:25,CHEQUE
DCTX14808940860840,GB94WWYR43460145320993,1/28/2015,31280.97,100001,N,Credited,IE,PC,Cr,13:00:59,15:34:54,4/20/2018,84803887,252.66,6,Party box just drug young ability across. Fine answer similar beat campaign between no. Security sea deep federal. Listen point before action car success.,14:57:53,CHEQUE
DCTX14808940860840,GB94WWYR43460145320993,1/28/2015,31533.63,100001,N,Credited,SAFARI,POS,Cr,22:24:53,25:28:15,4/20/2018,19497310,252.66,3,"Artist happen upon. Common nation she check theory. Lose wish degree during.
Away nation southern expect. Among various smile ball now. Story improve impact kitchen administration.",23:19:03,RTGS
DCTX14808940860840,GB94WWYR43460145320993,1/28/2015,33152.7,100001,N,Credited,MI,MOBILE,Cr,3:06:22,5:33:09,4/22/2018,37064440,1619.07,4,"Us piece issue key. Positive level fall special month. Again radio baby nice.
Painting protect police member represent reason economy. Action couple person industry discover.",4:43:44,UPI
DCTX14808940860840,GB94WWYR43460145320993,1/28/2015,34771.77,100001,N,Credited,CHROME,PC,Cr,7:03:12,10:49:23,4/22/2018,41108819,1619.07,7,Money democratic personal. Half campaign style us teacher. Voice her energy rest decade win trial should.,8:49:31,DD
DCTX14808940860840,GB94WWYR43460145320993,1/28/2015,33152.7,100001,Y,Transportation,FF,PC,Dr,10:53:12,14:16:37,4/22/2018,77389428,1619.07,4,"Rest time yes. Image cold adult pass democratic safe.
Popular federal article feel. Animal must report property control public Republican. Up from their our single.",12:41:59,UPI
DCTX14808940860840,GB94WWYR43460145320993,1/28/2015,34771.77,100001,N,Credited,IE,POS,Cr,16:03:59,18:39:58,4/22/2018,54181830,1619.07,2,"Some technology lawyer long. Identify third stop eat response middle activity. Gas father nation meet but.
Personal job democratic laugh structure seat. Field measure who development interesting.",18:02:15,IMPS
DCTX14808940860840,GB94WWYR43460145320993,1/28/2015,33152.7,100001,Y,Household Consumables,MI,MOBILE,Dr,19:38:24,23:12:37,4/22/2018,4775591,1619.07,5,"Will stand agree treatment method. Every consumer resource because.
Character reduce be help Mr until. Significant computer some laugh wife day. Tell top party power north.",21:17:49,CARDS
DCTX14808940860840,GB94WWYR43460145320993,1/28/2015,32140.9,100001,Y,Insurance,EDGE,POS,Dr,12:49:56,23:49:17,4/23/2018,1824759,1011.8,3,"Area open drop already. Outside issue baby science including pretty.
Involve pattern major line teacher pick. Consider brother grow fear will near huge.",18:31:35,RTGS
DCTX14808940860840,GB94WWYR43460145320993,1/28/2015,32283.66,100001,N,Credited,MI,PC,Cr,17:29:52,24:29:06,5/8/2018,7656545,142.76,3,"Since do run structure. Air issue foreign piece card glass here deal. Well building probably.
Reason risk be large. Woman term pretty either.",22:22:02,RTGS
DCTX14808940860840,GB94WWYR43460145320993,1/28/2015,33373.81,100001,N,Credited,SAFARI,MOBILE,Cr,5:49:38,8:30:24,5/16/2018,21776533,1090.15,5,Let oil among especially build. Claim off big top maintain mother.,6:54:27,CARDS
DCTX14808940860840,GB94WWYR43460145320993,1/28/2015,34463.96,100001,N,Credited,SAFARI,POS,Cr,10:29:35,15:32:04,5/16/2018,51796563,1090.15,5,"Still former of project possible oil. Letter popular some control.
Growth pretty level who its attention. Administration professor spring. More year discussion vote.",13:14:24,CARDS
DCTX14808940860840,GB94WWYR43460145320993,1/28/2015,35554.11,100001,N,Credited,SAFARI,MOBILE,Cr,17:41:02,21:12:22,5/16/2018,5483747,1090.15,5,"Mission least sometimes image team role carry. Music friend city hard sell. Bill trial claim all term rate. Book science subject box change everything property.
Save feeling there our move picture.",18:49:54,CARDS
DCTX14808940860840,GB94WWYR43460145320993,1/28/2015,35672.96,100001,N,Credited,IE,PC,Cr,12:40:01,16:45:41,5/23/2018,61713093,118.85,4,"Performance bag pretty week the.
Family law collection crime process suddenly party. Center space wife operation.
Remain indicate avoid left which. Site at financial energy cause.",13:40:01,UPI
DCTX14808940860840,GB94WWYR43460145320993,1/28/2015,35554.11,100001,Y,Rent,FF,MOBILE,Dr,15:50:33,22:13:44,5/23/2018,63119404,118.85,2,Writer meet read former team. Shake wish consider accept include. Loss create person. Agent kind production wait.,19:39:53,IMPS
DCTX14808940860840,GB94WWYR43460145320993,1/28/2015,37128.14,100001,N,Credited,FF,PC,Cr,6:09:16,9:14:58,5/24/2018,94876710,1574.03,7,"Professor only we listen. Seat career miss difference.
Eye opportunity bring wife in. Travel name wear others hospital relate. Situation nor bill situation each.",8:36:29,DD
DCTX14808940860840,GB94WWYR43460145320993,1/28/2015,38702.17,100001,N,Credited,FF,POS,Cr,13:04:49,17:24:45,5/24/2018,39442604,1574.03,7,"Modern material field.
Media head effect herself south edge quite.
Against green better fear you. Institution audience exist drop need quickly land.",14:52:50,DD
DCTX14808940860840,GB94WWYR43460145320993,1/28/2015,40276.2,100001,N,Credited,IE,PC,Cr,18:25:07,20:51:22,5/24/2018,87418392,1574.03,3,"Into end view. News day would decide.
Hard difficult good Democrat effort chair. Unit consumer necessary sister notice. Person court company record degree door may.",20:10:42,RTGS
DCTX14808940860840,GB94WWYR43460145320993,1/28/2015,41952.53,100001,N,Credited,FF,MOBILE,Cr,5:29:22,7:43:04,5/30/2018,79594691,1676.33,7,"Company large nice former. Board all main again cause like outside.
Bar social protect plant new race contain. Week in ball page.
These exactly see order name. Name maybe or huge deal yes air same.",6:14:36,DD
DCTX14808940860840,GB94WWYR43460145320993,1/28/2015,40276.2,100001,Y,Household Consumables,IE,POS,Dr,7:40:31,10:09:19,5/30/2018,86480932,1676.33,6,"Create book rest wish our administration. As possible loss wrong do bar.
Stand course site food message. Interest land direction off. Red three language inside lot.",9:16:10,CHEQUE
DCTX14808940860840,GB94WWYR43460145320993,1/28/2015,41952.53,100001,N,Credited,EDGE,PC,Cr,13:57:46,16:42:34,5/30/2018,10583395,1676.33,7,"Particularly light lawyer young front probably four run. Kitchen state news because man. Leg per response federal policy. Public music under thousand first audience.
Let two chair take can say.",15:21:40,DD
DCTX14808940860840,GB94WWYR43460145320993,1/28/2015,40276.2,100001,Y,Online Shopping,FF,MOBILE,Dr,17:37:25,18:59:17,5/30/2018,58887677,1676.33,4,"Total successful bring my onto. Throughout claim number can. Benefit eat difficult go party.
Community if perhaps stay. Resource long hear war hot.
Rather message smile speak ready.",18:02:35,UPI
DCTX14808940860840,GB94WWYR43460145320993,1/28/2015,38599.87,100001,Y,Dining,MI,PC,Dr,22:25:48,24:30:35,5/30/2018,23708495,1676.33,3,"There total though somebody million. Market protect since security bill walk cold.
You whether strategy listen economy month. Chair unit each activity case artist hand.",23:27:39,RTGS
DCTX14808940860840,GB94WWYR43460145320993,1/28/2015,39032.82,100001,N,Credited,SAFARI,PC,Cr,5:27:51,10:28:32,6/6/2018,71410371,432.95,6,"Produce here huge. Ability forward author worker let care property. Society picture indicate president.
Democrat skin item keep. Future protect at know argue management play.",7:59:45,CHEQUE
DCTX14808940860840,GB94WWYR43460145320993,1/28/2015,38599.87,100001,Y,Transportation,MI,PC,Dr,10:46:26,14:38:11,6/6/2018,3859100,432.95,7,See everyone also me season area. Market data table again only camera. Go over study early behavior become.,12:14:20,DD
DCTX14808940860840,GB94WWYR43460145320993,1/28/2015,38166.92,100001,Y,Insurance,OPERA,PC,Dr,18:08:21,23:07:38,6/6/2018,4701989,432.95,1,"Arm school employee all. Exist sound claim until son whole. Believe day head play.
Official group program general sometimes. Window best part appear.",21:01:25,NEFT
DCTX14808940860840,GB94WWYR43460145320993,1/28/2015,38794.05,100001,N,Credited,OPERA,POS,Cr,6:05:13,8:47:29,6/21/2018,36128280,627.13,5,"Social always week risk people book respond. Option media animal education. American issue add along Republican seat quickly.
Difficult view mind me practice another big.",7:32:19,CARDS
DCTX14808940860840,GB94WWYR43460145320993,1/28/2015,38166.92,100001,Y,Entertainment,CHROME,MOBILE,Dr,8:51:16,12:17:15,6/21/2018,77762627,627.13,5,"Appear future center. Develop skin improve contain thought product physical.
Affect section hear feel director job protect. Card indeed indeed fish upon enough.",10:52:58,CARDS
DCTX14808940860840,GB94WWYR43460145320993,1/28/2015,37539.79,100001,Y,Online Shopping,CHROME,PC,Dr,16:39:13,18:21:37,6/21/2018,55043939,627.13,5,"Region among hard far. Effort seem wind fish someone.
Sign decide development. Beyond investment old organization rest large.",17:25:52,CARDS
DCTX14808940860840,GB94WWYR43460145320993,1/28/2015,38166.92,100001,N,Credited,IE,MOBILE,Cr,20:16:15,22:59:37,6/21/2018,74239351,627.13,6,"Win her social reason education lawyer development. Husband city add involve any head require bar. Enough own often series study can new.
Husband join whether north state away.",22:07:15,CHEQUE
DCTX14808940860840,GB94WWYR43460145320993,1/28/2015,37104.9,100001,Y,Transportation,CHROME,PC,Dr,4:28:34,7:35:21,6/24/2018,71973708,1062.02,3,"Win step so all involve opportunity hear. Fund for admit perhaps.
North young add floor today. Offer most keep fly at research middle.",5:56:06,RTGS
DCTX14808940860840,GB94WWYR43460145320993,1/28/2015,38166.92,100001,N,Credited,IE,POS,Cr,7:09:25,9:13:12,6/24/2018,1311839,1062.02,2,Number interest save everyone wall wrong. Catch number commercial range herself thus. Land day country those task team.,8:10:21,IMPS
DCTX14808940860840,GB94WWYR43460145320993,1/28/2015,37104.9,100001,Y,Medicals,MI,PC,Dr,14:09:17,16:27:32,6/24/2018,57702889,1062.02,5,"Leader need see admit trip. Direction operation always. Major these activity available.
Soldier explain so score front family American. Catch air administration resource.",15:36:10,CARDS
DCTX14808940860840,GB94WWYR43460145320993,1/28/2015,36042.88,100001,Y,Dining,SAFARI,PC,Dr,17:25:34,20:18:57,6/24/2018,5418749,1062.02,6,"Various peace television science remain piece let. Pattern mission window state past smile.
Job defense agency also. Method hold hard sign property eat issue. Health source teach despite seek.",18:20:59,CHEQUE
DCTX14808940860840,GB94WWYR43460145320993,1/28/2015,34980.86,100001,Y,Household Consumables,IE,PC,Dr,20:08:59,23:14:09,6/24/2018,38442643,1062.02,5,"Image away mouth above president together fly. Budget cold rule.
Me question accept almost weight situation success. It option parent face one until. Democrat least key.",21:38:28,CARDS
DCTX14808940860840,GB94WWYR43460145320993,1/28/2015,33267.19,100001,Y,Medicals,MI,PC,Dr,11:25:42,16:44:03,7/6/2018,46727916,1713.67,4,"Scientist something total onto shake lead bill so. Cost identify tell around treat deal.
Fear animal strategy these. Worker ball a station.",14:46:08,UPI
DCTX14808940860840,GB94WWYR43460145320993,1/28/2015,34980.86,100001,N,Credited,FF,PC,Cr,20:04:46,26:33:48,7/6/2018,78726635,1713.67,2,Effect enter food live officer true offer chance. Executive international increase focus yourself. Computer meet your political amount like.,23:45:30,IMPS
DCTX14808940860840,GB94WWYR43460145320993,1/28/2015,34712.88,100001,Y,Dining,FF,PC,Dr,15:20:32,26:08:19,7/7/2018,55670302,267.98,1,Often real reason these. How white TV drop. Another avoid always sit heavy someone.,20:22:27,NEFT
DCTX14808940860840,GB94WWYR43460145320993,1/28/2015,35912.1,100001,N,Credited,SAFARI,MOBILE,Cr,18:47:07,24:19:42,7/11/2018,44880453,1199.22,3,Politics often hit of over sing usually. Table later me bad finally direction image.,20:56:54,RTGS
DCTX14808940860840,GB94WWYR43460145320993,1/28/2015,37014.25,100001,N,Credited,IE,POS,Cr,12:58:05,19:36:59,7/12/2018,3333310,1102.15,7,"Enjoy theory popular personal. Produce human stage. Game east charge husband across.
Statement speech address million.",14:51:58,DD
DCTX14808940860840,GB94WWYR43460145320993,1/28/2015,37827.24,100001,N,Credited,OPERA,PC,Cr,4:15:16,7:20:50,7/31/2018,45565458,812.99,1,Ball main crime meet suddenly truth several. Yet necessary manage. Realize thank likely heavy. Republican activity pretty look.,5:34:53,NEFT
DCTX14808940860840,GB94WWYR43460145320993,1/28/2015,37014.25,100001,Y,Rent,OPERA,PC,Dr,9:53:55,11:35:42,7/31/2018,44761639,812.99,6,"Current name generation fact other animal. Say focus animal.
Series simply benefit nearly. Yet sign myself finish long song sing.",10:42:17,CHEQUE
DCTX14808940860840,GB94WWYR43460145320993,1/28/2015,37827.24,100001,N,Credited,CHROME,POS,Cr,13:46:46,16:53:14,7/31/2018,33932873,812.99,5,Civil former maybe we young another political. During current information physical everybody toward admit. Worker remember since look fine situation.,15:12:17,CARDS
DCTX14808940860840,GB94WWYR43460145320993,1/28/2015,37014.25,100001,Y,Personal Care,CHROME,MOBILE,Dr,14:52:44,17:31:47,7/31/2018,47156456,812.99,6,"Strategy number top store yourself. Raise yes hold.
Beautiful everything name wait shoulder. Item maybe east.",16:34:11,CHEQUE
DCTX14808940860840,GB94WWYR43460145320993,1/28/2015,36201.26,100001,Y,Medicals,MI,POS,Dr,20:56:18,24:03:51,7/31/2018,62629966,812.99,4,Indicate campaign open. Guy myself force police international tax. Interesting believe size institution bad close finish.,22:05:45,UPI
DCTX14808940860840,GB94WWYR43460145320993,1/28/2015,34706.56,100001,Y,Dining,IE,POS,Dr,4:44:34,7:25:56,8/4/2018,73899839,1494.7,7,"Art they buy send pull event. Design simply important with.
Easy common suggest free.
Organization appear training forget carry check big. Resource central five bit piece.",6:02:39,DD
DCTX14808940860840,GB94WWYR43460145320993,1/28/2015,36201.26,100001,N,Credited,FF,PC,Cr,9:26:15,11:39:05,8/4/2018,24243971,1494.7,5,"Fine natural thank would level determine. Imagine miss quite while chance dark debate. Season political security campaign.
Body out sound add risk feel.",10:04:18,CARDS
DCTX14808940860840,GB94WWYR43460145320993,1/28/2015,34706.56,100001,Y,Utilities,SAFARI,PC,Dr,15:12:25,18:11:24,8/4/2018,96969625,1494.7,6,Read cup section run decision most million. Clear special cultural good very better event. Right person thousand.,16:03:45,CHEQUE
DCTX14808940860840,GB94WWYR43460145320993,1/28/2015,33211.86,100001,Y,Medicals,MI,MOBILE,Dr,20:48:11,24:33:27,8/4/2018,33010045,1494.7,4,"Else end major movie since season business.
Appear rest affect best stop son. Nation wide life. This newspaper mind. A continue environmental among protect be.",22:38:01,UPI
DCTX14808940860840,GB94WWYR43460145320993,1/28/2015,32864.32,100001,Y,Online Shopping,EDGE,POS,Dr,12:13:31,17:09:26,8/6/2018,73450719,347.54,7,"Middle surface then. Material break raise better. You think despite action hit tend meeting.
Subject be especially major most. Organization civil avoid sit each far. Owner visit quite season.",15:06:13,DD
DCTX14808940860840,GB94WWYR43460145320993,1/28/2015,32455.73,100001,Y,Medicals,CHROME,MOBILE,Dr,7:13:20,13:42:03,8/14/2018,90372742,408.59,7,"Goal executive current reach production field. Region morning Republican defense. Data believe end small move become.
Per team yet include if along. Theory notice physical middle.",10:32:43,DD
DCTX14808940860840,GB94WWYR43460145320993,1/28/2015,32047.14,100001,Y,Rent,OPERA,POS,Dr,17:48:30,22:55:56,8/14/2018,37758936,408.59,7,Response really end story eye chair under. Defense lawyer lay week language use hospital color. End along myself young media account.,21:01:40,DD
DCTX14808940860840,GB94WWYR43460145320993,1/28/2015,32837.35,100001,N,Credited,SAFARI,MOBILE,Cr,3:19:20,5:10:26,8/22/2018,92365308,790.21,1,"Need available bag often itself. Professional for fall discover decide fly turn.
Field ground board effort. Why respond scene maybe job charge more.",4:34:58,NEFT
DCTX14808940860840,GB94WWYR43460145320993,1/28/2015,32047.14,100001,Y,Insurance,OPERA,MOBILE,Dr,8:34:10,11:26:34,8/22/2018,868617,790.21,1,"Born this strategy room value test including. City no response purpose girl sign. Standard development factor plan.
Set by three design. Forward best current blood thought tree.",10:14:24,NEFT
DCTX14808940860840,GB94WWYR43460145320993,1/28/2015,32837.35,100001,N,Credited,IE,MOBILE,Cr,13:55:18,16:15:30,8/22/2018,60987556,790.21,2,"Occur with leg challenge continue sell air benefit. Performance true most.
School action wall movie parent. Family phone fly president behind. South drop mind should main.",15:29:21,IMPS
DCTX14808940860840,GB94WWYR43460145320993,1/28/2015,33627.56,100001,N,Credited,SAFARI,MOBILE,Cr,14:41:39,17:10:13,8/22/2018,13491574,790.21,1,Huge partner contain financial improve these surface meeting. Size government time bad candidate military.,16:03:13,NEFT
DCTX14808940860840,GB94WWYR43460145320993,1/28/2015,34417.77,100001,N,Credited,CHROME,POS,Cr,21:34:05,23:45:42,8/22/2018,89042274,790.21,3,"Air serve standard development dinner last black. Church blue candidate could itself.
Make college measure wind. Less rich indeed audience. Small gun on enough catch unit.",22:10:45,RTGS
DCTX14808940860840,GB94WWYR43460145320993,1/28/2015,34314.61,100001,Y,Dining,MI,MOBILE,Dr,6:27:04,8:22:12,8/24/2018,69212703,103.16,5,"Usually ok face sense certainly fall goal. New raise avoid director under effect want.
Treat staff administration drive many feeling. Despite different several population behavior.",6:59:13,CARDS
DCTX14808940860840,GB94WWYR43460145320993,1/28/2015,34211.45,100001,Y,Online Shopping,MI,POS,Dr,11:02:33,13:36:45,8/24/2018,63942262,103.16,5,"Article tell thus not strong note thought spend.
Eight drug idea important. Where add vote red.",11:43:40,CARDS
DCTX14808940860840,GB94WWYR43460145320993,1/28/2015,34314.61,100001,N,Credited,SAFARI,PC,Cr,17:06:08,18:52:34,8/24/2018,31259088,103.16,7,Need heart fact type face case. Involve Mrs old level. Power remember popular north black. Only rule leg either hold consider current not.,17:37:22,DD
DCTX14808940860840,GB94WWYR43460145320993,1/28/2015,34417.77,100001,N,Credited,EDGE,POS,Cr,20:26:26,22:40:35,8/24/2018,17849326,103.16,6,"Fill you prevent clearly attention. Cell trip vote prove eight bag strategy during.
Edge despite community card. Tend speak research yet official always car discussion.",21:41:08,CHEQUE
DCTX14808940860840,GB94WWYR43460145320993,1/28/2015,34364.6,100001,Y,Dining,EDGE,MOBILE,Dr,5:11:44,8:49:34,9/4/2018,267564,53.17,6,"Site protect threat since as. Effort pick election wide suggest. Respond might dream care plant summer I.
Similar visit mission. Any turn professor carry not. Level your your though.",6:44:40,CHEQUE
DCTX14808940860840,GB94WWYR43460145320993,1/28/2015,34311.43,100001,Y,Entertainment,EDGE,PC,Dr,14:14:48,18:02:00,9/4/2018,37948788,53.17,6,"Rock summer coach democratic. Life have control cut loss. Stop look thus air magazine.
Than suddenly reach treatment bill. Evidence everybody national message field kitchen mean.",15:13:37,CHEQUE
DCTX14808940860840,GB94WWYR43460145320993,1/28/2015,34258.26,100001,Y,Insurance,SAFARI,PC,Dr,22:27:06,26:26:34,9/4/2018,10921012,53.17,7,"Civil professional energy rock improve. Material water theory able we.
Simply training floor various detail.
Sort really someone common. Their place often easy husband sea.",23:49:53,DD
DCTX14808940860840,GB94WWYR43460145320993,1/28/2015,32933.73,100001,Y,Household Consumables,CHROME,POS,Dr,4:02:24,7:02:37,9/11/2018,86942027,1324.53,1,"Away some sound establish information affect there. Between good appear a ok front.
Produce open ability several. Early almost former forward country.
Whom model themselves staff.",5:39:56,NEFT
DCTX14808940860840,GB94WWYR43460145320993,1/28/2015,31609.2,100001,Y,Medicals,EDGE,POS,Dr,7:36:59,9:16:07,9/11/2018,90633447,1324.53,4,"Cut east yet create life. Why professor head general start against. Set face level avoid.
Full imagine join remain also art most. Rich blood song see.",8:06:57,UPI
DCTX14808940860840,GB94WWYR43460145320993,1/28/2015,32933.73,100001,N,Credited,SAFARI,PC,Cr,13:45:12,15:26:15,9/11/2018,50795116,1324.53,1,Determine together family argue public candidate case. Hard north paper physical financial image discuss. All think recently for. Happen run down pull actually.,14:16:45,NEFT
DCTX14808940860840,GB94WWYR43460145320993,1/28/2015,34258.26,100001,N,Credited,IE,MOBILE,Cr,15:59:19,18:37:17,9/11/2018,76363542,1324.53,7,Big explain purpose military lot. Indicate safe job head. Type stop remain Democrat account again will.,16:54:13,DD
DCTX14808940860840,GB94WWYR43460145320993,1/28/2015,32933.73,100001,Y,Online Shopping,OPERA,PC,Dr,21:38:02,24:39:40,9/11/2018,28425427,1324.53,7,Decade report consumer clearly live health. Blood grow others environment effort. Sense from member against. Major social none where probably method.,22:51:42,DD
DCTX14808940860840,GB94WWYR43460145320993,1/28/2015,31096.65,100001,Y,Insurance,CHROME,MOBILE,Dr,2:25:20,5:32:04,9/18/2018,74016938,1837.08,6,Speech face team reveal. Professor wall garden sense side later. Bed month building available. Arrive let help through.,4:07:00,CHEQUE
DCTX14808940860840,GB94WWYR43460145320993,1/28/2015,29259.57,100001,Y,Entertainment,EDGE,POS,Dr,7:49:51,11:00:25,9/18/2018,82538903,1837.08,6,"New wall newspaper sport stage sport strong. Early newspaper ask raise.
Real often whole director including student. Movie unit yeah economy.",9:07:34,CHEQUE
DCTX14808940860840,GB94WWYR43460145320993,1/28/2015,31096.65,100001,N,Credited,IE,MOBILE,Cr,13:03:41,15:47:14,9/18/2018,50144723,1837.08,3,"Interesting walk song situation. Crime value agency game shake respond low. Voice hold more up set yeah tax lead.
Citizen culture kitchen rock. College poor next painting management those newspaper.",13:56:19,RTGS
DCTX14808940860840,GB94WWYR43460145320993,1/28/2015,29259.57,100001,Y,Insurance,OPERA,POS,Dr,16:03:49,17:03:35,9/18/2018,35319092,1837.08,1,Close reality show artist bank many help happy. Lead dream none early on.,16:31:13,NEFT
DCTX14808940860840,GB94WWYR43460145320993,1/28/2015,27422.49,100001,Y,Insurance,OPERA,MOBILE,Dr,20:08:29,23:23:51,9/18/2018,26827421,1837.08,4,"Put care country crime. Sister again focus develop plant.
Until across why drop newspaper fill stage.",21:40:10,UPI
DCTX14808940860840,GB94WWYR43460145320993,1/28/2015,26025.2,100001,Y,Medicals,MI,MOBILE,Dr,7:01:52,8:49:42,9/28/2018,95298139,1397.29,4,"Here tell sister top real director support thus. Own consider give.
Wide serve turn treatment choose serve.",7:56:54,UPI
DCTX14808940860840,GB94WWYR43460145320993,1/28/2015,24627.91,100001,Y,Online Shopping,MI,POS,Dr,11:31:52,14:56:49,9/28/2018,92662124,1397.29,6,"Sea indeed though all.
Safe stop draw while today before occur here. Area number lay turn.
Seat within low officer visit smile.",12:53:24,CHEQUE
DCTX14808940860840,GB94WWYR43460145320993,1/28/2015,26025.2,100001,N,Credited,CHROME,POS,Cr,17:18:54,20:07:50,9/28/2018,24854856,1397.29,6,"Crime top close summer. Opportunity family son simple.
Upon part item agreement produce step analysis imagine.
Shake give tonight series. None military far second.",19:04:16,CHEQUE
DCTX14808940860840,GB94WWYR43460145320993,1/28/2015,24798.49,100001,Y,Online Shopping,FF,MOBILE,Dr,3:34:56,4:38:33,10/1/2018,14191732,1226.71,6,Responsibility you audience fight task benefit source. Enter stage send painting firm. Provide woman reduce morning glass decision.,4:13:42,CHEQUE
DCTX14808940860840,GB94WWYR43460145320993,1/28/2015,26025.2,100001,N,Credited,IE,MOBILE,Cr,9:46:41,12:25:39,10/1/2018,97062899,1226.71,4,Investment amount size information. Wife affect various his accept wear type. Throw make form police window.,10:57:33,UPI
DCTX14808940860840,GB94WWYR43460145320993,1/28/2015,24798.49,100001,Y,Entertainment,FF,POS,Dr,12:47:33,15:18:41,10/1/2018,29190263,1226.71,2,"Tonight particularly fly dream herself behavior.
Apply subject now defense past need. According support natural relationship. Rule view factor push.",13:51:43,IMPS
DCTX14808940860840,GB94WWYR43460145320993,1/28/2015,26025.2,100001,N,Credited,FF,MOBILE,Cr,17:31:30,21:10:56,10/1/2018,40881843,1226.71,2,Such already community never. Itself soldier figure discover white better. Peace me catch gun lay maintain agreement what. Challenge soldier fear manager agree from argue necessary.,19:27:01,IMPS
DCTX14808940860840,GB94WWYR43460145320993,1/28/2015,27251.91,100001,N,Credited,EDGE,MOBILE,Cr,19:35:15,22:12:46,10/1/2018,45145803,1226.71,2,"Example especially ask behind upon away us. Behavior spring window fine debate. Modern him offer.
Pressure with support stop mouth.",20:31:54,IMPS
DCTX14808940860840,GB94WWYR43460145320993,1/28/2015,29184.04,100001,N,Credited,CHROME,MOBILE,Cr,4:12:37,5:52:13,10/5/2018,81274901,1932.13,4,"Represent should cut game son camera. Air one military everyone.
Cover garden statement form page admit in. Spring while international meeting cup community. Hotel result wife. Far already adult.",4:49:54,UPI
DCTX14808940860840,GB94WWYR43460145320993,1/28/2015,31116.17,100001,N,Credited,EDGE,PC,Cr,8:52:20,10:07:32,10/5/2018,60783714,1932.13,2,Bag tonight third space southern family. Most morning happen central nature. Than tough score action western detail.,9:18:55,IMPS
DCTX14808940860840,GB94WWYR43460145320993,1/28/2015,33048.3,100001,N,Credited,EDGE,PC,Cr,13:35:40,15:48:20,10/5/2018,60848222,1932.13,1,"You toward magazine benefit close.
Season outside still two suddenly. Work themselves sure four prevent account.
Teach along above PM. Challenge present yourself ask girl south.",14:32:02,NEFT
DCTX14808940860840,GB94WWYR43460145320993,1/28/2015,34980.43,100001,N,Credited,FF,MOBILE,Cr,17:13:46,19:48:02,10/5/2018,827492,1932.13,4,Treatment trip peace one. Process government move stop physical since small forward.,18:20:42,UPI
DCTX14808940860840,GB94WWYR43460145320993,1/28/2015,36912.56,100001,N,Credited,MI,POS,Cr,23:10:45,24:49:44,10/5/2018,10585412,1932.13,2,"Those spend service know red themselves. Firm know card anyone near quite.
Person summer culture art great can.",23:57:31,IMPS
DCTX14808940860840,GB94WWYR43460145320993,1/28/2015,35017.78,100001,Y,Utilities,CHROME,POS,Dr,14:24:23,19:09:22,10/9/2018,40334141,1894.78,4,"About also sea face whom pattern. Business stage plan answer.
Notice kid force sport American. Cell organization with. Usually follow court sign floor future role.",15:58:17,UPI
DCTX14808940860840,GB94WWYR43460145320993,1/28/2015,36912.56,100001,N,Credited,SAFARI,PC,Cr,18:19:57,23:19:44,10/9/2018,47705142,1894.78,3,Though sport over forward red become. Rest consumer interest chair. Dog participant himself decide consumer practice.,21:17:51,RTGS
DCTX14808940860840,GB94WWYR43460145320993,1/28/2015,34913.11,100001,Y,Transportation,MI,POS,Dr,4:55:18,12:25:22,10/19/2018,33368894,1999.45,4,School executive himself never some create control. Threat know part sometimes his for. Ready pick choice ten organization.,8:35:04,UPI
DCTX14808940860840,GB94WWYR43460145320993,1/28/2015,32913.66,100001,Y,Personal Care,SAFARI,POS,Dr,18:31:53,20:24:41,10/19/2018,5531639,1999.45,3,"Money bar young executive dark. Brother hard late human I.
Imagine trouble and magazine discuss teach. Unit meet Mrs her. Quite north class minute explain look.",19:25:20,RTGS
DCTX14808940860840,GB94WWYR43460145320993,1/28/2015,32323.83,100001,Y,Entertainment,FF,MOBILE,Dr,8:36:40,11:25:50,10/29/2018,37507152,589.83,2,"Too shake attorney seat begin name shake. Late foreign drive once.
Perform knowledge the impact. Value religious run.
Least evening while task fund. Board next consumer be.",9:37:21,IMPS
DCTX14808940860840,GB94WWYR43460145320993,1/28/2015,31734,100001,Y,Dining,MI,PC,Dr,14:15:40,16:19:25,10/29/2018,79789042,589.83,6,Imagine wife area also. Person guess run expert hard hope this. Add occur western poor face evidence image.,15:04:38,CHEQUE
DCTX14808940860840,GB94WWYR43460145320993,1/28/2015,31144.17,100001,Y,Transportation,SAFARI,MOBILE,Dr,20:25:30,24:04:19,10/29/2018,96940341,589.83,1,This will southern condition night those. Model water ok certain turn nation water drop.,22:53:18,NEFT
DCTX14808940860840,GB94WWYR43460145320993,1/28/2015,29307.78,100001,Y,Utilities,FF,MOBILE,Dr,7:08:13,9:54:27,11/7/2018,60623386,1836.39,7,"Lot understand ask difficult half direction. International beautiful contain rather course free.
Most yes somebody hotel including former. Have upon interview task.
Skin east instead.",8:38:28,DD
DCTX14808940860840,GB94WWYR43460145320993,1/28/2015,27471.39,100001,Y,Online Shopping,OPERA,MOBILE,Dr,14:49:51,17:45:29,11/7/2018,31082075,1836.39,1,"Choose window Republican take. Mrs manage read.
Boy everything civil feel situation industry. The none pattern. Evidence some goal fly carry own senior. City watch past.",16:29:55,NEFT
DCTX14808940860840,GB94WWYR43460145320993,1/28/2015,29307.78,100001,N,Credited,CHROME,PC,Cr,18:06:25,21:38:19,11/7/2018,84135070,1836.39,6,Hand trip eight. Nearly door feel design. Meet evidence it anyone week water.,19:33:24,CHEQUE
DCTX14808940860840,GB94WWYR43460145320993,1/28/2015,30789.57,100001,N,Credited,CHROME,MOBILE,Cr,4:35:41,10:07:40,11/12/2018,38644276,1481.79,6,Without turn film citizen itself of build. Into avoid mean into laugh huge ready. Business specific whatever after.,8:26:26,CHEQUE
DCTX14808940860840,GB94WWYR43460145320993,1/28/2015,29307.78,100001,Y,Dining,FF,POS,Dr,15:21:03,20:02:12,11/12/2018,90741081,1481.79,7,Prevent little rest simple growth actually program. We cell accept less turn drop lead.,18:34:02,DD
DCTX14808940860840,GB94WWYR43460145320993,1/28/2015,29525.68,100001,N,Credited,FF,MOBILE,Cr,9:03:02,12:46:01,11/22/2018,70095074,217.9,1,Sell anything this light stop. College imagine fight feel within today pretty. Challenge it through trouble wide.,10:44:58,NEFT
DCTX14808940860840,GB94WWYR43460145320993,1/28/2015,29307.78,100001,Y,Rent,CHROME,POS,Dr,11:04:03,16:28:32,11/22/2018,62736749,217.9,3,"Worker front environment power. Matter writer final reality. Thing analysis model difference star tax speech.
State bring soon her admit instead campaign. Newspaper budget daughter field stop.",13:40:40,RTGS
DCTX14808940860840,GB94WWYR43460145320993,1/28/2015,29089.88,100001,Y,Household Consumables,CHROME,MOBILE,Dr,21:23:02,26:04:51,11/22/2018,22128126,217.9,3,"Beat here model board toward. Usually page the accept.
Color tonight determine each safe word reality. Argue daughter realize hour long thank computer. Book arrive daughter concern where majority.",23:23:00,RTGS
DCTX14808940860840,GB94WWYR43460145320993,1/28/2015,27454.97,100001,Y,Dining,OPERA,MOBILE,Dr,6:33:23,9:40:27,11/25/2018,39753991,1634.91,2,"Finish require different hold animal. Play matter people interest most word concern.
Special science good reason actually fight nature inside. Gas each leg strategy.",8:51:42,IMPS
DCTX14808940860840,GB94WWYR43460145320993,1/28/2015,25820.06,100001,Y,Rent,IE,PC,Dr,10:07:52,13:08:59,11/25/2018,67627301,1634.91,3,Expect him even serious first nation. Him significant participant. Age crime box tax. Despite foot politics product man star.,11:31:49,RTGS
DCTX14808940860840,GB94WWYR43460145320993,1/28/2015,24185.15,100001,Y,Online Shopping,SAFARI,MOBILE,Dr,14:20:50,17:35:28,11/25/2018,82758721,1634.91,3,"Minute I happy. Blood writer listen charge hand.
Bar head home later. Direction find share animal word. His again result fund.",15:21:34,RTGS
DCTX14808940860840,GB94WWYR43460145320993,1/28/2015,25820.06,100001,N,Credited,IE,MOBILE,Cr,23:12:03,24:30:55,11/25/2018,48696845,1634.91,6,"Serious loss appear PM. Agency prevent political line maintain agency finally. Produce owner watch.
Form operation next tough class over. Again let structure lose report of few.",23:42:25,CHEQUE
DCTX14808940860840,GB94WWYR43460145320993,1/28/2015,26702.63,100001,N,Credited,MI,PC,Cr,17:25:51,28:51:01,11/28/2018,47590137,882.57,7,Day improve model month Republican. I blue other voice state. Bit natural air crime.,23:25:27,DD
DCTX14808940860840,GB94WWYR43460145320993,1/28/2015,26791.89,100001,N,Credited,SAFARI,POS,Cr,3:43:12,6:02:02,11/30/2018,20405106,89.26,2,"Better although require opportunity let. Couple early one less line else soon.
Product before produce my off. Short guess deal work. Trade kid factor film difference doctor interesting.",5:00:53,IMPS
DCTX14808940860840,GB94WWYR43460145320993,1/28/2015,26881.15,100001,N,Credited,CHROME,PC,Cr,7:01:28,9:17:09,11/30/2018,71485157,89.26,4,"Of short may cold land wall. Wind house coach identify exactly. Better head evening top certain whatever everything.
Serve about maybe official. Drop defense huge. Item pick join small fly.",8:16:11,UPI
DCTX14808940860840,GB94WWYR43460145320993,1/28/2015,26791.89,100001,Y,Household Consumables,EDGE,MOBILE,Dr,13:01:29,16:03:09,11/30/2018,99128142,89.26,2,"Nature training finish defense. Good majority on true increase effect.
Must hotel also structure key people challenge. Degree color mention pass how audience develop.",14:15:04,IMPS
DCTX14808940860840,GB94WWYR43460145320993,1/28/2015,26881.15,100001,N,Credited,MI,MOBILE,Cr,17:38:57,19:41:20,11/30/2018,48678896,89.26,5,Gun field do light pass blue force hard. Bank hard walk everyone. The only life most majority film social drive.,18:12:45,CARDS
DCTX14808940860840,GB94WWYR43460145320993,1/28/2015,26791.89,100001,Y,Personal Care,CHROME,MOBILE,Dr,21:28:45,23:47:04,11/30/2018,90565915,89.26,3,"Politics central network front as. Sound public election admit center audience wait.
Which dark beautiful. American position about body professional meet. Lose central public page.",22:23:47,RTGS
DCTX14808940860840,GB94WWYR43460145320993,1/28/2015,26994.75,100001,N,Credited,SAFARI,POS,Cr,3:11:43,5:46:42,12/1/2018,84506368,202.86,7,"Consumer available none current however reduce series. Reduce cell series between child.
Effect special care artist company operation. Organization into son never these.",5:09:52,DD
DCTX14808940860840,GB94WWYR43460145320993,1/28/2015,26791.89,100001,Y,Household Consumables,FF,MOBILE,Dr,7:46:59,9:51:36,12/1/2018,76546778,202.86,2,"Card catch choose big table day. Open old consider knowledge animal.
Let shake quality argue executive single.",8:33:36,IMPS
DCTX14808940860840,GB94WWYR43460145320993,1/28/2015,26994.75,100001,N,Credited,SAFARI,PC,Cr,12:58:21,15:46:00,12/1/2018,82685546,202.86,5,Movie record now serve degree modern. Receive outside none common meeting person. Side boy building serious keep why.,13:54:01,CARDS
DCTX14808940860840,GB94WWYR43460145320993,1/28/2015,26791.89,100001,Y,Groceries,OPERA,PC,Dr,18:47:21,21:13:34,12/1/2018,70872521,202.86,3,"Use beyond real direction whatever. Surface seem eight method.
Black own compare list film million. A return well support finally step decision. Science season only debate thank.",19:22:14,RTGS
DCTX14808940860840,GB94WWYR43460145320993,1/28/2015,26994.75,100001,N,Credited,OPERA,MOBILE,Cr,18:30:38,21:30:29,12/1/2018,16210219,202.86,3,"Moment finish what step. Through put seven we key easy. Size every range if.
Field couple including admit bit.
Along exist ball begin employee. Generation position network resource catch official.",20:12:37,RTGS
DCTX14808940860840,GB94WWYR43460145320993,1/28/2015,26841.92,100001,Y,Online Shopping,OPERA,POS,Dr,3:28:10,6:54:26,12/4/2018,67540433,152.83,6,"Benefit face hit enough. Mean win continue husband growth along when.
Indeed market guy remember employee newspaper shake plant. Indicate fly data hotel.",5:17:43,CHEQUE
DCTX14808940860840,GB94WWYR43460145320993,1/28/2015,26689.09,100001,Y,Online Shopping,OPERA,MOBILE,Dr,9:02:31,10:16:47,12/4/2018,79914390,152.83,1,Commercial star thousand the. City form hear quality beautiful. Right somebody whether. Half live scene plan require.,9:39:32,NEFT
DCTX14808940860840,GB94WWYR43460145320993,1/28/2015,26536.26,100001,Y,Personal Care,IE,MOBILE,Dr,11:20:37,13:05:44,12/4/2018,65186145,152.83,3,Business however himself though admit million expect push. Them fly while too those.,12:03:13,RTGS
DCTX14808940860840,GB94WWYR43460145320993,1/28/2015,26689.09,100001,N,Credited,SAFARI,MOBILE,Cr,16:40:42,19:34:17,12/4/2018,65517666,152.83,4,"But opportunity law light stuff him.
Bill within item country share design eye maybe. Quite center seem sing their last. Daughter must within. Minute heavy law he heart.",17:56:07,UPI
DCTX14808940860840,GB94WWYR43460145320993,1/28/2015,26841.92,100001,N,Credited,OPERA,POS,Cr,20:38:47,22:52:14,12/4/2018,97511632,152.83,2,Perform situation south music heavy consider truth hair. Travel read drive small you later wind.,22:19:16,IMPS
DCTX14808940860840,GB94WWYR43460145320993,1/28/2015,25579.91,100001,Y,Groceries,OPERA,MOBILE,Dr,8:07:55,12:56:13,12/5/2018,42105572,1262.01,5,"Stock create remain thing get senior. Take moment thought always.
Wide happen woman series affect be. Trial somebody off training argue thus want whom. Executive watch allow table bill and.",9:56:54,CARDS
DCTX14808940860840,GB94WWYR43460145320993,1/28/2015,24317.9,100001,Y,Utilities,EDGE,MOBILE,Dr,14:49:12,22:25:03,12/5/2018,44565121,1262.01,3,"Career strong color hear part. Task house court statement writer but. Career will young actually.
Magazine land agent audience. Appear money hit important.",18:25:43,RTGS
DCTX14808940860840,GB94WWYR43460145320993,1/28/2015,24927.62,100001,N,Credited,OPERA,POS,Cr,6:07:06,9:46:03,12/8/2018,50540044,609.72,1,"Decision their least chance. Give against actually. Future require big. Space explain against somebody professional season evidence.
Cost act make enjoy generation.",6:46:40,NEFT
DCTX14808940860840,GB94WWYR43460145320993,1/28/2015,24317.9,100001,Y,Groceries,CHROME,MOBILE,Dr,10:03:51,14:08:17,12/8/2018,29376858,609.72,6,About tonight drive financial. Activity professor teach final conference life. Executive center need imagine nation whatever computer.,12:49:57,CHEQUE
DCTX14808940860840,GB94WWYR43460145320993,1/28/2015,23708.18,100001,Y,Online Shopping,EDGE,POS,Dr,15:06:32,19:12:14,12/8/2018,2702780,609.72,5,"Hold what but floor. Bar determine sign various finish message away without.
Like per fast sense remain say. Quality notice live. Try season watch appear others determine describe pick.",18:06:02,CARDS
DCTX14808940860840,GB94WWYR43460145320993,1/28/2015,24893.38,100001,N,Credited,MI,POS,Cr,14:27:36,18:38:13,12/15/2018,32466409,1185.2,7,Most finish sense table blood husband. Early anything recognize in return while information next.,16:06:11,DD
DCTX14808940860840,GB94WWYR43460145320993,1/28/2015,23045.91,100001,Y,Utilities,OPERA,POS,Dr,6:26:24,8:59:57,12/21/2018,96945339,1847.47,2,"Career far what.
Turn peace health family. Health music eight a hear ability point. Sound serious election process sure alone threat.",7:27:44,IMPS
DCTX14808940860840,GB94WWYR43460145320993,1/28/2015,24893.38,100001,N,Credited,IE,POS,Cr,16:22:55,19:41:26,12/21/2018,50246496,1847.47,1,"Peace entire among. Training require protect person with.
Wish across stage who. Capital example throw soon western.",17:08:56,NEFT
DCTX14808940860840,GB94WWYR43460145320993,1/28/2015,23045.91,100001,Y,Transportation,CHROME,MOBILE,Dr,17:43:36,20:00:47,12/21/2018,60166388,1847.47,4,Six most most teacher appear trouble despite dream. Number you note report color official stand. Professional measure direction prevent event culture. Member institution trouble.,18:34:56,UPI
DCTX14808940860840,GB94WWYR43460145320993,1/28/2015,22029.05,100001,Y,Rent,FF,POS,Dr,5:21:36,8:23:27,1/15/2019,69112041,1016.86,6,"Certainly must major. Level down decision market arrive claim.
Note television deep clear fly consumer still. Trouble happen would compare lot key agency.",7:04:26,CHEQUE
DCTX14808940860840,GB94WWYR43460145320993,1/28/2015,21012.19,100001,Y,Insurance,EDGE,POS,Dr,8:46:28,12:08:18,1/15/2019,9988323,1016.86,1,"Oil wonder population tonight for. Least strong issue action agree fall program.
Research college thousand agent. Gas skin however customer. Land about the family charge always.",9:49:24,NEFT
DCTX14808940860840,GB94WWYR43460145320993,1/28/2015,22029.05,100001,N,Credited,SAFARI,PC,Cr,15:09:14,17:47:30,1/15/2019,27956731,1016.86,5,"Seek theory mother want. Increase professor always concern story player present.
Beyond year office each site strategy. Relate someone himself. Federal task of I four only.",15:44:04,CARDS
DCTX14808940860840,GB94WWYR43460145320993,1/28/2015,23045.91,100001,N,Credited,CHROME,PC,Cr,22:23:29,25:23:41,1/15/2019,13453183,1016.86,1,"Campaign world wish page far industry. Audience finally community remember bit.
Large evening worry since letter perhaps nothing. Management term church figure. Early physical turn which.",23:01:07,NEFT
DCTX14808940860840,GB94WWYR43460145320993,1/28/2015,22060.6,100001,Y,Utilities,MI,PC,Dr,5:02:32,7:16:37,1/19/2019,49521474,985.31,7,"Hair movie room medical administration heavy. Democratic suggest nearly worry.
Girl cause night training smile. Movement skin sign set. Participant matter water head your.",5:50:56,DD
DCTX14808940860840,GB94WWYR43460145320993,1/28/2015,23045.91,100001,N,Credited,IE,PC,Cr,10:08:43,11:35:11,1/19/2019,89986301,985.31,5,Near wish authority opportunity. News speech peace push can or resource. Program them military politics plant. Industry traditional each wife movie actually.,10:46:50,CARDS
DCTX14808940860840,GB94WWYR43460145320993,1/28/2015,22060.6,100001,Y,Household Consumables,CHROME,PC,Dr,14:55:03,19:11:14,1/19/2019,72960479,985.31,3,"Medical small leg itself walk activity threat. Early our fear college. Four race method usually how.
Impact kind white like indicate mother.",17:06:19,RTGS
DCTX14808940860840,GB94WWYR43460145320993,1/28/2015,23045.91,100001,N,Credited,EDGE,MOBILE,Cr,22:19:20,25:00:51,1/19/2019,4590446,985.31,3,"Evening difficult technology. Either eight model leave wife word.
Significant could story day level performance on sister. Kid late view hour. Drive for many onto.",23:29:00,RTGS
DCTX14808940860840,GB94WWYR43460145320993,1/28/2015,21801.55,100001,Y,Online Shopping,SAFARI,POS,Dr,8:32:37,11:14:06,1/26/2019,16455832,1244.36,7,"Available pretty allow small camera. Language mother that strategy group tree. Need learn business piece.
Center sound oil impact. His while third morning.",9:17:27,DD
DCTX14808940860840,GB94WWYR43460145320993,1/28/2015,23045.91,100001,N,Credited,MI,POS,Cr,13:54:33,17:45:25,1/26/2019,37146542,1244.36,2,"Story late sell my. Fine wind south prevent response.
Military production moment right stay amount. Fall finish Mr.
Floor most team drop talk help executive. Hospital open reflect see feel.",15:17:15,IMPS
DCTX14808940860840,GB94WWYR43460145320993,1/28/2015,21801.55,100001,Y,Utilities,SAFARI,PC,Dr,18:55:17,23:41:12,1/26/2019,6715205,1244.36,6,"Cup who find itself serve. Bad fish even. Difficult society meeting at party.
Feeling yes answer similar other else. Coach data prevent choice loss represent.",21:15:35,CHEQUE
DCTX14808940860840,GB94WWYR43460145320993,1/28/2015,21409.36,100001,Y,Insurance,CHROME,PC,Dr,4:49:32,7:46:20,2/5/2019,17120432,392.19,2,Seven bring focus cut personal pattern part professor. Treat would leave know right now candidate. Population raise under baby scene wrong.,6:39:04,IMPS
DCTX14808940860840,GB94WWYR43460145320993,1/28/2015,21017.17,100001,Y,Insurance,MI,MOBILE,Dr,9:18:28,12:45:49,2/5/2019,59530657,392.19,7,"Good ground myself yard. Size money itself week. Clear question item idea.
Large be sell manager. Summer rather decision trade hundred soon view.",10:27:42,DD
DCTX14808940860840,GB94WWYR43460145320993,1/28/2015,20624.98,100001,Y,Personal Care,SAFARI,POS,Dr,16:13:05,18:56:16,2/5/2019,15408372,392.19,4,Industry quite world throw bad movie. Assume very candidate course see. Cup decision door front treatment short might wall.,16:52:19,UPI
DCTX14808940860840,GB94WWYR43460145320993,1/28/2015,21017.17,100001,N,Credited,OPERA,PC,Cr,21:00:30,25:03:27,2/5/2019,57103655,392.19,7,"Successful true cause action eye speech do alone.
Key yet way lot. She history lawyer magazine health job feeling. Window nature against final others.",22:59:03,DD
DCTX14808940860840,GB94WWYR43460145320993,1/28/2015,21795.79,100001,N,Credited,MI,PC,Cr,5:09:22,8:16:42,2/18/2019,8880512,778.62,5,Across tend spring leader team husband. He boy their final boy nation.,6:46:07,CARDS
DCTX14808940860840,GB94WWYR43460145320993,1/28/2015,22574.41,100001,N,Credited,CHROME,PC,Cr,9:11:57,10:36:53,2/18/2019,80753803,778.62,7,Before politics story go thus billion. Build magazine when product. Day like here bad down stock safe.,9:57:20,DD
DCTX14808940860840,GB94WWYR43460145320993,1/28/2015,21795.79,100001,Y,Rent,MI,PC,Dr,16:13:10,19:43:30,2/18/2019,10776285,778.62,3,"Today argue tough consumer history price.
Deep clearly skin increase PM. Act out court cause trip PM type. Meet various mention pay argue way especially end.",17:33:44,RTGS
DCTX14808940860840,GB94WWYR43460145320993,1/28/2015,21017.17,100001,Y,Transportation,FF,MOBILE,Dr,20:12:32,23:16:48,2/18/2019,53918048,778.62,6,Station condition discover general our owner born. Chair special between people education human. Clearly thought tell loss type thousand south method.,22:30:21,CHEQUE
DCTX14808940860840,GB94WWYR43460145320993,1/28/2015,20148.5,100001,Y,Household Consumables,SAFARI,PC,Dr,6:05:21,8:59:59,2/20/2019,94390476,868.67,5,Nature outside collection move know car world. Set company night TV prove. Week simple rest actually include myself even magazine.,8:03:56,CARDS
DCTX14808940860840,GB94WWYR43460145320993,1/28/2015,21017.17,100001,N,Credited,CHROME,MOBILE,Cr,9:59:39,12:02:49,2/20/2019,40756981,868.67,3,Remember budget month I indeed fine involve. Interest rule second modern today pretty treat. Particular administration almost compare record sense level.,10:50:39,RTGS
DCTX14808940860840,GB94WWYR43460145320993,1/28/2015,21885.84,100001,N,Credited,OPERA,PC,Cr,16:50:24,19:11:46,2/20/2019,87579581,868.67,2,"Consider buy money nearly response course. Woman scene top choose film.
You fear education purpose.
Kid oil necessary how best name. Center full population star clearly.",18:39:55,IMPS
DCTX14808940860840,GB94WWYR43460145320993,1/28/2015,22754.51,100001,N,Credited,SAFARI,PC,Cr,19:42:55,22:58:58,2/20/2019,64071602,868.67,7,Make act heart theory source try. Author force reality. Rich sister impact deep learn simple.,21:23:57,DD
DCTX14808940860840,GB94WWYR43460145320993,1/28/2015,21362.22,100001,Y,Personal Care,CHROME,POS,Dr,6:51:18,9:22:47,2/24/2019,49404258,1392.29,7,"East behavior yard benefit. Building lead affect. Republican prevent value analysis.
Truth too mother. Offer significant per different lot without car. Seek body rich land human.",7:54:26,DD
DCTX14808940860840,GB94WWYR43460145320993,1/28/2015,19969.93,100001,Y,Medicals,EDGE,POS,Dr,7:00:43,8:54:21,2/24/2019,40634913,1392.29,3,"General federal sure either. Strategy growth bag.
Senior too order social party couple. Carry couple series nice result feeling. Particular opportunity second who.",8:02:44,RTGS
DCTX14808940860840,GB94WWYR43460145320993,1/28/2015,18577.64,100001,Y,Entertainment,EDGE,PC,Dr,11:27:53,14:11:04,2/24/2019,24099370,1392.29,2,Serious year institution organization budget. Serve support same letter Republican.,12:17:13,IMPS
DCTX14808940860840,GB94WWYR43460145320993,1/28/2015,19969.93,100001,N,Credited,FF,POS,Cr,14:30:13,18:08:08,2/24/2019,64253077,1392.29,6,Difference build know amount. Move perform soon. Administration statement could true professional that.,16:17:35,CHEQUE
DCTX14808940860840,GB94WWYR43460145320993,1/28/2015,21362.22,100001,N,Credited,EDGE,POS,Cr,20:59:56,24:28:34,2/24/2019,21510779,1392.29,2,But receive least another receive identify along. Everyone picture stock particular right test.,22:44:51,IMPS
DCTX14808940860840,GB94WWYR43460145320993,1/28/2015,22868.31,100001,N,Credited,EDGE,POS,Cr,3:44:08,6:05:49,3/8/2019,37450755,1506.09,1,"Center player region per score. Reason seven state blood leg treatment wall. Nearly account accept.
Owner conference friend drug need push indeed. Others Mrs common act stay answer increase peace.",5:34:09,NEFT
DCTX14808940860840,GB94WWYR43460145320993,1/28/2015,24374.4,100001,N,Credited,FF,PC,Cr,9:12:13,11:14:07,3/8/2019,94418491,1506.09,3,Accept age night once provide decision. Cold choice yard more player many. We close point and forward maybe quality.,10:23:06,RTGS
DCTX14808940860840,GB94WWYR43460145320993,1/28/2015,22868.31,100001,Y,Rent,MI,MOBILE,Dr,15:49:25,18:49:48,3/8/2019,97096061,1506.09,2,"Note if decision sister bank street. Tonight field occur general environmental thing. Few amount help seven piece.
Worry unit ready you. May natural far him third then near.",17:12:37,IMPS
DCTX14808940860840,GB94WWYR43460145320993,1/28/2015,24374.4,100001,N,Credited,FF,PC,Cr,20:35:42,22:19:26,3/8/2019,79937399,1506.09,4,Production surface attack deal foreign change doctor. Great can test he toward glass may court. Member hour amount energy scientist itself community.,21:32:47,UPI
DCTX14808940860840,GB94WWYR43460145320993,1/28/2015,23270.31,100001,Y,Household Consumables,OPERA,MOBILE,Dr,17:28:28,22:27:58,3/9/2019,92674080,1104.09,7,"Whom and south skill on federal.
City simply force base. Career technology scene respond fall guess.
Current various find will great realize ask age. Building if again knowledge.",18:46:13,DD
DCTX14808940860840,GB94WWYR43460145320993,1/28/2015,23520.19,100001,N,Credited,IE,PC,Cr,4:16:59,7:13:28,3/14/2019,76699665,249.88,7,Speak event say practice according foreign this. Notice player animal become do begin. Letter news born. Into ask bit will cultural early blue.,4:49:32,DD
DCTX14808940860840,GB94WWYR43460145320993,1/28/2015,23270.31,100001,Y,Entertainment,CHROME,PC,Dr,13:06:07,15:14:25,3/14/2019,55571012,249.88,4,"Name it also go board avoid two.
Bit production own TV worry bit live. Whose state price enough reflect. Teacher identify again at step chance push.",14:01:52,UPI
DCTX14808940860840,GB94WWYR43460145320993,1/28/2015,23020.43,100001,Y,Insurance,CHROME,POS,Dr,15:48:33,19:21:31,3/14/2019,74205271,249.88,6,"Floor trial method win. Political what when serve director firm.
Film opportunity billion head. Start never lay surface part. Officer soldier model rock.",16:58:02,CHEQUE
DCTX14808940860840,GB94WWYR43460145320993,1/28/2015,23270.31,100001,N,Credited,OPERA,PC,Cr,17:40:20,20:43:16,3/14/2019,97418108,249.88,6,Reach him leave someone. Past man great throughout church dog.,19:39:25,CHEQUE
DCTX14808940860840,GB94WWYR43460145320993,1/28/2015,22577.72,100001,Y,Insurance,OPERA,PC,Dr,21:06:10,28:35:53,3/29/2019,99351618,692.59,5,"Exactly red activity play movement. Note she bit common economic.
Everybody sign weight after. Join measure represent another wonder marriage.",23:29:01,CARDS
DCTX14808940860840,GB94WWYR43460145320993,1/28/2015,24009.03,100001,N,Credited,FF,MOBILE,Cr,7:04:06,8:27:55,4/2/2019,77742384,1431.31,7,"Box wear easy popular. Leave successful method hot because just true.
Consider under knowledge my. Product science age.
Value money skill religious. Whom boy trouble with. Mind this ask know.",7:50:14,DD
DCTX14808940860840,GB94WWYR43460145320993,1/28/2015,25440.34,100001,N,Credited,MI,PC,Cr,9:55:27,12:59:54,4/2/2019,4581512,1431.31,5,"Maintain family this difference top year. Size cause after analysis suffer former analysis.
Seek sign forget live TV certainly seem. Eat drug go step would.
Me continue mean. Time than claim TV walk.",11:47:37,CARDS
DCTX14808940860840,GB94WWYR43460145320993,1/28/2015,26871.65,100001,N,Credited,MI,PC,Cr,13:44:51,17:52:15,4/2/2019,78409682,1431.31,2,"American kid determine poor. Rock conference letter stand listen how price. And letter financial much force.
Admit finish someone dark market. Company page cell possible either discussion quickly.",15:59:41,IMPS
DCTX14808940860840,GB94WWYR43460145320993,1/28/2015,25440.34,100001,Y,Utilities,EDGE,MOBILE,Dr,19:44:08,22:34:04,4/2/2019,32829457,1431.31,6,"Organization understand off week pretty. Recent see four side. Entire travel type.
Of reality finally put wish green clear daughter. Would various minute young. Group exactly admit rich bag.",21:31:00,CHEQUE
DCTX14808940860840,GB94WWYR43460145320993,1/28/2015,25797.4,100001,N,Credited,EDGE,PC,Cr,8:10:18,10:12:37,4/14/2019,64897837,357.06,3,Detail operation cost discuss any attorney. Color myself my speak film force. List religious technology make.,9:21:52,RTGS
DCTX14808940860840,GB94WWYR43460145320993,1/28/2015,25440.34,100001,Y,Online Shopping,FF,PC,Dr,11:19:01,13:49:43,4/14/2019,94274424,357.06,6,"Late newspaper resource network me choice. Report sort century able sister. Serve leave get sense.
Tend pull arrive job.",12:37:28,CHEQUE
DCTX14808940860840,GB94WWYR43460145320993,1/28/2015,25797.4,100001,N,Credited,MI,POS,Cr,15:18:13,18:06:12,4/14/2019,96648254,357.06,2,Blue truth program billion life hot music. Reveal door myself personal best entire business.,16:51:30,IMPS
DCTX14808940860840,GB94WWYR43460145320993,1/28/2015,26154.46,100001,N,Credited,CHROME,POS,Cr,23:18:07,25:56:32,4/14/2019,23378841,357.06,5,"Into effect suffer own help apply discuss save.
Administration although along experience. Store effect instead attack.
Give draw strategy full throw cause discussion rate. Put on cultural leg.",23:56:12,CARDS
DCTX14808940860840,GB94WWYR43460145320993,1/28/2015,27693.6,100001,N,Credited,MI,PC,Cr,13:19:50,18:58:43,4/16/2019,78694538,1539.14,7,Certain degree question thing sing assume left future. Defense out start mission find sometimes. Gas tend run record. Laugh ready investment interesting skin.,15:42:55,DD
DCTX14808940860840,GB94WWYR43460145320993,1/28/2015,26154.46,100001,Y,Groceries,IE,POS,Dr,20:37:52,24:49:09,4/16/2019,58377024,1539.14,1,Answer billion stand. Onto break decision public why. Perform collection question heavy true cover light attack.,23:02:54,NEFT
DCTX14808940860840,GB94WWYR43460145320993,1/28/2015,24584.66,100001,Y,Rent,FF,PC,Dr,15:14:01,23:44:56,4/21/2019,80880653,1569.8,5,A marriage free popular role. Alone cut program man window name. Million play fine. Should big citizen animal new five choice line.,19:10:32,CARDS
DCTX14808940860840,GB94WWYR43460145320993,1/28/2015,26183.07,100001,N,Credited,MI,MOBILE,Cr,3:21:23,7:18:33,4/25/2019,84288936,1598.41,3,Although TV eat of your boy change. Detail life stuff much easy travel. Two various compare day.,5:43:55,RTGS
DCTX14808940860840,GB94WWYR43460145320993,1/28/2015,24584.66,100001,Y,Dining,OPERA,POS,Dr,9:55:00,13:30:15,4/25/2019,61513082,1598.41,5,"Sing speak deal represent ahead. Especially staff indicate help success position. Word hard prove weight.
Security subject bar enough former inside. Father maintain perhaps people across woman.",11:21:59,CARDS
DCTX14808940860840,GB94WWYR43460145320993,1/28/2015,26183.07,100001,N,Credited,CHROME,MOBILE,Cr,17:36:42,20:31:05,4/25/2019,43411603,1598.41,3,Age some skin skin. Like language consider administration everybody single Congress. Federal quite prepare usually offer place performance.,18:25:44,RTGS
DCTX14808940860840,GB94WWYR43460145320993,1/28/2015,24584.66,100001,Y,Entertainment,SAFARI,PC,Dr,19:56:29,23:19:57,4/25/2019,76646157,1598.41,6,Lawyer two discover charge. Political forget choose support perform least let.,21:55:46,CHEQUE
DCTX14808940860840,GB94WWYR43460145320993,1/28/2015,24391.62,100001,Y,Online Shopping,EDGE,MOBILE,Dr,6:40:07,10:11:04,5/2/2019,3987063,193.04,7,"Sign someone same spring history. Worry pass senior something. After seem big avoid.
Democrat huge expert technology ok body. Per car kind series sing. Spring charge lose often pick.",7:48:47,DD
DCTX14808940860840,GB94WWYR43460145320993,1/28/2015,24584.66,100001,N,Credited,EDGE,POS,Cr,14:06:19,17:18:22,5/2/2019,13090937,193.04,5,"Sound concern instead however military investment impact. Line during onto them we reduce.
Care political much table step. Reveal local whatever outside his. Environment standard bit administration.",16:28:28,CARDS
DCTX14808940860840,GB94WWYR43460145320993,1/28/2015,24777.7,100001,N,Credited,EDGE,POS,Cr,17:48:06,21:54:03,5/2/2019,67827558,193.04,5,"Sit try organization on call evidence. Plan may grow course.
Each question significant wife president medical occur special. Education suggest major concern trade red allow.",19:24:18,CARDS
DCTX14808940860840,GB94WWYR43460145320993,1/28/2015,22796.06,100001,Y,Rent,IE,PC,Dr,6:34:54,10:11:28,5/9/2019,30717954,1981.64,3,"Decision tree training. Maintain they company charge.
Someone best local together fund rock.
Theory far middle skill government computer race. When which drug learn.",9:03:50,RTGS
DCTX14808940860840,GB94WWYR43460145320993,1/28/2015,20814.42,100001,Y,Utilities,CHROME,MOBILE,Dr,12:25:59,15:56:59,5/9/2019,64016870,1981.64,4,Stop well by current challenge successful institution another. Team myself beyond day. Above truth fly.,14:08:27,UPI
DCTX14808940860840,GB94WWYR43460145320993,1/28/2015,18832.78,100001,Y,Insurance,CHROME,POS,Dr,22:47:32,25:24:11,5/9/2019,48977913,1981.64,3,"I attack as move recently. These everybody probably avoid manage travel. Represent thousand here sport lawyer.
Actually Mrs near effort few mouth teach. Let up about. So Democrat article as.",23:25:22,RTGS
DCTX14808940860840,GB94WWYR43460145320993,1/28/2015,19962.52,100001,N,Credited,SAFARI,POS,Cr,5:27:28,7:01:07,5/14/2019,28465393,1129.74,7,"Company decade accept company mission. Their practice herself billion rest each.
Group author draw quickly. Value probably guy. Of day record south. Smile yet either face.",6:21:00,DD
DCTX14808940860840,GB94WWYR43460145320993,1/28/2015,21092.26,100001,N,Credited,MI,PC,Cr,8:02:07,9:33:52,5/14/2019,91624666,1129.74,7,"Partner coach material fight peace purpose. Employee thought stage behavior doctor.
Threat decide possible citizen central current risk.",8:48:06,DD
DCTX14808940860840,GB94WWYR43460145320993,1/28/2015,22222,100001,N,Credited,SAFARI,POS,Cr,15:12:01,16:56:54,5/14/2019,46219084,1129.74,2,"Scientist but professional member heavy. Already adult writer participant along.
Agent husband change. Success performance us its wait page. Save north senior name executive act.",15:48:11,IMPS
DCTX14808940860840,GB94WWYR43460145320993,1/28/2015,23351.74,100001,N,Credited,MI,MOBILE,Cr,15:50:34,18:21:02,5/14/2019,49629033,1129.74,2,"Serve state about school.
Affect thing rich manager be short. System until build generation pretty up cup. Whatever defense south.",17:49:46,IMPS
DCTX14808940860840,GB94WWYR43460145320993,1/28/2015,24481.48,100001,N,Credited,MI,PC,Cr,19:33:56,22:21:04,5/14/2019,55302814,1129.74,3,"Risk fire finish especially rate.
Table game total past. Staff structure each very energy spend.",20:47:13,RTGS
DCTX14808940860840,GB94WWYR43460145320993,1/28/2015,24162.52,100001,Y,Insurance,FF,PC,Dr,9:20:50,14:02:01,5/23/2019,85682962,318.96,1,"People modern travel listen. Wonder four themselves station break station.
Experience blood clear. Radio book else large.",11:09:42,NEFT
DCTX14808940860840,GB94WWYR43460145320993,1/28/2015,24481.48,100001,N,Credited,EDGE,POS,Cr,17:03:32,20:23:46,5/23/2019,81896783,318.96,1,"Admit story show indicate thank last. Score city sort director.
Sound remain never spend new decide also service. Ground night action station difficult contain. Color focus only parent head.",18:33:37,NEFT
DCTX14808940860840,GB94WWYR43460145320993,1/28/2015,26349.42,100001,N,Credited,OPERA,PC,Cr,7:12:55,9:55:37,5/24/2019,73917885,1867.94,4,Worry key hand poor. Meeting item benefit successful despite. Smile almost chair first ability western.,7:49:11,UPI
DCTX14808940860840,GB94WWYR43460145320993,1/28/2015,28217.36,100001,N,Credited,CHROME,PC,Cr,12:38:03,15:14:02,5/24/2019,88785974,1867.94,2,These relate evidence five. Traditional simply within floor thus above. Knowledge college actually teacher star here scene. Lot still commercial talk treatment serious thing Republican.,13:18:40,IMPS
DCTX14808940860840,GB94WWYR43460145320993,1/28/2015,30085.3,100001,N,Credited,IE,POS,Cr,14:21:13,17:06:54,5/24/2019,36864584,1867.94,6,"Direction watch manager system should leg while.
Prove child close when strategy material. Else boy citizen their.
Name major spend kind. That hard future eat wonder camera personal.",15:08:18,CHEQUE
DCTX14808940860840,GB94WWYR43460145320993,1/28/2015,31953.24,100001,N,Credited,MI,POS,Cr,20:51:50,24:50:05,5/24/2019,21801037,1867.94,1,"Attorney large image grow hundred box gun.
Marriage establish small where. Mission heavy brother must light similar. Current message think economic drive.",22:26:12,NEFT
DCTX14808940860840,GB94WWYR43460145320993,1/28/2015,32138.04,100001,N,Credited,FF,MOBILE,Cr,8:18:54,10:49:26,5/28/2019,4173847,184.8,6,"Exactly high could dog thus among. Early member ok.
Style rule program get stop.
Camera animal prove. Election live able join.",9:03:03,CHEQUE
DCTX14808940860840,GB94WWYR43460145320993,1/28/2015,32322.84,100001,N,Credited,OPERA,PC,Cr,11:35:24,13:37:35,5/28/2019,54408449,184.8,4,Mean some allow player certainly stay. Morning character task. Each region side evening interesting travel sort especially.,12:12:51,UPI
DCTX14808940860840,GB94WWYR43460145320993,1/28/2015,32138.04,100001,Y,Medicals,SAFARI,POS,Dr,20:18:20,23:21:53,5/28/2019,27620410,184.8,7,"Heart and stand senior official establish school. Put choose include plan natural thing.
Full believe project consider card. Avoid which turn fly.",21:00:02,DD
DCTX14808940860840,GB94WWYR43460145320993,1/28/2015,32847.99,100001,N,Credited,OPERA,POS,Cr,4:29:23,6:51:55,5/30/2019,79529679,709.95,7,We car question rest not drug camera. Late here teach draw. Whatever generation indeed pretty require response heavy program.,6:26:39,DD
DCTX14808940860840,GB94WWYR43460145320993,1/28/2015,32138.04,100001,Y,Medicals,IE,MOBILE,Dr,9:07:08,11:23:33,5/30/2019,84998903,709.95,2,Poor body behind will prove spend notice. Perform glass option result. Direction perform low condition time glass future already.,10:17:25,IMPS
DCTX14808940860840,GB94WWYR43460145320993,1/28/2015,32847.99,100001,N,Credited,CHROME,MOBILE,Cr,14:50:30,17:02:40,5/30/2019,29798551,709.95,4,"Street close movement dinner. Do kitchen near mean process fish much imagine.
Close source draw dog similar myself yes.
Sure fall thousand with fall.
Past sit begin someone partner focus compare.",15:29:51,UPI
DCTX14808940860840,GB94WWYR43460145320993,1/28/2015,32138.04,100001,Y,Online Shopping,IE,MOBILE,Dr,15:18:36,17:13:23,5/30/2019,9766327,709.95,6,"Bit manage as kitchen skin. Form energy Mrs fund.
Different tree long check attention upon according. Consider drop model very let check civil.",16:05:37,CHEQUE
DCTX14808940860840,GB94WWYR43460145320993,1/28/2015,32847.99,100001,N,Credited,SAFARI,POS,Cr,21:55:48,24:07:39,5/30/2019,55561525,709.95,7,"Can mission question catch piece. Mission purpose only late purpose.
Realize year our we rock. Skill mind finally local.",23:22:59,DD
DCTX14808940860840,GB94WWYR43460145320993,1/28/2015,31364.37,100001,Y,Insurance,IE,PC,Dr,15:04:43,19:19:22,6/2/2019,95626048,1483.62,3,"Ten message wife next stock. Table cover rather evening industry top. Consider to base wind from also perhaps.
Issue doctor method PM. Evidence people than.",16:21:11,RTGS
DCTX14808940860840,GB94WWYR43460145320993,1/28/2015,30026.45,100001,Y,Entertainment,SAFARI,PC,Dr,5:12:39,8:24:40,6/5/2019,44216719,1337.92,6,"Quite modern get citizen coach answer rule. Professor rise small foreign current yet one run. Fact left effect game meeting.
Important father throw. Old window peace mind team great.",6:41:30,CHEQUE
DCTX14808940860840,GB94WWYR43460145320993,1/28/2015,31364.37,100001,N,Credited,SAFARI,PC,Cr,16:06:14,19:52:21,6/5/2019,21117756,1337.92,6,Value few certain hour recognize raise protect. Professor herself mean could particular southern cover claim. Authority perform this seat mention cultural.,17:19:37,CHEQUE
DCTX14808940860840,GB94WWYR43460145320993,1/28/2015,32702.29,100001,N,Credited,CHROME,PC,Cr,18:47:20,23:01:50,6/5/2019,22068330,1337.92,7,"Play fall general ahead present. Summer let room send side point seat.
Social work amount first action between. Raise break federal finish amount. Individual set hit space billion pick become war.",21:46:41,DD
DCTX14808940860840,GB94WWYR43460145320993,1/28/2015,34171.48,100001,N,Credited,CHROME,PC,Cr,5:15:12,7:33:10,6/6/2019,34828359,1469.19,4,"Republican own no eight attorney. Approach class time identify second prevent reality. Friend nothing case Mrs.
Himself feel recently by. Rise sound conference far along lawyer.",6:10:47,UPI
DCTX14808940860840,GB94WWYR43460145320993,1/28/2015,32702.29,100001,Y,Transportation,FF,MOBILE,Dr,10:19:38,12:08:04,6/6/2019,52838101,1469.19,1,"Direction practice four remember can writer action. Happen few conference report. Those writer choose magazine matter store.
Couple walk example. But high American fight.",11:37:39,NEFT
DCTX14808940860840,GB94WWYR43460145320993,1/28/2015,31233.1,100001,Y,Rent,OPERA,POS,Dr,13:30:55,15:48:45,6/6/2019,76541193,1469.19,3,"Continue happy form form eye get explain. Her tax attention beyond morning.
Responsibility age fine heavy.
Lawyer hard everything dinner indicate should. Believe can Mr while age around.",14:17:31,RTGS
DCTX14808940860840,GB94WWYR43460145320993,1/28/2015,29763.91,100001,Y,Groceries,IE,MOBILE,Dr,15:31:35,17:51:33,6/6/2019,8900548,1469.19,1,Despite prove simple picture would majority new. Again both citizen argue light. Traditional reach their industry field.,16:11:10,NEFT
DCTX14808940860840,GB94WWYR43460145320993,1/28/2015,31233.1,100001,N,Credited,OPERA,PC,Cr,19:48:53,22:24:18,6/6/2019,60102003,1469.19,5,Low hour baby entire they. Huge over audience teach type follow. Religious daughter table respond appear. Would avoid couple.,21:32:54,CARDS
DCTX14808940860840,GB94WWYR43460145320993,1/28/2015,29327.36,100001,Y,Insurance,CHROME,PC,Dr,3:33:56,8:41:06,6/24/2019,42975304,1905.74,1,"Now light organization oil note. Find others stand. Experience avoid least push.
Young better stand instead kind. Kid big against.",6:26:10,NEFT
DCTX14808940860840,GB94WWYR43460145320993,1/28/2015,31233.1,100001,N,Credited,EDGE,POS,Cr,12:19:04,15:05:24,6/24/2019,11135036,1905.74,6,Much kid east decade leg arm open. Prevent blue cell prove present candidate window. Drop participant election front.,13:40:58,CHEQUE
DCTX14808940860840,GB94WWYR43460145320993,1/28/2015,33138.84,100001,N,Credited,EDGE,POS,Cr,18:42:03,21:28:35,6/24/2019,78338722,1905.74,3,"There anyone operation sit where let others. Mean above scene suffer. Type end yard pay whether.
Degree condition ten continue. Goal forget man then station. Everything we dog learn star five choice.",20:33:36,RTGS
DCTX14808940860840,GB94WWYR43460145320993,1/28/2015,32122.44,100001,Y,Medicals,CHROME,PC,Dr,10:36:58,17:28:46,7/8/2019,45978791,1016.4,2,"Congress assume us pretty beyond read deep. Test base argue upon hot stage.
Way foreign organization thank modern. Space risk shake end.",13:53:08,IMPS
DCTX14808940860840,GB94WWYR43460145320993,1/28/2015,32119.96,100001,Y,Household Consumables,EDGE,POS,Dr,3:30:32,5:18:10,7/9/2019,55938921,2.48,2,By treat sit voice next along ground crime. International recently executive minute know practice analysis. Produce dog follow task each study. Everybody tough admit event.,4:52:29,IMPS
DCTX14808940860840,GB94WWYR43460145320993,1/28/2015,32117.48,100001,Y,Groceries,OPERA,POS,Dr,9:47:05,12:19:31,7/9/2019,62516020,2.48,2,"Reason party operation well. Bring notice somebody nothing Mrs if bit.
Heavy instead win leader key network owner.",10:34:18,IMPS
DCTX14808940860840,GB94WWYR43460145320993,1/28/2015,32115,100001,Y,Personal Care,CHROME,MOBILE,Dr,12:46:15,16:15:45,7/9/2019,74655663,2.48,5,"Least since travel agree choice. Through stop partner.
Carry south happy fall relate. Material institution direction yard son probably. Son condition heart line.",14:39:25,CARDS
DCTX14808940860840,GB94WWYR43460145320993,1/28/2015,32112.52,100001,Y,Utilities,IE,PC,Dr,17:01:59,20:10:34,7/9/2019,79316286,2.48,7,Product audience rate high listen. Nation within state. Interesting partner suffer example cut little.,18:49:34,DD
DCTX14808940860840,GB94WWYR43460145320993,1/28/2015,32110.04,100001,Y,Personal Care,SAFARI,PC,Dr,18:45:10,21:46:00,7/9/2019,19033655,2.48,1,"Difficult reason tax glass hold paper tonight age. Drive federal capital sea as stand determine require.
Born rest analysis issue room race.",20:35:51,NEFT
DCTX14808940860840,GB94WWYR43460145320993,1/28/2015,30295.42,100001,Y,Transportation,FF,PC,Dr,4:53:29,7:09:38,7/10/2019,83135088,1814.62,7,Magazine force type hour go others north everything. Record cause fire paper best Republican. Thought teacher people bad.,6:32:48,DD
DCTX14808940860840,GB94WWYR43460145320993,1/28/2015,28480.8,100001,Y,Household Consumables,FF,PC,Dr,6:45:38,8:44:38,7/10/2019,60151988,1814.62,2,Peace research cover of myself. Time worry suffer response present owner five. Much scientist race age right arrive.,8:08:45,IMPS
DCTX14808940860840,GB94WWYR43460145320993,1/28/2015,26666.18,100001,Y,Groceries,FF,PC,Dr,14:06:39,17:12:07,7/10/2019,74825127,1814.62,2,"Republican might Republican. Apply both just certainly smile.
Rich yourself always mouth level blood. Listen decision whose over firm particular. Economy sense cost writer rate two station value.",15:32:03,IMPS
DCTX14808940860840,GB94WWYR43460145320993,1/28/2015,24851.56,100001,Y,Personal Care,EDGE,PC,Dr,16:15:21,19:13:06,7/10/2019,10949313,1814.62,7,"Question fall wall well. Arrive end far four outside.
Clearly sit produce no trial Mrs. Human think long. Same trouble number. Peace wall once really.",17:35:42,DD
DCTX14808940860840,GB94WWYR43460145320993,1/28/2015,23036.94,100001,Y,Household Consumables,OPERA,PC,Dr,20:14:50,21:56:34,7/10/2019,71116020,1814.62,3,Court think own way determine nation especially. Space figure feel world. Piece product various reflect floor at. Popular world politics almost ready.,20:40:43,RTGS
DCTX14808940860840,GB94WWYR43460145320993,1/28/2015,21682.76,100001,Y,Online Shopping,MI,MOBILE,Dr,13:55:19,17:14:50,7/11/2019,15458995,1354.18,6,"Republican night include herself report talk. Seem such garden recent stop message already. Public test summer parent thousand.
Town husband forward interview however. Well news myself yes without.",15:53:01,CHEQUE
DCTX14808940860840,GB94WWYR43460145320993,1/28/2015,23036.94,100001,N,Credited,IE,PC,Cr,14:02:25,17:35:04,7/11/2019,3312537,1354.18,2,Notice agree national cost believe low there. Lead what street weight executive. Compare team thus article report material Congress.,16:21:52,IMPS
DCTX14808940860840,GB94WWYR43460145320993,1/28/2015,24159.84,100001,N,Credited,FF,MOBILE,Cr,5:16:46,8:50:25,7/14/2019,57145471,1122.9,5,"Own director class. Save answer its.
Next coach throw western dark will. Purpose loss finish recent senior wear worry. Democratic fast enough else. Race claim point sea lay stop.",7:19:04,CARDS
DCTX14808940860840,GB94WWYR43460145320993,1/28/2015,23036.94,100001,Y,Household Consumables,EDGE,POS,Dr,11:11:15,13:15:01,7/14/2019,39124036,1122.9,7,"Sister accept attack million different central. Song top entire computer. Machine west choose.
Theory assume region other else forward.",12:16:48,DD
DCTX14808940860840,GB94WWYR43460145320993,1/28/2015,24159.84,100001,N,Credited,EDGE,MOBILE,Cr,14:25:19,18:36:15,7/14/2019,90410888,1122.9,4,Administration really example pretty hotel view new. Economic white wait budget to happen. Sea attorney total concern east.,16:33:58,UPI
DCTX14808940860840,GB94WWYR43460145320993,1/28/2015,23036.94,100001,Y,Utilities,FF,POS,Dr,18:44:27,22:39:01,7/14/2019,65647714,1122.9,1,Candidate apply describe for line. Theory will social last would unit program enter. Meet wrong minute human on candidate safe.,20:49:31,NEFT
DCTX14808940860840,GB94WWYR43460145320993,1/28/2015,22649.81,100001,Y,Transportation,OPERA,PC,Dr,11:17:51,18:04:13,7/15/2019,3974957,387.13,3,"Participant peace agent. Them including mission never little.
Son onto available. Newspaper change onto.
At shake citizen whatever blood result imagine.",14:07:05,RTGS
DCTX14808940860840,GB94WWYR43460145320993,1/28/2015,24000.33,100001,N,Credited,OPERA,POS,Cr,5:46:43,7:10:08,7/18/2019,44501150,1350.52,5,"Also water team land official rise.
Seem age foreign law owner. Become art style here much dark nice.
Minute glass PM exactly main. Avoid health interest simple but. List work us I share list.",6:17:55,CARDS
DCTX14808940860840,GB94WWYR43460145320993,1/28/2015,25350.85,100001,N,Credited,CHROME,PC,Cr,8:44:46,12:23:31,7/18/2019,56428896,1350.52,7,"Either sister executive finish life tax ok. Unit over lead center trouble describe.
Agency organization phone message heart to prepare industry. Piece herself policy finish box middle.",10:30:37,DD
DCTX14808940860840,GB94WWYR43460145320993,1/28/2015,26701.37,100001,N,Credited,MI,PC,Cr,12:25:23,13:54:35,7/18/2019,82563363,1350.52,2,Perform instead wait act. Less role beat audience recognize or eye. Area parent animal section.,12:59:15,IMPS
DCTX14808940860840,GB94WWYR43460145320993,1/28/2015,28051.89,100001,N,Credited,FF,PC,Cr,17:28:36,19:51:56,7/18/2019,26419466,1350.52,1,Need yes seat hair. Perhaps three specific then. Set cut political certain carry husband.,18:43:46,NEFT
DCTX14808940860840,GB94WWYR43460145320993,1/28/2015,29402.41,100001,N,Credited,IE,POS,Cr,22:20:45,24:35:42,7/18/2019,47468177,1350.52,4,"Line if while view. Political wrong practice hospital step happy area. Lawyer suffer worker.
List policy book wind ability you. Anyone may pass fact trial.",23:02:14,UPI
DCTX14808940860840,GB94WWYR43460145320993,1/28/2015,30438.37,100001,N,Credited,CHROME,POS,Cr,11:28:13,19:20:06,7/22/2019,58298572,1035.96,6,Part usually politics upon level measure. Easy however find baby fish. Pick control all personal official produce bring back.,14:26:49,CHEQUE
DCTX14808940860840,GB94WWYR43460145320993,1/28/2015,30843.04,100001,N,Credited,MI,MOBILE,Cr,4:56:33,10:10:07,7/27/2019,43777273,404.67,3,Care same art increase anyone statement. Arrive scene close agreement others group. Benefit behavior need quite enter high condition.,7:52:05,RTGS
DCTX14808940860840,GB94WWYR43460145320993,1/28/2015,30438.37,100001,Y,Rent,EDGE,PC,Dr,15:37:01,18:13:28,7/27/2019,79282345,404.67,7,Mother three ground time give change left. Ability night hit ground. Report military administration particularly then computer budget.,16:40:28,DD
DCTX14808940860840,GB94WWYR43460145320993,1/28/2015,30843.04,100001,N,Credited,MI,MOBILE,Cr,17:19:45,20:38:29,7/27/2019,12419661,404.67,1,"Fear heavy alone live beautiful certain operation shake. Describe prove laugh move guess.
Few book away research hard plant ago. Try soldier land knowledge compare agreement wall bad.",18:00:07,NEFT
DCTX14808940860840,GB94WWYR43460145320993,1/28/2015,32711.52,100001,N,Credited,OPERA,MOBILE,Cr,7:46:28,10:33:24,8/15/2019,92719941,1868.48,3,"Most teach box cold onto brother question establish. Owner key glass than. Require position water prove evidence staff his project.
Voice it husband fine. West have left offer her.",8:55:33,RTGS
DCTX14808940860840,GB94WWYR43460145320993,1/28/2015,30843.04,100001,Y,Groceries,EDGE,POS,Dr,12:44:45,14:12:26,8/15/2019,11923657,1868.48,3,"Any line ground look final. Move center help ask. Than take board lead suddenly.
Reality dog discuss rock pressure event science. Hour quite movie amount remember. Stand under language.",13:25:04,RTGS
DCTX14808940860840,GB94WWYR43460145320993,1/28/2015,32711.52,100001,N,Credited,EDGE,POS,Cr,14:23:31,16:20:40,8/15/2019,26949116,1868.48,7,"Shake candidate eat financial hair TV hit. Hot many population certain enjoy.
Certain security environment specific show fund size authority. New scene big high.",15:25:22,DD
DCTX14808940860840,GB94WWYR43460145320993,1/28/2015,30843.04,100001,Y,Entertainment,IE,MOBILE,Dr,21:01:15,24:20:07,8/15/2019,39635532,1868.48,4,"Social professor wonder since idea ten. Street drop cold professional stage position have.
Catch cell six meeting add. End short suffer example.",23:17:17,UPI
DCTX14808940860840,GB94WWYR43460145320993,1/28/2015,29405.35,100001,Y,Insurance,SAFARI,POS,Dr,8:34:50,12:03:58,8/19/2019,84653611,1437.69,7,"Draw college discussion avoid model. Song night bag half worker. Station catch cup factor.
That draw shoulder family. Very threat economic five best.",11:10:36,DD
DCTX14808940860840,GB94WWYR43460145320993,1/28/2015,27967.66,100001,Y,Dining,IE,POS,Dr,16:03:38,20:13:45,8/19/2019,21069482,1437.69,1,"Guy shake because article without though. Necessary response both realize stay especially. One of recognize lay Mrs.
High effort others expect part American. Win race never officer development.",17:26:21,NEFT
DCTX14808940860840,GB94WWYR43460145320993,1/28/2015,26529.97,100001,Y,Utilities,IE,POS,Dr,20:17:00,24:28:05,8/19/2019,89530788,1437.69,4,Quickly quality agreement series out power develop thousand. Industry machine pull others. Apply similar most small among environment something.,22:53:42,UPI
DCTX14808940860840,GB94WWYR43460145320993,1/28/2015,27684.98,100001,N,Credited,CHROME,PC,Cr,14:19:59,22:16:56,8/27/2019,3605578,1155.01,3,"Former full member strong. Benefit professor lose between head.
Our agree determine find begin. Doctor participant student fish behind.",17:15:09,RTGS
DCTX14808940860840,GB94WWYR43460145320993,1/28/2015,27496.08,100001,Y,Online Shopping,OPERA,MOBILE,Dr,5:43:17,7:36:19,9/6/2019,40561820,188.9,2,Gun each quite through any cause mouth. Over environmental southern now soldier memory. Development perhaps feeling safe get long.,6:52:54,IMPS
DCTX14808940860840,GB94WWYR43460145320993,1/28/2015,27684.98,100001,N,Credited,MI,PC,Cr,11:25:26,14:16:29,9/6/2019,28952473,188.9,7,"Consumer evidence that poor someone wish particular. True PM whose brother local operation onto.
Test his upon. Quality care quite model later prove. Matter amount establish story fly idea bring.",13:12:16,DD
DCTX14808940860840,GB94WWYR43460145320993,1/28/2015,27873.88,100001,N,Credited,EDGE,MOBILE,Cr,16:47:32,18:30:10,9/6/2019,57112091,188.9,3,"Many around travel these writer. Common time rich industry way threat smile.
Rate husband not hotel. Turn may subject recognize some else.
There system into must. Send production raise.",17:16:20,RTGS
DCTX14808940860840,GB94WWYR43460145320993,1/28/2015,27684.98,100001,Y,Entertainment,MI,MOBILE,Dr,22:51:38,24:36:34,9/6/2019,21914720,188.9,3,"Right many parent born. Couple rich wind style.
Different research once hold result. Story wife including continue occur attorney task side. Painting animal try culture resource century.",23:47:17,RTGS
DCTX14808940860840,GB94WWYR43460145320993,1/28/2015,27850.3,100001,N,Credited,SAFARI,PC,Cr,2:45:50,5:03:52,9/11/2019,99100858,165.32,2,Brother audience discover usually pull firm. Along dog right today town character establish thing.,4:09:28,IMPS
DCTX14808940860840,GB94WWYR43460145320993,1/28/2015,27684.98,100001,Y,Dining,MI,MOBILE,Dr,9:13:57,11:59:07,9/11/2019,88344270,165.32,2,"Assume what need third. Include leader final lawyer reason become. Task paper adult threat physical beyond.
Policy tree look before local. Reason plan state experience.",10:06:45,IMPS
DCTX14808940860840,GB94WWYR43460145320993,1/28/2015,27519.66,100001,Y,Household Consumables,CHROME,POS,Dr,13:59:26,15:06:55,9/11/2019,45026324,165.32,1,"Do through million everybody run before box. Speak drop suffer professor popular none deal. Team computer share blue.
International go year man already get score. Protect agent will unit other.",14:31:50,NEFT
DCTX14808940860840,GB94WWYR43460145320993,1/28/2015,27684.98,100001,N,Credited,MI,MOBILE,Cr,15:10:29,17:45:45,9/11/2019,31532235,165.32,2,"Land meeting wish establish foreign direction ago. Ask eight dinner guess. Door still reality hope country through surface.
Marriage individual bar paper certain institution relationship.",16:08:52,IMPS
DCTX14808940860840,GB94WWYR43460145320993,1/28/2015,27519.66,100001,Y,Dining,MI,PC,Dr,22:52:36,23:57:18,9/11/2019,32927009,165.32,2,"Budget although cultural spring.
Sea decide myself market. Tend suddenly worry former explain.",23:20:40,IMPS
DCTX14808940860840,GB94WWYR43460145320993,1/28/2015,28969.03,100001,N,Credited,IE,MOBILE,Cr,13:44:28,17:18:26,9/13/2019,93366106,1449.37,6,"Style gun tonight easy somebody reason grow teacher. Hit authority area everybody home TV free away.
Nature herself create individual. Throughout continue administration radio program continue wrong.",15:38:53,CHEQUE
DCTX14808940860840,GB94WWYR43460145320993,1/28/2015,27519.66,100001,Y,Entertainment,CHROME,POS,Dr,12:50:40,19:53:56,9/13/2019,96085899,1449.37,5,"Available so situation movie both. Tell high wide.
Concern lead important particular receive car. Share impact program moment.",16:38:51,CARDS
DCTX14808940860840,GB94WWYR43460145320993,1/28/2015,26845.45,100001,Y,Transportation,SAFARI,PC,Dr,6:08:14,8:37:22,9/23/2019,69007316,674.21,5,Short consider tough shoulder. Relate attorney order cost have fear history south.,7:10:41,CARDS
DCTX14808940860840,GB94WWYR43460145320993,1/28/2015,27519.66,100001,N,Credited,CHROME,PC,Cr,9:15:29,12:47:12,9/23/2019,83380211,674.21,3,"Expert story both television forward Mrs door. World deep central market brother.
Once job glass simply economy. Whole something service letter my carry change technology.",10:35:41,RTGS
DCTX14808940860840,GB94WWYR43460145320993,1/28/2015,26845.45,100001,Y,Household Consumables,IE,PC,Dr,15:27:10,20:00:05,9/23/2019,41226001,674.21,6,"Beautiful see attorney newspaper although guy high field. Answer customer main especially response.
Learn top few light paper very. Sell could argue game environmental each.",17:49:06,CHEQUE
DCTX14808940860840,GB94WWYR43460145320993,1/28/2015,27519.66,100001,N,Credited,FF,POS,Cr,20:00:20,22:21:25,9/23/2019,90234071,674.21,1,"Push media discussion evidence rock image also. Institution draw leg job today.
Teach focus measure see physical.
These responsibility director report outside. Challenge fly rise item less not.",21:13:10,NEFT
DCTX14808940860840,GB94WWYR43460145320993,1/28/2015,29387.38,100001,N,Credited,EDGE,MOBILE,Cr,7:50:24,9:38:08,9/28/2019,15881526,1867.72,6,"Seem individual across resource option. Conference baby human time. Speak make some.
Student six item authority fire fear. Place politics animal. Could military class memory participant compare ball.",8:22:43,CHEQUE
DCTX14808940860840,GB94WWYR43460145320993,1/28/2015,27519.66,100001,Y,Medicals,CHROME,POS,Dr,7:52:10,10:36:54,9/28/2019,77275110,1867.72,5,Perhaps yeah staff money himself city central attention. Do truth she approach campaign discuss seek wait. Anything base training attorney strategy inside.,9:41:34,CARDS
DCTX14808940860840,GB94WWYR43460145320993,1/28/2015,29387.38,100001,N,Credited,IE,POS,Cr,15:53:39,18:16:45,9/28/2019,73649502,1867.72,1,"Off effort every continue follow drive apply. Future care all development reach. Herself according address defense begin feeling.
Stock Congress stage interview. Consider yet to maintain.",17:23:43,NEFT
DCTX14808940860840,GB94WWYR43460145320993,1/28/2015,27519.66,100001,Y,Transportation,SAFARI,PC,Dr,19:25:54,21:29:27,9/28/2019,1351101,1867.72,7,Reason subject strategy mean. First leader method color sport for region. Establish car of relate later.,20:13:42,DD
DCTX14808940860840,GB94WWYR43460145320993,1/28/2015,25697.44,100001,Y,Personal Care,IE,POS,Dr,5:35:22,7:45:16,9/29/2019,12197286,1822.22,4,"Sing article traditional something. Game daughter American compare.
Subject long Democrat account. Side money pay foot tax.
Area win out eight politics young during.",7:13:18,UPI
DCTX14808940860840,GB94WWYR43460145320993,1/28/2015,23875.22,100001,Y,Rent,FF,PC,Dr,10:27:58,12:12:45,9/29/2019,40413488,1822.22,1,"List father charge beat. Word write land own job.
Appear claim character bill. North student best deal. Concern authority hundred true community like manager.",11:29:05,NEFT
DCTX14808940860840,GB94WWYR43460145320993,1/28/2015,25697.44,100001,N,Credited,CHROME,MOBILE,Cr,12:03:34,15:08:18,9/29/2019,9473669,1822.22,4,"Site wrong herself speech. She return best rock.
Mention conference special evening group day approach give. Possible material rest create baby.",13:10:39,UPI
DCTX14808940860840,GB94WWYR43460145320993,1/28/2015,23875.22,100001,Y,Household Consumables,EDGE,MOBILE,Dr,16:05:26,18:44:55,9/29/2019,76371486,1822.22,4,"Kind lose car accept. Will training model direction. And less during true.
Conference soldier there size. Perhaps work increase music debate. Bad interest international deep happy.",17:16:53,UPI
DCTX14808940860840,GB94WWYR43460145320993,1/28/2015,25697.44,100001,N,Credited,MI,MOBILE,Cr,21:41:44,24:16:46,9/29/2019,31353953,1822.22,6,"Including find little effort item environmental. Significant idea force not three recently next political.
Break state it accept toward. Moment every certain.",22:24:47,CHEQUE
DCTX14808940860840,GB94WWYR43460145320993,1/28/2015,24091.43,100001,Y,Online Shopping,FF,MOBILE,Dr,10:35:52,14:00:33,10/12/2019,36254286,1606.01,4,Message set sometimes air executive assume behavior. Measure lose form five research. Brother increase property kitchen model sort realize.,11:47:35,UPI
DCTX14808940860840,GB94WWYR43460145320993,1/28/2015,25697.44,100001,N,Credited,SAFARI,POS,Cr,20:57:53,24:12:10,10/12/2019,99814663,1606.01,2,"Particularly hair beyond argue wear. Audience pressure store significant. Water star effort.
Our truth structure Congress I subject. Successful list beautiful.
Necessary end cultural fine go city TV.",22:30:33,IMPS
DCTX14808940860840,GB94WWYR43460145320993,1/28/2015,27371.92,100001,N,Credited,IE,MOBILE,Cr,6:27:05,8:33:57,10/13/2019,15073662,1674.48,3,"Much bag level office. Away majority writer choose. Pattern past five return.
He sure right eye.
Doctor school lot carry state science. Example window coach economy middle. Would foreign property.",7:48:02,RTGS
DCTX14808940860840,GB94WWYR43460145320993,1/28/2015,25697.44,100001,Y,Dining,SAFARI,POS,Dr,9:48:14,11:21:15,10/13/2019,60310699,1674.48,3,"Field president follow star if thank society. Suggest paper foot how green human help. Recently community listen list daughter deal.
Peace figure onto later modern something politics.",10:43:24,RTGS
DCTX14808940860840,GB94WWYR43460145320993,1/28/2015,27371.92,100001,N,Credited,SAFARI,MOBILE,Cr,14:55:14,16:47:16,10/13/2019,92433496,1674.48,3,"Too attention almost example head help.
Save finally four small yes. Never none fish success. Yard get network spend example would.
Prove condition one. From family soldier after that later practice.",15:29:18,RTGS
DCTX14808940860840,GB94WWYR43460145320993,1/28/2015,25697.44,100001,Y,Medicals,IE,MOBILE,Dr,15:29:57,17:32:08,10/13/2019,46648938,1674.48,5,"Sit half service condition picture special heavy. Reality know deep truth. Artist level control treat.
Life throw me set. Fly role special enjoy shake floor president. Quite happy year space.",16:37:08,CARDS
DCTX14808940860840,GB94WWYR43460145320993,1/28/2015,27371.92,100001,N,Credited,SAFARI,POS,Cr,19:23:20,21:18:08,10/13/2019,41619452,1674.48,2,War apply picture. Forget material material voice position his situation. Clear size fish expect add almost.,20:44:53,IMPS
DCTX14808940860840,GB94WWYR43460145320993,1/28/2015,28615.57,100001,N,Credited,IE,MOBILE,Cr,7:38:53,17:39:30,10/17/2019,90221033,1243.65,4,"Rather bit beat stock everything. Idea marriage guess threat agent.
Law his himself kid this history act. Ground development body no view during. Note generation state north draw important.",12:04:36,UPI
DCTX14808940860840,GB94WWYR43460145320993,1/28/2015,27816.61,100001,Y,Medicals,EDGE,MOBILE,Dr,12:48:19,17:52:27,10/23/2019,39705600,798.96,2,"Word job side bank key. Movie assume level machine guy various.
Southern avoid condition serious power you fish out.",14:23:38,IMPS
DCTX14808940860840,GB94WWYR43460145320993,1/28/2015,28615.57,100001,N,Credited,OPERA,MOBILE,Cr,21:03:34,24:32:50,10/23/2019,73091752,798.96,5,Condition if training trouble. Act traditional pay campaign occur arm effort. There light maintain old support take.,22:11:24,CARDS
DCTX14808940860840,GB94WWYR43460145320993,1/28/2015,30217.09,100001,N,Credited,MI,PC,Cr,3:38:47,6:07:17,10/27/2019,45876356,1601.52,2,"Newspaper apply try though writer. Fund sign fall pass professor pick.
Road reach medical push act type. Everything yourself whom else agreement lot enjoy.",4:31:17,IMPS
DCTX14808940860840,GB94WWYR43460145320993,1/28/2015,31818.61,100001,N,Credited,EDGE,POS,Cr,8:44:25,11:31:51,10/27/2019,92132207,1601.52,5,End perhaps product court. Recently range tax job quite.,10:17:22,CARDS
DCTX14808940860840,GB94WWYR43460145320993,1/28/2015,33420.13,100001,N,Credited,OPERA,PC,Cr,11:47:26,13:44:09,10/27/2019,45835186,1601.52,2,"Ball less blood start reveal brother near debate.
Around follow training value information that.",12:34:51,IMPS
DCTX14808940860840,GB94WWYR43460145320993,1/28/2015,31818.61,100001,Y,Rent,IE,POS,Dr,15:19:03,18:11:18,10/27/2019,75929015,1601.52,7,Cold crime should into base participant discussion address. Performance happen training true girl address sense. Wind people number successful action it rate.,17:09:02,DD
DCTX14808940860840,GB94WWYR43460145320993,1/28/2015,30217.09,100001,Y,Groceries,CHROME,MOBILE,Dr,19:18:08,21:41:20,10/27/2019,28515500,1601.52,4,"Land level century field member bill. Have player difficult the.
Effect remain bit sort music mind book artist. Certain social over mouth.
Set center six son stock.",20:02:25,UPI
DCTX14808940860840,GB94WWYR43460145320993,1/28/2015,31957.31,100001,N,Credited,OPERA,PC,Cr,11:24:04,15:47:23,10/28/2019,67432158,1740.22,7,"Culture experience coach family. Wind life sign statement deep help thought.
Minute unit such oil.",14:30:15,DD
DCTX14808940860840,GB94WWYR43460145320993,1/28/2015,33697.53,100001,N,Credited,CHROME,MOBILE,Cr,19:08:33,23:31:25,10/28/2019,6371418,1740.22,1,"Research follow what rule.
In paper decade college election answer right large. Two home remember crime land decision look. Expect specific within challenge.",20:52:55,NEFT
DCTX14808940860840,GB94WWYR43460145320993,1/28/2015,34264.68,100001,N,Credited,OPERA,PC,Cr,13:06:56,19:47:55,11/8/2019,22559234,567.15,3,"Reality trade begin pretty. Between game camera visit next turn full. Unit police daughter seven in share.
Case too positive arrive military away. Particular international beyond finish week.",15:28:10,RTGS
DCTX14808940860840,GB94WWYR43460145320993,1/28/2015,34211.32,100001,Y,Online Shopping,OPERA,PC,Dr,7:58:17,11:32:58,11/20/2019,96902714,53.36,1,"Soldier old take budget plan middle road. Situation doctor newspaper old than address.
Stand young little nothing. Share war movie camera billion father. Event about it news consider few.",9:06:12,NEFT
DCTX14808940860840,GB94WWYR43460145320993,1/28/2015,34157.96,100001,Y,Online Shopping,MI,POS,Dr,17:07:57,20:49:27,11/20/2019,20445706,53.36,3,Military tax possible parent open. Treatment every garden cold remain. Writer carry thank old particularly real first.,19:37:35,RTGS
DCTX14808940860840,GB94WWYR43460145320993,1/28/2015,35365.32,100001,N,Credited,SAFARI,POS,Cr,4:13:21,9:05:08,11/22/2019,60457394,1207.36,3,Risk large financial learn appear. Debate effect away thank stop site. Director individual power raise lawyer.,6:47:15,RTGS
DCTX14808940860840,GB94WWYR43460145320993,1/28/2015,36572.68,100001,N,Credited,CHROME,POS,Cr,11:05:00,14:42:15,11/22/2019,70584325,1207.36,3,"Sport tax offer top later. Listen it bed red office. Few next commercial tree painting of easy.
Under already notice drive. Up source thus clearly soldier.",12:18:40,RTGS
DCTX14808940860840,GB94WWYR43460145320993,1/28/2015,37780.04,100001,N,Credited,CHROME,PC,Cr,17:05:14,21:20:25,11/22/2019,40170961,1207.36,5,"Occur yes option certain eight walk floor. Wall them line rule against everyone hour.
Determine question when executive feeling.
Decade game explain read. Look teacher security picture shake.",19:47:23,CARDS
DCTX14808940860840,GB94WWYR43460145320993,1/28/2015,36200.21,100001,Y,Personal Care,EDGE,MOBILE,Dr,11:26:45,16:21:44,11/23/2019,52184864,1579.83,6,On just big unit family. Sea marriage system central mind expert. General pressure prepare tough.,14:17:46,CHEQUE
DCTX14808940860840,GB94WWYR43460145320993,1/28/2015,34348.63,100001,Y,Household Consumables,MI,POS,Dr,9:48:41,14:59:03,11/24/2019,52915895,1851.58,1,"Defense five hand professional result call. Evening anything sound spend personal.
Central then town month send significant happen sound. Represent evidence office key. Manager item enough account.",12:01:44,NEFT
DCTX14808940860840,GB94WWYR43460145320993,1/28/2015,32497.05,100001,Y,Transportation,CHROME,PC,Dr,15:18:20,19:46:26,11/24/2019,99161651,1851.58,6,"Player break exactly industry ago fine really. That together lot already wrong.
The car bit professional news Mr. Figure budget occur myself glass. Two if edge seem dinner today learn.",16:42:23,CHEQUE
DCTX14808940860840,GB94WWYR43460145320993,1/28/2015,33504.02,100001,N,Credited,EDGE,PC,Cr,7:51:07,9:47:54,11/28/2019,33212777,1006.97,2,Its common effort past feeling my. Time soon available. Second mention yeah response forget hundred base. Agent can goal then conference see along.,8:59:02,IMPS
DCTX14808940860840,GB94WWYR43460145320993,1/28/2015,32497.05,100001,Y,Utilities,OPERA,POS,Dr,15:43:51,18:10:30,11/28/2019,43566518,1006.97,2,"Responsibility degree southern rule size attack especially school. Oil upon score section soon. Material institution answer.
Moment we without. Thus identify think all support child would factor.",16:43:21,IMPS
DCTX14808940860840,GB94WWYR43460145320993,1/28/2015,33504.02,100001,N,Credited,IE,POS,Cr,19:25:56,22:41:15,11/28/2019,10521748,1006.97,6,"Carry positive improve successful present. Admit assume care audience bring office billion.
Within run reason wrong performance benefit. Forget else half down sense police.",21:33:26,CHEQUE
DCTX14808940860840,GB94WWYR43460145320993,1/28/2015,33126.67,100001,Y,Insurance,IE,PC,Dr,11:09:55,15:25:49,12/2/2019,66127963,377.35,7,"Industry body to right. Various generation forward fire.
Old summer president wife computer my national ready.",13:48:30,DD
DCTX14808940860840,GB94WWYR43460145320993,1/28/2015,32749.32,100001,Y,Transportation,CHROME,POS,Dr,21:11:40,25:49:02,12/2/2019,62437622,377.35,7,Apply discussion owner buy onto small get similar. Section Congress same enough consumer.,22:42:08,DD
DCTX14808940860840,GB94WWYR43460145320993,1/28/2015,31733.33,100001,Y,Transportation,CHROME,PC,Dr,9:30:12,14:33:56,12/13/2019,75281090,1015.99,2,Art her personal save yes. Exactly beautiful despite from yourself establish development so. Weight than establish form card remember.,11:37:57,IMPS
DCTX14808940860840,GB94WWYR43460145320993,1/28/2015,30717.34,100001,Y,Rent,IE,PC,Dr,11:55:43,15:04:38,12/13/2019,76740749,1015.99,4,"Decade late question hot lot southern customer. Their catch late. Approach direction writer television necessary.
Them television step well require nation. Market attack smile culture similar.",13:22:08,UPI
DCTX14808940860840,GB94WWYR43460145320993,1/28/2015,31733.33,100001,N,Credited,CHROME,MOBILE,Cr,18:32:50,21:29:35,12/13/2019,72594476,1015.99,6,Me more follow air along play stage off. Trip machine perform budget sign. With fast speech become.,19:46:11,CHEQUE
DCTX14808940860840,GB94WWYR43460145320993,1/28/2015,32467.07,100001,N,Credited,SAFARI,MOBILE,Cr,8:15:19,9:43:07,12/14/2019,53132345,733.74,3,Do action me or within send your. Learn large chance season soon else education.,8:45:42,RTGS
DCTX14808940860840,GB94WWYR43460145320993,1/28/2015,33200.81,100001,N,Credited,CHROME,MOBILE,Cr,12:29:09,14:11:22,12/14/2019,50136285,733.74,5,Three during task garden. Impact truth audience strategy public sister purpose. Thus measure production all.,13:36:47,CARDS
DCTX14808940860840,GB94WWYR43460145320993,1/28/2015,33934.55,100001,N,Credited,MI,MOBILE,Cr,16:48:33,20:15:39,12/14/2019,42088790,733.74,2,Purpose find all wrong director peace everything. Find television church fly paper affect big minute. Bed position suggest a painting charge own once.,18:18:26,IMPS
DCTX14808940860840,GB94WWYR43460145320993,1/28/2015,33200.81,100001,Y,Utilities,SAFARI,POS,Dr,17:17:13,21:23:20,12/14/2019,74106325,733.74,4,Realize identify size. Perhaps identify call listen. Size sea word shoulder reality husband decade option.,19:35:05,UPI
DCTX14808940860840,GB94WWYR43460145320993,1/28/2015,34552.45,100001,N,Credited,CHROME,PC,Cr,16:50:28,22:06:10,12/17/2019,16824409,1351.64,5,Sign short crime. Group company speak blue score will. Moment her with police.,18:35:56,CARDS
DCTX14808940860840,GB94WWYR43460145320993,1/28/2015,36234.48,100001,N,Credited,MI,MOBILE,Cr,4:30:05,8:26:28,12/18/2019,67023615,1682.03,1,Exist onto keep type. Tree toward few cause hundred head face. House that cover fine relationship anything.,6:54:02,NEFT
DCTX14808940860840,GB94WWYR43460145320993,1/28/2015,37916.51,100001,N,Credited,FF,MOBILE,Cr,12:06:23,17:17:48,12/18/2019,47943650,1682.03,5,"Floor serious project worker yet. Leave performance security answer Republican coach suffer firm.
Body him garden water majority front front. Officer determine war our especially reason security.",14:42:18,CARDS
DCTX14808940860840,GB94WWYR43460145320993,1/28/2015,39598.54,100001,N,Credited,FF,MOBILE,Cr,21:53:06,25:36:12,12/18/2019,45746864,1682.03,3,"Large marriage contain. Senior success foot year others after less.
Style turn book character. Western season listen very she always employee. Tonight everybody open air player southern.",22:55:04,RTGS
DCTX14808940860840,GB94WWYR43460145320993,1/28/2015,38384.94,100001,Y,Medicals,OPERA,MOBILE,Dr,7:53:57,16:38:13,12/21/2019,96831328,1213.6,6,Back miss represent exist somebody example. Believe station change research. Whether approach run deal skill.,12:22:41,CHEQUE
DCTX14808940860840,GB94WWYR43460145320993,1/28/2015,36834.01,100001,Y,Utilities,FF,POS,Dr,3:56:26,7:01:18,12/22/2019,49535419,1550.93,3,Half walk must weight. Benefit soldier them generation rate food. Yeah bank remember scene agency stage message president.,5:53:38,RTGS
DCTX14808940860840,GB94WWYR43460145320993,1/28/2015,38384.94,100001,N,Credited,FF,POS,Cr,6:59:43,10:01:38,12/22/2019,82972479,1550.93,4,"Majority main very. For happen possible other.
Kid line you yes end stand push next. President each three leave south no main born.",8:54:01,UPI
DCTX14808940860840,GB94WWYR43460145320993,1/28/2015,39935.87,100001,N,Credited,OPERA,POS,Cr,11:16:55,13:31:49,12/22/2019,21806964,1550.93,5,From treatment such fact receive. Involve population need structure.,12:47:14,CARDS
DCTX14808940860840,GB94WWYR43460145320993,1/28/2015,38384.94,100001,Y,Groceries,FF,PC,Dr,19:32:38,20:23:30,12/22/2019,85971301,1550.93,1,"Media assume anyone doctor rule. Congress fund full while between understand.
Teach yourself season case much old sound. Them general throughout admit.",19:56:48,NEFT
DCTX14808940860840,GB94WWYR43460145320993,1/28/2015,39935.87,100001,N,Credited,CHROME,MOBILE,Cr,20:21:35,23:47:25,12/22/2019,32539226,1550.93,6,"Today court black section Democrat of explain. Ground heart yard with education. Too group family newspaper law.
Age can name dog. Throughout however center concern memory always appear.",22:08:21,CHEQUE
DCTX14808940860840,GB94WWYR43460145320993,1/28/2015,39135.13,100001,Y,Personal Care,OPERA,POS,Dr,3:32:45,5:47:37,12/23/2019,78012264,800.74,7,West business call often change lot. Sign word soldier book one court. Despite evidence charge join just inside join.,4:04:23,DD
DCTX14808940860840,GB94WWYR43460145320993,1/28/2015,38334.39,100001,Y,Household Consumables,CHROME,POS,Dr,8:56:10,11:41:33,12/23/2019,23226166,800.74,3,Gas meeting time represent usually. Because particularly huge participant nothing.,10:50:00,RTGS
DCTX14808940860840,GB94WWYR43460145320993,1/28/2015,37533.65,100001,Y,Groceries,OPERA,POS,Dr,11:49:15,14:18:01,12/23/2019,91901385,800.74,6,"Like until enough. Agency everybody view. Kid analysis make some prevent hotel include. Project cause president large.
That inside service body material.",13:38:34,CHEQUE
DCTX14808940860840,GB94WWYR43460145320993,1/28/2015,38334.39,100001,N,Credited,SAFARI,POS,Cr,18:29:27,20:25:33,12/23/2019,11893868,800.74,1,"Week research attorney until become fear agent marriage. Medical mention lose course one deal. Prepare defense class chance rest so way.
Game team specific likely. Yard city beat soldier by my.",19:25:51,NEFT
DCTX14808940860840,GB94WWYR43460145320993,1/28/2015,39135.13,100001,N,Credited,MI,POS,Cr,20:36:24,23:36:54,12/23/2019,40766850,800.74,5,"Audience away summer include.
Prepare trial let trouble pretty could. Save improve know production or increase. Start work four alone.",22:30:15,CARDS
DCTX14808940860840,GB94WWYR43460145320993,1/28/2015,39225.22,100001,N,Credited,IE,POS,Cr,5:13:07,11:06:12,1/6/2020,72771778,90.09,4,"Push under four avoid hit poor consider. Force day seven impact yard cold they team.
But watch ever discuss information. Year head ball science then democratic only.",8:07:11,UPI
DCTX14808940860840,GB94WWYR43460145320993,1/28/2015,39315.31,100001,N,Credited,CHROME,PC,Cr,14:01:11,16:22:42,1/6/2020,83700811,90.09,5,"Federal in truth worker though down. Whose which PM through travel leader. Last plant with hope keep exist.
Clearly let everybody yes enjoy able risk. Many laugh off century partner happy increase.",15:39:32,CARDS
DCTX14808940860840,GB94WWYR43460145320993,1/28/2015,39405.4,100001,N,Credited,OPERA,POS,Cr,23:01:01,25:24:15,1/6/2020,21025808,90.09,7,Movie foot year rate couple. Many face campaign cup half. Her military choose gun player.,23:48:59,DD
DCTX14808940860840,GB94WWYR43460145320993,1/28/2015,37815.4,100001,Y,Household Consumables,IE,PC,Dr,8:24:09,15:14:05,1/17/2020,23766112,1590,1,"Wife manage with treatment particularly prove. Too born hair across outside themselves common perhaps. Indicate rest would.
Member million service reveal treatment.",13:21:41,NEFT
DCTX14808940860840,GB94WWYR43460145320993,1/28/2015,38945.75,100001,N,Credited,MI,MOBILE,Cr,4:30:59,6:23:06,1/18/2020,22155078,1130.35,4,"Space vote plan generation accept left. Student huge guy number rate threat.
Even myself daughter recognize opportunity camera ever. Stop if make summer run part.",5:13:27,UPI
DCTX14808940860840,GB94WWYR43460145320993,1/28/2015,40076.1,100001,N,Credited,SAFARI,POS,Cr,7:43:28,10:11:08,1/18/2020,42535737,1130.35,1,"Too activity guy draw first front offer. Western do class side. Late go big man.
Another arrive security attack. Mention physical address direction. Real same same.",9:16:47,NEFT
DCTX14808940860840,GB94WWYR43460145320993,1/28/2015,41206.45,100001,N,Credited,OPERA,POS,Cr,12:20:24,14:08:28,1/18/2020,45065620,1130.35,4,"Wrong piece author scene determine into line. Wrong before campaign cold professional head most. Our traditional guess safe.
Right itself southern court color. Five my season game.",13:34:03,UPI
DCTX14808940860840,GB94WWYR43460145320993,1/28/2015,40076.1,100001,Y,Medicals,MI,POS,Dr,16:03:19,17:42:14,1/18/2020,2754307,1130.35,5,"Thought side picture gun develop. First reason low. Development history card policy increase.
Rock eat live soldier school third agreement sit. Answer whose too high report firm.",17:12:46,CARDS
DCTX14808940860840,GB94WWYR43460145320993,1/28/2015,38945.75,100001,Y,Entertainment,EDGE,MOBILE,Dr,20:47:59,23:43:00,1/18/2020,1728712,1130.35,7,Adult especially later back wait each not. Beautiful much go trip safe three have other. Should today theory goal hold great.,22:26:02,DD
DCTX14808940860840,GB94WWYR43460145320993,1/28/2015,39104.34,100001,N,Credited,FF,POS,Cr,13:22:11,17:13:10,1/19/2020,95032917,158.59,7,"Challenge relate effect police no hospital. Charge start figure ten sea.
Republican wait fear century involve. Two soldier bank. Radio happy analysis through natural relate less.",15:38:51,DD
DCTX14808940860840,GB94WWYR43460145320993,1/28/2015,38945.75,100001,Y,Entertainment,EDGE,POS,Dr,18:38:54,21:26:34,1/19/2020,597487,158.59,4,"After old week most reveal hot board tree. Organization your office street whom although customer.
She foot market during hundred ball trial skill. Human high despite whole.",20:02:10,UPI
DCTX14808940860840,GB94WWYR43460145320993,1/28/2015,39713.94,100001,N,Credited,SAFARI,MOBILE,Cr,4:51:45,12:19:09,2/11/2020,7831256,768.19,7,"Suggest dark break power. Production current growth paper.
Religious face positive push lawyer. Always person central analysis.",8:37:50,DD
DCTX14808940860840,GB94WWYR43460145320993,1/28/2015,38945.75,100001,Y,Insurance,OPERA,MOBILE,Dr,15:17:01,19:52:44,2/11/2020,5861668,768.19,1,Decade peace identify tell suddenly serious much reduce. Develop show administration bad purpose brother glass war. People south I culture star decade. However best reason provide.,18:47:32,NEFT
DCTX14808940860840,GB94WWYR43460145320993,1/28/2015,40396.26,100001,N,Credited,SAFARI,PC,Cr,5:03:16,7:18:08,2/16/2020,53935274,1450.51,3,"Pattern compare trial one simple former way. Spring billion left threat.
Our themselves voice good. Detail year point.",6:31:30,RTGS
DCTX14808940860840,GB94WWYR43460145320993,1/28/2015,38945.75,100001,Y,Transportation,EDGE,PC,Dr,9:14:55,13:10:36,2/16/2020,59990116,1450.51,5,Director probably dog commercial Mrs fear. Table military land attention throughout week. Toward rich amount strong style find well several. Movie important economy customer.,11:11:30,CARDS
DCTX14808940860840,GB94WWYR43460145320993,1/28/2015,40396.26,100001,N,Credited,IE,POS,Cr,16:59:53,19:25:19,2/16/2020,82133832,1450.51,7,"Management develop third possible any. Will beyond leader allow international.
Agree Mr want always range. Front four fund fight rock manage.
Property travel within she easy.",18:02:01,DD
DCTX14808940860840,GB94WWYR43460145320993,1/28/2015,41846.77,100001,N,Credited,FF,MOBILE,Cr,22:49:31,25:32:40,2/16/2020,34686102,1450.51,3,"Wonder force soon area word. Them service radio worker without author.
Race question wife remain next. Travel chair himself explain mean sign blue. Author top free fight certainly affect early.",23:42:47,RTGS
DCTX14808940860840,GB94WWYR43460145320993,1/28/2015,41783.32,100001,Y,Utilities,IE,MOBILE,Dr,8:19:33,11:12:27,2/17/2020,12007974,63.45,5,"Responsibility group answer population simply within. Test rest process accept eight. Learn size bill full.
Level theory water hope station him win. Home tend behind city bring shake different.",9:14:42,CARDS
DCTX14808940860840,GB94WWYR43460145320993,1/28/2015,41719.87,100001,Y,Insurance,MI,POS,Dr,8:53:25,11:20:09,2/17/2020,82575434,63.45,3,"Have admit dog Mr deep. Run walk might process until political.
Serious six air Republican she process space. Even success soldier make real officer foreign friend.",10:24:03,RTGS
DCTX14808940860840,GB94WWYR43460145320993,1/28/2015,41783.32,100001,N,Credited,CHROME,POS,Cr,14:15:02,17:46:10,2/17/2020,75345563,63.45,4,"Less tonight major long. Be require choose that produce miss.
Check base measure interesting when. White quite mean official.",16:28:46,UPI
DCTX14808940860840,GB94WWYR43460145320993,1/28/2015,41846.77,100001,N,Credited,CHROME,PC,Cr,21:40:43,23:33:28,2/17/2020,16497382,63.45,3,"Since administration raise organization. Light edge he.
Not front what today. Agent audience beyond wife.
Attack detail remain. Piece commercial series few reduce think trouble country.",22:23:46,RTGS
DCTX14808940860840,GB94WWYR43460145320993,1/28/2015,43600.81,100001,N,Credited,SAFARI,POS,Cr,9:15:14,13:56:21,2/20/2020,59069317,1754.04,7,Begin executive worker moment include size after. Church administration reduce data create challenge.,10:54:17,DD
DCTX14808940860840,GB94WWYR43460145320993,1/28/2015,41846.77,100001,Y,Rent,EDGE,PC,Dr,18:56:37,21:49:13,2/20/2020,47367746,1754.04,6,"Either find local former art moment. Republican enter get fight quickly century toward.
Special first market easy race wrong sound style. Weight without indicate high foreign opportunity sister.",20:35:31,CHEQUE
DCTX14808940860840,GB94WWYR43460145320993,1/28/2015,42090.98,100001,N,Credited,OPERA,POS,Cr,6:28:34,9:45:21,3/2/2020,85479326,244.21,2,"As face begin north training wife. Me approach herself. Day image term statement.
Wrong top brother stand education. Imagine throughout eat inside pull way.",7:50:30,IMPS
DCTX14808940860840,GB94WWYR43460145320993,1/28/2015,42335.19,100001,N,Credited,CHROME,PC,Cr,7:23:30,8:54:35,3/2/2020,39359384,244.21,1,Raise citizen style. Institution vote town toward discuss democratic. Amount car walk though government development. About culture learn.,8:05:53,NEFT
DCTX14808940860840,GB94WWYR43460145320993,1/28/2015,42090.98,100001,Y,Entertainment,SAFARI,PC,Dr,14:17:28,15:24:47,3/2/2020,19282206,244.21,4,"To perhaps law series head add. Degree life most support manager.
Leader small support seat detail produce whom occur. Provide him forward bit shake now offer.",14:43:16,UPI
DCTX14808940860840,GB94WWYR43460145320993,1/28/2015,41846.77,100001,Y,Dining,EDGE,POS,Dr,17:15:03,18:55:17,3/2/2020,35264064,244.21,7,"Notice store tree measure rise open. Top issue figure. Measure soldier plan apply important instead interest American.
We us hand job direction. Three relationship never quickly. Play subject add.",18:10:41,DD
DCTX14808940860840,GB94WWYR43460145320993,1/28/2015,41602.56,100001,Y,Personal Care,CHROME,POS,Dr,21:52:16,23:40:21,3/2/2020,70319163,244.21,1,Evidence character option American. Game often hair interesting.,23:02:16,NEFT
DCTX14808940860840,GB94WWYR43460145320993,1/28/2015,41248.4,100001,Y,Insurance,IE,POS,Dr,6:53:25,8:57:42,3/8/2020,98996032,354.16,7,"Federal the hundred. Meeting final themselves lose.
Significant blue clearly. Difficult may set really account. Trouble must include plant. Morning purpose gun story wrong.",7:22:46,DD
DCTX14808940860840,GB94WWYR43460145320993,1/28/2015,40894.24,100001,Y,Rent,CHROME,POS,Dr,9:02:03,12:35:38,3/8/2020,22986023,354.16,3,"Not side father change discuss same. Party establish wall edge. Standard class fear either.
Food yes safe discuss believe. Floor recognize check happy. By grow choose.",10:45:37,RTGS
DCTX14808940860840,GB94WWYR43460145320993,1/28/2015,40540.08,100001,Y,Rent,OPERA,POS,Dr,14:18:28,17:27:08,3/8/2020,4300861,354.16,2,Service left prove citizen air affect produce. Result summer box culture while ten strategy. Cover safe find news.,15:51:33,IMPS
DCTX14808940860840,GB94WWYR43460145320993,1/28/2015,40894.24,100001,N,Credited,CHROME,MOBILE,Cr,15:17:05,17:50:30,3/8/2020,99984199,354.16,2,Rock reality stay. End common yeah his. Glass dream child budget everybody.,16:33:02,IMPS
DCTX14808940860840,GB94WWYR43460145320993,1/28/2015,40540.08,100001,Y,Personal Care,MI,MOBILE,Dr,19:14:11,21:57:01,3/8/2020,60911247,354.16,3,"Budget or five they important scene plan.
Size director nation. Tell describe baby town can box forward write.
Recently each fine citizen left support. Expect than civil face black month by leave.",20:32:59,RTGS
DCTX14808940860840,GB94WWYR43460145320993,1/28/2015,40134.18,100001,Y,Online Shopping,IE,PC,Dr,7:23:18,10:43:39,3/21/2020,3153307,405.9,1,"Game young quickly part now item. Executive whole pull cup talk finally. As officer tough indeed soon forward. Assume bad hotel build wrong.
Well black those. Good book age floor bed enter.",8:21:50,NEFT
DCTX14808940860840,GB94WWYR43460145320993,1/28/2015,40540.08,100001,N,Credited,OPERA,MOBILE,Cr,11:35:45,15:00:29,3/21/2020,76352362,405.9,5,Quickly whom near firm. Officer skill administration natural thus dream. Win pick while science opportunity.,12:59:33,CARDS
DCTX14808940860840,GB94WWYR43460145320993,1/28/2015,40945.98,100001,N,Credited,OPERA,POS,Cr,14:24:39,18:06:36,3/21/2020,74123438,405.9,4,"Positive Democrat where memory cell. Box mention force discussion.
Wall reveal seven president. Us understand interesting role religious religious final. In southern stage prevent.",15:43:42,UPI
DCTX14808940860840,GB94WWYR43460145320993,1/28/2015,40540.08,100001,Y,Utilities,EDGE,MOBILE,Dr,17:59:00,20:40:38,3/21/2020,86583220,405.9,3,"Ok east film. Girl available three military population attorney.
Thousand can talk system music authority.",19:43:55,RTGS
DCTX14808940860840,GB94WWYR43460145320993,1/28/2015,40343.77,100001,Y,Dining,IE,POS,Dr,13:10:17,18:24:02,3/23/2020,18301229,196.31,5,Effect toward house such carry. Sister hand evening cause nature. Wait change building red off cost.,15:18:30,CARDS
DCTX14808940860840,GB94WWYR43460145320993,1/28/2015,40540.08,100001,N,Credited,IE,POS,Cr,18:55:52,24:42:04,3/23/2020,28034322,196.31,6,"Buy big media surface gas care. These easy part lead edge discover see.
Fact threat loss inside answer. Enjoy most force make yourself get finally factor. Attention art yourself.",22:27:42,CHEQUE
DCTX14808940860840,GB94WWYR43460145320993,1/28/2015,39704.09,100001,Y,Insurance,CHROME,MOBILE,Dr,16:30:24,20:44:08,4/2/2020,52339257,835.99,1,"Less learn real little thank. Change never treatment friend. First I growth total man election.
Large program even company. While data note too view. School somebody newspaper return under.",18:37:35,NEFT
DCTX14808940860840,GB94WWYR43460145320993,1/28/2015,39290.61,100001,Y,Utilities,CHROME,POS,Dr,7:05:37,10:22:02,4/3/2020,49872170,413.48,2,Order every customer develop see. See sing happy hair different. Current lot cultural tend civil look science.,8:44:25,IMPS
DCTX14808940860840,GB94WWYR43460145320993,1/28/2015,39704.09,100001,N,Credited,SAFARI,POS,Cr,10:48:19,14:52:56,4/3/2020,7642722,413.48,7,"See admit yourself customer field turn sure democratic. Gas couple with third visit.
Exist arm particularly on sister. Movie toward customer probably that.",13:10:00,DD
DCTX14808940860840,GB94WWYR43460145320993,1/28/2015,40117.57,100001,N,Credited,SAFARI,PC,Cr,15:59:11,17:23:59,4/3/2020,51817367,413.48,7,"Born lay turn manage democratic. Concern enjoy suffer heavy believe chair month. Issue goal forget rise.
Sing value much chance speech. Finally member let nothing however.",16:49:35,DD
DCTX14808940860840,GB94WWYR43460145320993,1/28/2015,39704.09,100001,Y,Online Shopping,OPERA,PC,Dr,21:54:40,25:02:41,4/3/2020,23575202,413.48,5,Able large toward everybody catch stuff. Finally base former statement together paper. After power manage act between now travel tonight.,23:52:59,CARDS
DCTX14808940860840,GB94WWYR43460145320993,1/28/2015,40586.9,100001,N,Credited,MI,PC,Cr,15:33:52,22:24:30,4/10/2020,4603580,882.81,3,Clearly tax son painting window imagine. Six a home quickly beat hot under. Threat fact expect federal skill growth collection tree.,20:01:10,RTGS
DCTX14808940860840,GB94WWYR43460145320993,1/28/2015,38932.53,100001,Y,Personal Care,IE,PC,Dr,8:57:51,13:41:14,4/14/2020,70684902,1654.37,3,Team push position rock government easy. Statement hundred policy region manage record hear.,10:43:18,RTGS
DCTX14808940860840,GB94WWYR43460145320993,1/28/2015,40586.9,100001,N,Credited,OPERA,PC,Cr,12:28:27,14:31:33,4/14/2020,53757678,1654.37,1,"Job religious training chance hospital hour front. World such defense.
Often ability follow receive red. Only memory reality population wrong voice.",13:41:49,NEFT
DCTX14808940860840,GB94WWYR43460145320993,1/28/2015,38932.53,100001,Y,Utilities,SAFARI,MOBILE,Dr,21:08:21,24:15:32,4/14/2020,74611409,1654.37,2,"Them choose movement various doctor capital without. High spring land fact simple though our. Than still near push country.
Direction likely sea skin. Always ago help Mrs half who.",23:03:33,IMPS
DCTX14808940860840,GB94WWYR43460145320993,1/28/2015,38778.84,100001,Y,Dining,SAFARI,PC,Dr,18:30:16,25:00:22,4/20/2020,36725670,153.69,1,Then good yes particularly blood adult drop. Ready tax almost town become. With performance authority fear. Deep account control audience first light talk health.,21:44:41,NEFT
DCTX14808940860840,GB94WWYR43460145320993,1/28/2015,40104.63,100001,N,Credited,CHROME,POS,Cr,7:35:49,13:11:12,4/22/2020,67225828,1325.79,3,Everyone after as view. Wrong population operation next right war. Attorney camera support possible child matter.,11:13:23,RTGS
DCTX14808940860840,GB94WWYR43460145320993,1/28/2015,38778.84,100001,Y,Medicals,FF,PC,Dr,17:59:43,22:02:03,4/22/2020,64854229,1325.79,7,"Strong story sure evening movement human science product. Eat to stop new.
Find skin ask sea project prove. Most film the everybody room theory. Friend anyone TV if.",20:47:47,DD
DCTX14808940860840,GB94WWYR43460145320993,1/28/2015,40019.1,100001,N,Credited,OPERA,POS,Cr,10:56:10,18:01:46,5/3/2020,75742317,1240.26,1,Daughter raise four available feel. Gas plant lose picture last admit young. Land another method argue. Change despite range go method.,12:49:37,NEFT
DCTX14808940860840,GB94WWYR43460145320993,1/28/2015,40391.92,100001,N,Credited,FF,MOBILE,Cr,2:44:10,5:35:13,5/6/2020,8814296,372.82,5,"Security explain current performance note skin clear authority. Remain wind student heart red body.
Police food bar college couple amount behind. However second debate. From quite stand life.",4:27:39,CARDS
DCTX14808940860840,GB94WWYR43460145320993,1/28/2015,40019.1,100001,Y,Utilities,IE,MOBILE,Dr,7:49:48,11:28:57,5/6/2020,61739239,372.82,3,Foreign simple investment. All animal health. That three specific about system difference not.,9:46:06,RTGS
DCTX14808940860840,GB94WWYR43460145320993,1/28/2015,40391.92,100001,N,Credited,IE,PC,Cr,13:50:23,15:22:59,5/6/2020,59280996,372.82,7,Sense yard box protect thing partner. They attack service subject. Mention probably her ok.,14:50:36,DD
DCTX14808940860840,GB94WWYR43460145320993,1/28/2015,40019.1,100001,Y,Insurance,EDGE,POS,Dr,18:17:08,19:53:10,5/6/2020,65532614,372.82,7,Theory reflect gun need show add. Type that eye indicate grow part south. Without tax letter first.,19:29:02,DD
DCTX14808940860840,GB94WWYR43460145320993,1/28/2015,40391.92,100001,N,Credited,MI,PC,Cr,21:51:09,24:55:37,5/6/2020,61288980,372.82,1,"Building region party. Imagine home show note drive why life blue. Level question them care fall rise technology.
Ground fear remain sound play style fish.",23:28:07,NEFT
DCTX14808940860840,GB94WWYR43460145320993,1/28/2015,40136.06,100001,Y,Online Shopping,IE,PC,Dr,4:11:47,7:42:15,5/16/2020,48914505,255.86,5,"Total somebody ready college little. Oil cost respond wall seven pretty federal. Reality machine attention relate past must.
North once other must consider.",5:18:54,CARDS
DCTX14808940860840,GB94WWYR43460145320993,1/28/2015,40391.92,100001,N,Credited,IE,MOBILE,Cr,10:49:28,13:39:25,5/16/2020,13708924,255.86,5,Medical appear catch team interest performance treatment. Some leave it item attention item. Rather often agency contain citizen rich military.,11:27:02,CARDS
DCTX14808940860840,GB94WWYR43460145320993,1/28/2015,40136.06,100001,Y,Rent,CHROME,MOBILE,Dr,12:52:30,15:29:40,5/16/2020,254182,255.86,1,"Future age total population phone project medical. Down forget pattern including plan. Space give morning subject decade near thousand.
Decision few ready air learn.",14:41:07,NEFT
DCTX14808940860840,GB94WWYR43460145320993,1/28/2015,39880.2,100001,Y,Entertainment,FF,POS,Dr,19:47:53,21:35:01,5/16/2020,59752035,255.86,7,"Them defense model executive. Including prove truth example consumer. However hold figure employee. Data maybe pull.
Him bill standard stuff lose line. On father student.",20:55:46,DD
DCTX14808940860840,GB94WWYR43460145320993,1/28/2015,38983.68,100001,Y,Medicals,SAFARI,MOBILE,Dr,5:47:52,9:11:18,5/26/2020,16955653,896.52,3,Kitchen report particularly entire. Middle white think cause ago.,7:18:01,RTGS
DCTX14808940860840,GB94WWYR43460145320993,1/28/2015,38087.16,100001,Y,Medicals,FF,PC,Dr,9:10:15,13:08:44,5/26/2020,77387387,896.52,6,"Defense action discuss. Without example environment.
Loss population street budget grow. There camera trouble worry new. Theory fight choice model subject.",10:50:59,CHEQUE
DCTX14808940860840,GB94WWYR43460145320993,1/28/2015,38983.68,100001,N,Credited,EDGE,PC,Cr,17:08:42,20:52:50,5/26/2020,24186254,896.52,1,"Black these east. Voice one PM space. Play season ten whom.
Young public yourself nature price style green. Upon bar peace. Attorney sound detail detail particular off nature song.",18:30:32,NEFT
DCTX14808940860840,GB94WWYR43460145320993,1/28/2015,39880.2,100001,N,Credited,IE,POS,Cr,17:50:41,21:37:26,5/26/2020,52501067,896.52,3,"Among hold so these. Activity inside worker see six even close. With me charge when sort enjoy.
Scene next improve two floor writer.",19:37:59,RTGS
DCTX14808940860840,GB94WWYR43460145320993,1/28/2015,38449.71,100001,Y,Online Shopping,EDGE,MOBILE,Dr,17:36:34,21:18:09,5/29/2020,49510898,1430.49,5,Interesting brother the the store able develop. Recognize late management trial law poor must art. Dark parent soldier follow. Last role maintain pay.,19:38:22,CARDS
DCTX14808940860840,GB94WWYR43460145320993,1/28/2015,39116.45,100001,N,Credited,FF,MOBILE,Cr,12:22:18,16:30:45,5/30/2020,85147690,666.74,1,"Protect smile identify. Material commercial miss.
President on director against responsibility plant those. Nothing six future ago person policy. Trouble employee time include stock her.",13:34:19,NEFT
DCTX14808940860840,GB94WWYR43460145320993,1/28/2015,38449.71,100001,Y,Entertainment,FF,POS,Dr,19:13:03,25:38:29,5/30/2020,92767089,666.74,1,"Human white meet road. Investment within carry. Possible group tell sort simply after.
Senior court focus worry. Seem very discuss right.",22:45:15,NEFT
DCTX14808940860840,GB94WWYR43460145320993,1/28/2015,40188.78,100001,N,Credited,CHROME,MOBILE,Cr,2:57:34,6:27:49,6/4/2020,80070733,1739.07,7,Door do night investment most. Give improve bit something blue themselves. Early continue way firm let simple.,4:52:41,DD
DCTX14808940860840,GB94WWYR43460145320993,1/28/2015,38449.71,100001,Y,Online Shopping,FF,MOBILE,Dr,11:30:24,15:39:05,6/4/2020,62440981,1739.07,6,Six nature goal report. Like although east team teacher central. Development enter soon beautiful few break.,13:38:27,CHEQUE
DCTX14808940860840,GB94WWYR43460145320993,1/28/2015,40188.78,100001,N,Credited,SAFARI,PC,Cr,15:29:02,17:57:24,6/4/2020,64842523,1739.07,5,"We provide father want base face. Remember city return woman room put. Strategy PM environment finish.
Economy body value often. Make chair movement send get.",16:56:08,CARDS
DCTX14808940860840,GB94WWYR43460145320993,1/28/2015,38449.71,100001,Y,Transportation,FF,MOBILE,Dr,18:32:27,22:29:39,6/4/2020,28035268,1739.07,4,Ahead thus hot population write hundred late. Stop wall quite.,20:37:24,UPI
DCTX14808940860840,GB94WWYR43460145320993,1/28/2015,38780.22,100001,N,Credited,CHROME,PC,Cr,6:52:38,9:07:38,6/6/2020,68695330,330.51,5,"Dream soon your order environment deal. Show should church stand employee film air.
Maybe conference with. Smile modern music young yet effect.",8:01:06,CARDS
DCTX14808940860840,GB94WWYR43460145320993,1/28/2015,38449.71,100001,Y,Insurance,MI,POS,Dr,19:29:35,24:16:38,6/6/2020,24787147,330.51,2,"Forget too thank between top strong. Similar professor book kitchen whatever tough their.
Realize data project wait level.",21:24:05,IMPS
DCTX14808940860840,GB94WWYR43460145320993,1/28/2015,37180.19,100001,Y,Household Consumables,EDGE,MOBILE,Dr,7:06:39,9:28:33,6/9/2020,2946269,1269.52,6,"Drive claim actually partner specific just. Time else road benefit party south no provide.
Factor hand can inside. On father we player pattern. Make professor argue door.",7:31:01,CHEQUE
DCTX14808940860840,GB94WWYR43460145320993,1/28/2015,35910.67,100001,Y,Rent,EDGE,PC,Dr,9:21:42,12:40:15,6/9/2020,25739107,1269.52,2,Main lawyer lot worker glass. Want throw major happen not wall.,10:46:28,IMPS
DCTX14808940860840,GB94WWYR43460145320993,1/28/2015,34641.15,100001,Y,Groceries,IE,PC,Dr,11:57:19,14:53:00,6/9/2020,35207153,1269.52,6,Matter seven religious house receive. Think forget security key age man since. Lot case public could catch probably week.,13:12:30,CHEQUE
DCTX14808940860840,GB94WWYR43460145320993,1/28/2015,33371.63,100001,Y,Entertainment,MI,POS,Dr,16:16:06,17:26:59,6/9/2020,31128568,1269.52,6,Gun pressure many age year ready behavior. On better hit baby behavior phone. Wind difference stand. Serve especially my how.,16:58:31,CHEQUE
DCTX14808940860840,GB94WWYR43460145320993,1/28/2015,34641.15,100001,N,Credited,FF,PC,Cr,21:55:02,24:44:04,6/9/2020,66307037,1269.52,1,Pull look south fund partner fast speak. Focus a your industry during.,23:40:31,NEFT
DCTX14808940860840,GB94WWYR43460145320993,1/28/2015,34666.56,100001,N,Credited,SAFARI,MOBILE,Cr,5:34:04,10:05:58,6/30/2020,76542268,25.41,2,"You hour hard interest sea. Management rock window country speech compare poor.
Range south that. Work animal current radio. These father both their future senior treatment.",7:46:02,IMPS
DCTX14808940860840,GB94WWYR43460145320993,1/28/2015,34691.97,100001,N,Credited,OPERA,MOBILE,Cr,13:54:49,18:12:26,6/30/2020,37076108,25.41,3,"Meeting wait election small she religious green. Resource common tax smile laugh. Little record national staff phone election nice those.
Message investment key such magazine.",16:12:47,RTGS
DCTX14808940860840,GB94WWYR43460145320993,1/28/2015,34717.38,100001,N,Credited,CHROME,POS,Cr,21:40:11,24:30:51,6/30/2020,31577182,25.41,3,Continue break week whether method recognize any. Adult such somebody.,22:46:07,RTGS
DCTX14808940860840,GB94WWYR43460145320993,1/28/2015,32836.24,100001,Y,Transportation,SAFARI,PC,Dr,6:25:04,11:11:43,7/8/2020,48953207,1881.14,2,"In tax price subject. Reach public traditional assume someone themselves up.
Able team worker box other sense instead. Together cause set entire level west art provide.",8:34:27,IMPS
DCTX14808940860840,GB94WWYR43460145320993,1/28/2015,30955.1,100001,Y,Online Shopping,OPERA,POS,Dr,14:36:47,18:46:25,7/8/2020,68622817,1881.14,4,That trouble democratic finally civil.,16:08:58,UPI
DCTX14808940860840,GB94WWYR43460145320993,1/28/2015,29073.96,100001,Y,Groceries,EDGE,POS,Dr,20:38:46,24:16:15,7/8/2020,27111215,1881.14,5,"Car too sing still spring five. Good his either sense.
Some enough management she. Late reach half traditional about.",21:58:36,CARDS
DCTX14808940860840,GB94WWYR43460145320993,1/28/2015,30308.19,100001,N,Credited,SAFARI,POS,Cr,11:50:58,17:19:59,7/17/2020,90217944,1234.23,3,"Even condition election interview people point sell. Spend real hot eight.
Mother western hour debate.",15:51:11,RTGS
DCTX14808940860840,GB94WWYR43460145320993,1/28/2015,31370.12,100001,N,Credited,EDGE,PC,Cr,6:51:21,10:06:21,7/23/2020,51343491,1061.93,1,"Second various discussion want film trip.
Every born place mind only southern.
Few would sea husband true director network. None describe way onto. Eat week attack she.",8:33:03,NEFT
DCTX14808940860840,GB94WWYR43460145320993,1/28/2015,30308.19,100001,Y,Groceries,SAFARI,POS,Dr,10:28:38,13:55:56,7/23/2020,85068179,1061.93,5,Picture sometimes team gas big. Remember address program. Each lay who operation full development for.,11:57:38,CARDS
DCTX14808940860840,GB94WWYR43460145320993,1/28/2015,31370.12,100001,N,Credited,CHROME,POS,Cr,16:50:17,18:52:21,7/23/2020,48417280,1061.93,7,"According PM federal. Yet go difference tell exactly start son. Example process dream region financial travel meet single.
Sometimes main staff cause her. Ask program together executive.",17:38:43,DD
DCTX14808940860840,GB94WWYR43460145320993,1/28/2015,30308.19,100001,Y,Entertainment,SAFARI,POS,Dr,19:24:56,22:17:03,7/23/2020,62062411,1061.93,6,"Church pick put movement him college. Teacher civil news. Information consider notice teacher heavy.
Decide test will measure popular enjoy less walk.",21:42:23,CHEQUE
DCTX14808940860840,GB94WWYR43460145320993,1/28/2015,29717.99,100001,Y,Transportation,FF,POS,Dr,14:32:29,21:32:21,7/26/2020,68004439,590.2,3,"There charge describe. Chance newspaper camera me seek audience.
Six probably international artist itself method grow.
Itself get person special. Congress feel require board.",19:00:06,RTGS
DCTX14808940860840,GB94WWYR43460145320993,1/28/2015,29358.35,100001,Y,Utilities,IE,POS,Dr,4:33:12,5:30:49,9/3/2020,32178555,359.64,7,"Grow well describe hair.
Thank job establish bad rock less. Traditional own practice avoid. Third point phone available series.",5:02:35,DD
DCTX14808940860840,GB94WWYR43460145320993,1/28/2015,29717.99,100001,N,Credited,IE,PC,Cr,7:39:46,9:00:38,9/3/2020,61897335,359.64,5,"Scene eight create know age. Action second husband.
Tv increase assume painting popular. People type arrive fear cost price six way. Exactly sure subject able technology test.",8:28:54,CARDS
DCTX14808940860840,GB94WWYR43460145320993,1/28/2015,29358.35,100001,Y,Entertainment,SAFARI,POS,Dr,11:49:18,14:54:35,9/3/2020,7667961,359.64,7,Foreign possible race dog concern man own. Reach plan item policy do tell describe.,13:29:58,DD
DCTX14808940860840,GB94WWYR43460145320993,1/28/2015,28998.71,100001,Y,Utilities,SAFARI,MOBILE,Dr,15:32:33,17:31:00,9/3/2020,93771818,359.64,1,Avoid trial hand section firm thousand pressure. Face serve system eye cold.,16:27:03,NEFT
DCTX14808940860840,GB94WWYR43460145320993,1/28/2015,29358.35,100001,N,Credited,IE,MOBILE,Cr,20:31:24,23:37:14,9/3/2020,87654011,359.64,6,Walk industry safe great home. Nothing base rest own act. Run group rate stay when care perform it. Position against strong pay.,21:52:20,CHEQUE
DCTX14808940860840,GB94WWYR43460145320993,1/28/2015,28248.22,100001,Y,Household Consumables,IE,MOBILE,Dr,19:32:00,23:17:42,9/20/2020,98610211,1110.13,4,"Hope name director contain factor science. Area several player game candidate.
Main exist food former recent hair.",21:18:19,UPI
DCTX14808940860840,GB94WWYR43460145320993,1/28/2015,28975.04,100001,N,Credited,FF,POS,Cr,5:11:45,7:29:16,9/22/2020,37480196,726.82,2,Street difference once that near country my wear. Only operation debate Democrat production news enter. Own key be newspaper article medical no. Build bed class lose.,6:07:07,IMPS
DCTX14808940860840,GB94WWYR43460145320993,1/28/2015,29701.86,100001,N,Credited,SAFARI,POS,Cr,10:43:20,14:33:26,9/22/2020,68525545,726.82,1,Seem author adult. Thousand message college city but green scene million.,12:30:25,NEFT
DCTX14808940860840,GB94WWYR43460145320993,1/28/2015,30428.68,100001,N,Credited,CHROME,POS,Cr,18:42:03,23:59:24,9/22/2020,71978857,726.82,5,"Lose onto military money have keep. Same attack language green if half involve. Quite wife by animal land mind past.
No no treatment maintain land onto walk. Professor worry better all head Mr.",21:28:48,CARDS
DCTX14808940860840,GB94WWYR43460145320993,1/28/2015,28500.54,100001,Y,Personal Care,SAFARI,MOBILE,Dr,6:58:48,9:29:29,9/23/2020,26413174,1928.14,7,Indicate information challenge. Night for just concern man hold. Hold series and factor.,8:12:40,DD
DCTX14808940860840,GB94WWYR43460145320993,1/28/2015,26572.4,100001,Y,Entertainment,EDGE,MOBILE,Dr,18:15:46,21:46:23,9/23/2020,23065994,1928.14,6,View box true security nothing choose require. Data party son particular follow. Inside dinner whom around success maintain show.,19:05:48,CHEQUE
DCTX14808940860840,GB94WWYR43460145320993,1/28/2015,25015.5,100001,Y,Groceries,OPERA,POS,Dr,4:12:58,9:00:42,9/27/2020,16124578,1556.9,7,"Second responsibility cold. Door describe do fill debate nation American maybe. It hand cause know.
Writer any guess subject listen community. Plan house because same field break. Gun stay fear tree.",6:37:55,DD
DCTX14808940860840,GB94WWYR43460145320993,1/28/2015,23458.6,100001,Y,Personal Care,EDGE,POS,Dr,13:54:29,18:08:57,9/27/2020,62195379,1556.9,2,News go case. American partner now central now race news.,16:40:14,IMPS
DCTX14808940860840,GB94WWYR43460145320993,1/28/2015,25015.5,100001,N,Credited,EDGE,PC,Cr,19:09:23,23:20:48,9/27/2020,73344056,1556.9,5,Maybe establish after price worry job. Issue recently sport network.,20:35:17,CARDS
DCTX14808940860840,GB94WWYR43460145320993,1/28/2015,24493.1,100001,Y,Personal Care,MI,MOBILE,Dr,3:29:13,6:21:24,9/28/2020,57622071,522.4,1,Single report decision hair. Usually almost herself hope account share. Trouble husband wind true section each newspaper.,5:16:32,NEFT
DCTX14808940860840,GB94WWYR43460145320993,1/28/2015,25015.5,100001,N,Credited,EDGE,MOBILE,Cr,10:38:11,12:37:38,9/28/2020,62465830,522.4,6,Become left oil point letter million task. Wish bag four everybody thought agree. Save close from condition. Work build start worker.,11:15:37,CHEQUE
DCTX14808940860840,GB94WWYR43460145320993,1/28/2015,24493.1,100001,Y,Online Shopping,IE,POS,Dr,13:51:05,15:11:39,9/28/2020,97763826,522.4,7,"Place talk bank knowledge though cold assume. Per why summer imagine no major.
Close score space can. True spend build far.",14:33:17,DD
DCTX14808940860840,GB94WWYR43460145320993,1/28/2015,23970.7,100001,Y,Entertainment,EDGE,POS,Dr,15:33:55,18:56:28,9/28/2020,14710445,522.4,3,"Degree college home financial however power. Fall sit production morning hope blue enter close.
Particular various evidence while deep market. Ever agency benefit score.",17:32:26,RTGS
DCTX14808940860840,GB94WWYR43460145320993,1/28/2015,23448.3,100001,Y,Online Shopping,SAFARI,MOBILE,Dr,21:20:55,23:28:49,9/28/2020,22164292,522.4,1,"Model peace recently know usually. Ready he color prove way million. Or role my.
Head onto toward present quickly center. Civil plant open social culture class.",22:47:18,NEFT
DCTX14808940860840,GB94WWYR43460145320993,1/28/2015,22333.58,100001,Y,Online Shopping,OPERA,POS,Dr,4:48:03,6:45:28,10/1/2020,96451687,1114.72,6,Culture hold hear another others reach environmental. Bit save summer. Race state true.,5:22:55,CHEQUE
DCTX14808940860840,GB94WWYR43460145320993,1/28/2015,23448.3,100001,N,Credited,SAFARI,POS,Cr,10:56:26,12:46:07,10/1/2020,20663803,1114.72,1,"Wish box around. His into option middle main. Leg simply stay shoulder.
Sport public street.",11:29:52,NEFT
DCTX14808940860840,GB94WWYR43460145320993,1/28/2015,24563.02,100001,N,Credited,SAFARI,POS,Cr,13:34:55,15:06:57,10/1/2020,73315612,1114.72,4,"So least area. Other watch site.
Million pick should boy energy government own go. Term some say arrive interesting common oil north. Serve pressure life mouth three word.",14:06:15,UPI
DCTX14808940860840,GB94WWYR43460145320993,1/28/2015,23448.3,100001,Y,Dining,OPERA,PC,Dr,16:32:57,19:04:09,10/1/2020,9915589,1114.72,7,"This program kind reason commercial talk. Idea actually sit. Understand candidate similar.
There already despite take risk how.",17:28:53,DD
DCTX14808940860840,GB94WWYR43460145320993,1/28/2015,22333.58,100001,Y,Transportation,OPERA,PC,Dr,21:38:53,22:42:54,10/1/2020,51769109,1114.72,4,"Seem very purpose meet deal senior fact. Him agreement best month. Green rather future pay memory.
Cut institution might head middle. Me oil tend decide order speak development.",22:09:36,UPI
DCTX14808940860840,GB94WWYR43460145320993,1/28/2015,23243.52,100001,N,Credited,MI,PC,Cr,4:40:08,7:57:27,10/8/2020,58205877,909.94,5,Century between always cost. Coach those she call large. Name two grow order. Sister guy rich natural live century heart.,6:05:14,CARDS
DCTX14808940860840,GB94WWYR43460145320993,1/28/2015,22333.58,100001,Y,Transportation,SAFARI,PC,Dr,11:09:14,12:51:23,10/8/2020,83865343,909.94,2,"Within where specific guess song successful nature. Free bar memory cause until wrong south.
Measure section month positive type interesting because gun. Entire paper foreign discuss kid.",12:01:40,IMPS
DCTX14808940860840,GB94WWYR43460145320993,1/28/2015,23243.52,100001,N,Credited,FF,POS,Cr,14:21:42,15:59:24,10/8/2020,85493247,909.94,6,"Turn authority line structure option.
Certain street do peace process. Animal throw goal citizen everything. Get production civil various. Every inside floor grow foreign through.",15:26:13,CHEQUE
DCTX14808940860840,GB94WWYR43460145320993,1/28/2015,22333.58,100001,Y,Online Shopping,EDGE,POS,Dr,18:12:30,21:02:38,10/8/2020,73696957,909.94,4,"Join now certainly. Still if model center. Development fund include point. Resource he worry particular follow cut.
Heart his amount improve. Other threat hope director.",20:23:41,UPI
DCTX14808940860840,GB94WWYR43460145320993,1/28/2015,22274.88,100001,Y,Transportation,EDGE,PC,Dr,12:35:57,16:03:07,10/16/2020,3265239,58.7,7,"Behind individual not federal from different too. In view section. Carry both support tax citizen white.
Who visit money. Moment security production former create. Art feel successful style.",14:33:16,DD
DCTX14808940860840,GB94WWYR43460145320993,1/28/2015,23133.02,100001,N,Credited,SAFARI,MOBILE,Cr,17:52:20,25:59:19,10/24/2020,19842455,858.14,7,"Example white no his whether. Week by later have interesting sort between.
Trial instead may listen night.",23:34:57,DD
DCTX14808940860840,GB94WWYR43460145320993,1/28/2015,23245.84,100001,N,Credited,IE,MOBILE,Cr,13:46:35,21:27:03,10/25/2020,18470512,112.82,3,"Yard maybe idea baby. Candidate rise television likely popular such wait.
Real reveal wall woman before. High attack know.",16:14:37,RTGS
DCTX14808940860840,GB94WWYR43460145320993,1/28/2015,22222.23,100001,Y,Insurance,MI,MOBILE,Dr,2:43:30,5:27:49,11/5/2020,89896907,1023.61,6,"Quality blue create such. Series fly follow television go. Part head himself who usually.
Exist military this eye rest ever. Full social clear once fund describe.",4:41:46,CHEQUE
DCTX14808940860840,GB94WWYR43460145320993,1/28/2015,21198.62,100001,Y,Medicals,MI,PC,Dr,7:28:07,10:36:08,11/5/2020,35872382,1023.61,4,Simply ground trade analysis military. Professional record factor majority wonder production clearly hard. Claim argue list range.,8:40:28,UPI
DCTX14808940860840,GB94WWYR43460145320993,1/28/2015,22222.23,100001,N,Credited,FF,MOBILE,Cr,14:24:13,16:39:39,11/5/2020,10981818,1023.61,3,Do drop treatment control such image. Score series test. Government past be discussion board crime fine answer.,15:49:26,RTGS
DCTX14808940860840,GB94WWYR43460145320993,1/28/2015,21198.62,100001,Y,Insurance,FF,PC,Dr,16:19:41,19:08:10,11/5/2020,93556927,1023.61,6,"Author company turn bag indeed nation. Poor dream allow smile behavior show sign.
Try level society letter money natural.
Shoulder feeling character specific career.",17:31:37,CHEQUE
DCTX14808940860840,GB94WWYR43460145320993,1/28/2015,20175.01,100001,Y,Personal Care,FF,MOBILE,Dr,18:59:23,21:10:48,11/5/2020,49681154,1023.61,5,"Window put we knowledge report. Course such should might series.
Turn let risk take TV none. Thing expect try. Do hear stage. Economic image prevent exist yet city benefit table.",20:33:26,CARDS
DCTX14808940860840,GB94WWYR43460145320993,1/28/2015,21492.24,100001,N,Credited,CHROME,POS,Cr,9:23:19,11:59:03,11/19/2020,9553965,1317.23,4,Miss sell expect anyone word. By city care adult official do baby success. Commercial media management.,10:08:01,UPI
DCTX14808940860840,GB94WWYR43460145320993,1/28/2015,22809.47,100001,N,Credited,FF,PC,Cr,14:55:33,19:06:14,11/19/2020,4315988,1317.23,1,Rock dog themselves itself. Choose scene respond. Wide analysis from career can quite.,16:43:08,NEFT
DCTX14808940860840,GB94WWYR43460145320993,1/28/2015,24126.7,100001,N,Credited,EDGE,PC,Cr,15:42:53,20:15:06,11/19/2020,88618753,1317.23,1,Measure own another get. Half glass against start investment help. Some president top across final woman.,18:13:09,NEFT
DCTX14808940860840,GB94WWYR43460145320993,1/28/2015,23016.6,100001,Y,Online Shopping,EDGE,POS,Dr,13:41:00,20:02:16,11/21/2020,57627496,1110.1,6,"For room everybody local. Water if response laugh but with writer.
Away now spring company. Smile college seven himself think agreement mind. No within into audience size easy author admit.",18:08:58,CHEQUE
DCTX14808940860840,GB94WWYR43460145320993,1/28/2015,23435.34,100001,N,Credited,FF,POS,Cr,7:58:25,11:28:02,11/29/2020,93725156,418.74,2,"My agent sister hour. Approach I should themselves throughout writer.
Big law other interview baby serious discussion. Performance treat his specific firm. Court build consider.",9:23:34,IMPS
DCTX14808940860840,GB94WWYR43460145320993,1/28/2015,23016.6,100001,Y,Rent,CHROME,POS,Dr,9:19:17,13:01:44,11/29/2020,68122065,418.74,1,"Memory miss camera usually society. Actually assume TV. Music security watch discover.
Fly everything shake again weight. Create situation then major question human.",11:09:25,NEFT
DCTX14808940860840,GB94WWYR43460145320993,1/28/2015,22597.86,100001,Y,Online Shopping,MI,PC,Dr,13:46:56,17:51:19,11/29/2020,50497317,418.74,2,"Son face general present whom. Traditional safe forward actually will war. Your change avoid head bill.
Real surface water shoulder. Charge sometimes three law.",15:49:53,IMPS
DCTX14808940860840,GB94WWYR43460145320993,1/28/2015,23016.6,100001,N,Credited,SAFARI,PC,Cr,18:11:43,21:13:11,11/29/2020,11350866,418.74,3,Stock name medical visit report. Film strong risk mind. Nice child argue beyond any space husband.,19:25:38,RTGS
DCTX14808940860840,GB94WWYR43460145320993,1/28/2015,21096.36,100001,Y,Household Consumables,SAFARI,POS,Dr,9:54:10,14:28:32,12/5/2020,95283487,1920.24,1,"Personal describe ago physical. Continue let economic candidate. Determine home arm easy service.
Current when live recently forward. Way indicate attack enough.",11:31:52,NEFT
DCTX14808940860840,GB94WWYR43460145320993,1/28/2015,23016.6,100001,N,Credited,CHROME,POS,Cr,14:17:04,20:25:55,12/5/2020,24481205,1920.24,5,Music scene go fly us growth capital near. Art plant wrong the return Democrat. Hotel discuss anything news card career.,17:19:46,CARDS
DCTX14808940860840,GB94WWYR43460145320993,1/28/2015,22361.55,100001,Y,Medicals,FF,MOBILE,Dr,12:18:53,17:38:41,12/8/2020,61203020,655.05,7,Nice risk view. Space hear vote write experience beautiful wind. Lead sense dinner Congress ahead. Body property offer leave even generation couple.,13:53:35,DD
DCTX14808940860840,GB94WWYR43460145320993,1/28/2015,21706.5,100001,Y,Online Shopping,MI,MOBILE,Dr,20:22:40,22:40:19,12/8/2020,94336887,655.05,3,"Statement themselves off high north. Image sound hope building baby whose.
Most morning car. Dream state could value scene difficult wall.",21:48:59,RTGS
DCTX14808940860840,GB94WWYR43460145320993,1/28/2015,22602.45,100001,N,Credited,IE,PC,Cr,10:18:05,13:49:35,12/10/2020,37968069,895.95,7,"Item wait individual might. Rate recognize standard democratic. Hope carry other.
Newspaper body protect onto feeling will receive idea. In catch that. Training product into fund firm fact campaign.",11:54:22,DD
DCTX14808940860840,GB94WWYR43460145320993,1/28/2015,23498.4,100001,N,Credited,MI,POS,Cr,21:31:50,25:14:06,12/10/2020,80613886,895.95,7,"Foreign tough compare tree. Expect return short American likely traditional exist. Memory service thank.
Hard certain exactly always religious show.
Campaign fill matter great build.",22:32:25,DD
DCTX14808940860840,GB94WWYR43460145320993,1/28/2015,23402.2,100001,Y,Groceries,SAFARI,PC,Dr,8:30:59,13:43:24,12/14/2020,32061239,96.2,6,Box source why term sometimes. There action something. Father growth animal interesting think peace development play.,11:09:48,CHEQUE
DCTX14808940860840,GB94WWYR43460145320993,1/28/2015,23306,100001,Y,Dining,OPERA,MOBILE,Dr,11:51:45,14:12:26,12/14/2020,93840170,96.2,2,"Writer city certainly. Part arm stand throughout.
Remember trial friend floor thing control or owner. All enter appear then treat.
For line garden other lot feeling power.",13:03:27,IMPS
DCTX14808940860840,GB94WWYR43460145320993,1/28/2015,23209.8,100001,Y,Groceries,SAFARI,MOBILE,Dr,18:53:44,21:29:37,12/14/2020,17716314,96.2,4,Really deal from lay here opportunity. Two area these interesting PM big chair. Provide particular down card across. Different day she lead end.,20:49:54,UPI
DCTX14808940860840,GB94WWYR43460145320993,1/28/2015,21319.42,100001,Y,Utilities,IE,PC,Dr,10:15:49,13:50:54,12/15/2020,39638588,1890.38,2,"Wait customer born rather.
Hope figure response forget place. Study be prove risk pay.",11:45:06,IMPS
DCTX14808940860840,GB94WWYR43460145320993,1/28/2015,23209.8,100001,N,Credited,OPERA,POS,Cr,15:20:49,18:04:59,12/15/2020,30353015,1890.38,2,"Third floor chance allow performance. Hotel religious site station particular.
Too public condition again pay sister hit. Contain success find. Indicate bad wind left tree participant.",17:10:12,IMPS
DCTX14808940860840,GB94WWYR43460145320993,1/28/2015,21319.42,100001,Y,Groceries,MI,PC,Dr,22:25:10,24:49:38,12/15/2020,47983977,1890.38,5,Fill nation standard entire for job again. Line unit position shoulder left account visit.,23:12:21,CARDS
DCTX14808940860840,GB94WWYR43460145320993,1/28/2015,21325.82,100001,N,Credited,FF,PC,Cr,6:01:06,8:34:16,12/21/2020,64970042,6.4,4,Certainly than entire goal peace with. Business however hold half your participant. Medical song service mission year college.,6:42:18,UPI
DCTX14808940860840,GB94WWYR43460145320993,1/28/2015,21319.42,100001,Y,Transportation,EDGE,POS,Dr,11:50:12,15:54:18,12/21/2020,84653260,6.4,3,Produce that coach whom speak visit manager. Congress company worry per now number middle. Name majority evening level.,13:49:17,RTGS
DCTX14808940860840,GB94WWYR43460145320993,1/28/2015,21325.82,100001,N,Credited,FF,MOBILE,Cr,16:42:19,20:48:39,12/21/2020,91514301,6.4,5,"Science wide test action number authority. Something white tree.
Identify ever hundred response school care health. Line physical show if time message. Wait whether should clear firm successful.",18:45:09,CARDS
DCTX14808940860840,GB94WWYR43460145320993,1/28/2015,21332.22,100001,N,Credited,SAFARI,MOBILE,Cr,19:14:35,21:07:19,12/21/2020,4268857,6.4,3,"Control participant better pretty away than. Wife we dark increase yes. East pressure serve guy small professor.
When rock few movie throughout per. Could option network wife.",20:07:22,RTGS
DCTX14808940860840,GB94WWYR43460145320993,1/28/2015,19753.74,100001,Y,Transportation,MI,MOBILE,Dr,7:27:10,11:46:43,12/22/2020,72458242,1578.48,1,Question yes career personal if mission process.,10:23:32,NEFT
DCTX14808940860840,GB94WWYR43460145320993,1/28/2015,21332.22,100001,N,Credited,IE,MOBILE,Cr,14:37:57,17:00:11,12/22/2020,57760360,1578.48,4,"For morning time term. Billion security class run painting.
Treatment hard go defense stuff gun. Language general scene throughout pretty several anyone. Well girl call chair.",16:13:13,UPI
DCTX14808940860840,GB94WWYR43460145320993,1/28/2015,19753.74,100001,Y,Medicals,OPERA,MOBILE,Dr,18:54:48,24:23:46,12/22/2020,80248583,1578.48,3,"How hand window probably eye air discussion. Within form subject.
Whole shake another ahead college your citizen. Her scientist cut fall. Security father operation participant special.",21:24:40,RTGS
DCTX14808940860840,GB94WWYR43460145320993,1/28/2015,18371.91,100001,Y,Household Consumables,MI,MOBILE,Dr,6:03:14,8:50:42,12/29/2020,30782532,1381.83,7,"Nature yes continue show college lawyer.
Look others your carry top enough political city. Gas maybe its them may. Compare hundred under tend figure sport yet.",7:06:59,DD
DCTX14808940860840,GB94WWYR43460145320993,1/28/2015,19753.74,100001,N,Credited,FF,MOBILE,Cr,10:42:36,13:57:24,12/29/2020,47659445,1381.83,1,This nothing line cultural machine instead mother. West left baby quality offer anyone traditional. Until late certain event education face.,12:39:36,NEFT
DCTX14808940860840,GB94WWYR43460145320993,1/28/2015,21135.57,100001,N,Credited,IE,MOBILE,Cr,13:36:04,16:28:20,12/29/2020,37546540,1381.83,4,Bag national report I break market. Easy right effort. Box television blue onto scene live kid.,14:58:40,UPI
DCTX14808940860840,GB94WWYR43460145320993,1/28/2015,19753.74,100001,Y,Insurance,OPERA,MOBILE,Dr,19:32:22,20:49:15,12/29/2020,8456144,1381.83,5,Important large present six. Believe hundred peace court statement professional practice. Relationship sister compare another decade purpose think.,20:16:51,CARDS
DCTX14808940860840,GB94WWYR43460145320993,1/28/2015,19227.42,100001,Y,Dining,IE,PC,Dr,9:15:49,14:10:53,1/2/2021,61197862,526.32,4,"Figure for brother usually draw force food. Third cause money head until.
Order pass democratic. Fact week especially close hard mind son. Party hope from customer police.",11:42:47,UPI
DCTX14808940860840,GB94WWYR43460145320993,1/28/2015,19753.74,100001,N,Credited,SAFARI,POS,Cr,10:13:59,13:33:23,1/2/2021,22002914,526.32,1,"Idea radio relate life. Relationship economic move drop worry wait series. Ever end vote like.
Throw draw along than seek. Fire your southern.",12:31:50,NEFT
DCTX14808940860840,GB94WWYR43460145320993,1/28/2015,19227.42,100001,Y,Rent,MI,PC,Dr,21:13:59,24:26:05,1/2/2021,27499146,526.32,5,Subject consumer decide threat on goal. East left return hundred last. Ok specific understand draw read yourself discussion have.,22:39:05,CARDS
DCTX14808940860840,GB94WWYR43460145320993,1/28/2015,18789.8,100001,Y,Household Consumables,SAFARI,MOBILE,Dr,7:38:05,11:22:28,1/7/2021,64639185,437.62,5,"Dog game mouth involve. Treatment whatever wear physical among figure.
Near century stay table. Without already serve trade second. Term likely world first.",8:53:30,CARDS
DCTX14808940860840,GB94WWYR43460145320993,1/28/2015,18352.18,100001,Y,Household Consumables,MI,MOBILE,Dr,13:08:13,14:55:17,1/7/2021,29509089,437.62,6,Material into southern would check. Almost probably ever scene day inside shoulder as. The probably high represent policy election the student.,14:10:32,CHEQUE
DCTX14808940860840,GB94WWYR43460145320993,1/28/2015,18789.8,100001,N,Credited,IE,MOBILE,Cr,22:36:18,25:37:37,1/7/2021,17999120,437.62,6,"Inside western home yes would prove. Game audience provide thank Congress. Office southern in operation parent. Fight add success know wrong sea difference.
Energy recent drug mention require world.",23:54:09,CHEQUE
DCTX14808940860840,GB94WWYR43460145320993,1/28/2015,19313.97,100001,N,Credited,SAFARI,PC,Cr,7:04:30,10:59:45,1/13/2021,24047890,524.17,3,Magazine than direction stock measure common such. Brother pick network indicate television big article.,9:10:08,RTGS
DCTX14808940860840,GB94WWYR43460145320993,1/28/2015,18789.8,100001,Y,Insurance,OPERA,PC,Dr,9:35:47,12:35:12,1/13/2021,32035230,524.17,1,Executive debate generation. Baby care process stuff camera worry skill. Radio occur environmental want. Condition source instead avoid thus total treat.,11:33:25,NEFT
DCTX14808940860840,GB94WWYR43460145320993,1/28/2015,19313.97,100001,N,Credited,EDGE,PC,Cr,12:57:07,16:35:41,1/13/2021,8406897,524.17,2,"Size career detail white heart allow. Age offer glass. Until soldier various.
Anything almost foreign catch growth thought never. Support sport usually try.",14:51:52,IMPS
DCTX14808940860840,GB94WWYR43460145320993,1/28/2015,19838.14,100001,N,Credited,SAFARI,POS,Cr,18:31:13,21:52:19,1/13/2021,54669628,524.17,7,"Seek while war win everyone. Listen same leave direction few several.
Six again window where second. Arrive likely season election feel. Machine everybody almost sport treat ground.",20:31:22,DD
DCTX14808940860840,GB94WWYR43460145320993,1/28/2015,21289.2,100001,N,Credited,EDGE,PC,Cr,6:29:29,9:55:38,1/17/2021,87504811,1451.06,7,Computer agree edge their reality want care. Head leave people thank option.,8:01:07,DD
DCTX14808940860840,GB94WWYR43460145320993,1/28/2015,19838.14,100001,Y,Dining,MI,POS,Dr,7:24:08,10:19:53,1/17/2021,85031029,1451.06,4,"Forward member industry young property able.
Indicate cold per compare he. Power talk some.",9:45:10,UPI
DCTX14808940860840,GB94WWYR43460145320993,1/28/2015,21289.2,100001,N,Credited,IE,POS,Cr,13:56:45,18:15:22,1/17/2021,42508366,1451.06,5,"Too lead radio old fish small TV. Civil network standard important office.
Support responsibility service why fact. Sometimes vote who control moment when. Say market discuss while site send.",16:18:09,CARDS
DCTX14808940860840,GB94WWYR43460145320993,1/28/2015,19838.14,100001,Y,Utilities,EDGE,MOBILE,Dr,19:21:21,22:34:53,1/17/2021,35822325,1451.06,6,"Mission safe ok significant sister decade clearly. Either tonight view garden little nation.
Wife race some fill contain know threat. Whom indeed hot cold. Book live including if.",20:24:29,CHEQUE
DCTX14808940860840,GB94WWYR43460145320993,1/28/2015,19316.22,100001,Y,Entertainment,SAFARI,MOBILE,Dr,6:48:12,8:41:49,2/3/2021,36478743,521.92,2,"Ahead east she deal. Stop development particularly type. Turn foreign carry impact eight.
Future let believe safe middle. Project eye notice almost possible community fill institution.",7:27:46,IMPS
DCTX14808940860840,GB94WWYR43460145320993,1/28/2015,18794.3,100001,Y,Household Consumables,SAFARI,MOBILE,Dr,9:03:21,12:04:26,2/3/2021,37234850,521.92,4,Very whatever large bar. Middle maintain foot example adult together. Rock serve partner image scene under another.,10:14:35,UPI
DCTX14808940860840,GB94WWYR43460145320993,1/28/2015,18272.38,100001,Y,Entertainment,FF,PC,Dr,12:20:45,15:25:03,2/3/2021,98169856,521.92,2,Energy under central we though sport turn teacher. Loss however artist agency sea lot sometimes. Attention campaign few lawyer decade building goal.,13:30:01,IMPS
DCTX14808940860840,GB94WWYR43460145320993,1/28/2015,18794.3,100001,N,Credited,FF,PC,Cr,16:11:56,17:49:36,2/3/2021,15552624,521.92,2,"Possible suffer skin. Police ground bad four listen capital.
Bit safe spring thought fact. Difficult thing probably political. Movie sport computer sound green. Watch but management vote myself.",17:20:59,IMPS
DCTX14808940860840,GB94WWYR43460145320993,1/28/2015,19316.22,100001,N,Credited,OPERA,MOBILE,Cr,21:11:39,24:31:27,2/3/2021,66413868,521.92,1,"Style go blue phone realize then media to. Start simple during tree. Each ok after party.
Do style fire state tax. Enjoy party life half perform.",22:53:00,NEFT
DCTX14808940860840,GB94WWYR43460145320993,1/28/2015,19927.8,100001,N,Credited,MI,PC,Cr,8:17:53,14:49:57,2/21/2021,497466,611.58,4,"Action arrive true understand personal prevent response. Heart answer same although task attorney happen. Safe building military heavy participant.
Job card yes eye attack rule film hot.",11:36:20,UPI
DCTX14808940860840,GB94WWYR43460145320993,1/28/2015,20539.38,100001,N,Credited,SAFARI,MOBILE,Cr,18:34:18,21:27:22,2/21/2021,19779911,611.58,6,"Keep central quite remember. Of factor color able real.
Protect have likely election. Anyone activity attention again smile. Call case instead commercial fight.",20:34:47,CHEQUE
DCTX14808940860840,GB94WWYR43460145320993,1/28/2015,19125.41,100001,Y,Dining,OPERA,POS,Dr,11:14:41,18:10:28,2/22/2021,12761418,1413.97,5,"Process say college itself trouble lay. Yeah street financial Mr serve throw.
Writer consumer religious personal any. Here court employee specific suggest interest.",13:58:24,CARDS
DCTX14808940860840,GB94WWYR43460145320993,1/28/2015,17709.89,100001,Y,Rent,OPERA,MOBILE,Dr,10:11:02,14:05:01,2/24/2021,58474969,1415.52,3,"Exist let would say most. Eye where laugh eight major street effect. Draw Congress human magazine.
Attorney enough southern pattern big. Nation develop poor its these rest decade.",11:25:00,RTGS
DCTX14808940860840,GB94WWYR43460145320993,1/28/2015,19125.41,100001,N,Credited,MI,POS,Cr,13:38:40,15:50:10,2/24/2021,53074492,1415.52,7,Magazine collection believe stand. Stuff still job instead poor improve much task. Rest room ground image price national.,14:55:00,DD
DCTX14808940860840,GB94WWYR43460145320993,1/28/2015,17709.89,100001,Y,Insurance,EDGE,PC,Dr,20:33:40,24:22:19,2/24/2021,31424837,1415.52,6,"Check he owner series picture yet commercial. Almost remain gas economy such alone that.
Know single never edge herself.",22:32:53,CHEQUE
DCTX14808940860840,GB94WWYR43460145320993,1/28/2015,18952.17,100001,N,Credited,IE,PC,Cr,4:55:35,9:59:13,2/26/2021,28328070,1242.28,3,"Figure type form drop drive. Be television spend a. Name later new.
Main television entire human fund. Western positive number quality role practice. That news hour set me.",6:59:58,RTGS
DCTX14808940860840,GB94WWYR43460145320993,1/28/2015,17709.89,100001,Y,Groceries,OPERA,MOBILE,Dr,14:34:58,17:24:43,2/26/2021,88471914,1242.28,4,"Soon discuss woman can apply. Identify forget discover once. Mention fact man evening.
Age environmental recent none see travel prove. Represent hand production. Discover campaign score.",16:39:30,UPI
DCTX14808940860840,GB94WWYR43460145320993,1/28/2015,18952.17,100001,N,Credited,SAFARI,MOBILE,Cr,21:47:40,24:25:18,2/26/2021,95398655,1242.28,6,"Generation parent natural factor. Step go wonder investment stand sit. Firm woman particular type.
Performance lay industry throughout. Move like occur hold run phone industry.",23:28:16,CHEQUE
DCTX14808940860840,GB94WWYR43460145320993,1/28/2015,20446.77,100001,N,Credited,OPERA,MOBILE,Cr,11:13:35,17:07:22,2/28/2021,6132866,1494.6,6,"Bring herself prepare maybe finish drug education.
Decide thing oil address main. Fight care tonight left ability. Impact resource office any ten investment.",14:25:01,CHEQUE
DCTX14808940860840,GB94WWYR43460145320993,1/28/2015,21941.37,100001,N,Credited,MI,MOBILE,Cr,21:09:54,26:43:42,2/28/2021,87057874,1494.6,7,"Environment dinner market couple manage not mind. Policy prove must.
Employee employee safe method power material structure. South standard site daughter range big value.",23:58:06,DD
DCTX14808940860840,GB94WWYR43460145320993,1/28/2015,21074.96,100001,Y,Groceries,EDGE,MOBILE,Dr,6:05:55,8:59:33,3/1/2021,93702744,866.41,3,"Energy which standard home north alone challenge. Look short might task task science onto may.
System enough professor let which. Require at important performance.",7:31:55,RTGS
DCTX14808940860840,GB94WWYR43460145320993,1/28/2015,21941.37,100001,N,Credited,IE,MOBILE,Cr,8:14:18,9:40:51,3/1/2021,61538184,866.41,2,Traditional much or power contain stay still actually. Help personal growth send society nothing matter. Benefit attack trade we deal discuss help.,8:44:43,IMPS
DCTX14808940860840,GB94WWYR43460145320993,1/28/2015,22807.78,100001,N,Credited,EDGE,PC,Cr,10:57:45,13:01:36,3/1/2021,94393484,866.41,4,"Trouble out leader father.
Sound cut piece. Result pretty wrong night close discuss three. Ten television west course level surface car language.",12:15:29,UPI
DCTX14808940860840,GB94WWYR43460145320993,1/28/2015,23674.19,100001,N,Credited,IE,MOBILE,Cr,18:14:43,21:08:11,3/1/2021,4989981,866.41,1,"Stand real save least analysis for. Game win up focus far campaign. See son policy smile. Past Democrat yes who sometimes lot media.
Would black son. Ability writer student its.",19:35:47,NEFT
DCTX14808940860840,GB94WWYR43460145320993,1/28/2015,24540.6,100001,N,Credited,EDGE,PC,Cr,20:45:58,23:09:39,3/1/2021,38145049,866.41,5,Fill hit couple set involve number. Operation might place to.,21:53:38,CARDS
DCTX14808940860840,GB94WWYR43460145320993,1/28/2015,26111.63,100001,N,Credited,FF,MOBILE,Cr,9:00:48,13:18:55,3/7/2021,4258506,1571.03,3,"Available almost black between kid exist agency. Term whole project without machine tell.
Budget from simple move card money my. Huge each my customer like poor.",11:20:56,RTGS
DCTX14808940860840,GB94WWYR43460145320993,1/28/2015,27682.66,100001,N,Credited,CHROME,PC,Cr,14:37:40,19:20:08,3/7/2021,84734327,1571.03,3,Statement suddenly arrive security. Relate work follow long attack. Scientist response cold than behavior necessary both.,17:13:18,RTGS
DCTX14808940860840,GB94WWYR43460145320993,1/28/2015,29253.69,100001,N,Credited,OPERA,POS,Cr,22:05:02,24:03:19,3/7/2021,48718486,1571.03,3,Most line force may. Necessary song billion. Leader show understand finish none rather stay well.,23:04:07,RTGS
DCTX14808940860840,GB94WWYR43460145320993,1/28/2015,30873.09,100001,N,Credited,EDGE,POS,Cr,5:41:21,9:30:39,3/10/2021,17859356,1619.4,3,Exactly truth house even democratic fine see. Check glass catch term tell.,7:30:52,RTGS
DCTX14808940860840,GB94WWYR43460145320993,1/28/2015,29253.69,100001,Y,Entertainment,MI,MOBILE,Dr,8:44:28,11:55:27,3/10/2021,44731229,1619.4,3,"Discussion report approach very probably standard door. Effect situation she.
Party manager film art still. Why one their understand recent. Focus stock camera may society.",9:59:04,RTGS
DCTX14808940860840,GB94WWYR43460145320993,1/28/2015,30873.09,100001,N,Credited,MI,PC,Cr,13:22:00,16:05:53,3/10/2021,39678881,1619.4,6,"Discussion ball international through. Argue else exist drug. Each attorney artist eat way cell.
Study bed know throughout idea citizen current. Soldier develop least fast artist night.",14:48:00,CHEQUE
DCTX14808940860840,GB94WWYR43460145320993,1/28/2015,29253.69,100001,Y,Dining,CHROME,POS,Dr,19:01:56,22:21:30,3/10/2021,43541744,1619.4,4,"Full example mother usually force.
His particularly run general. Increase state course pull war wonder toward discuss. Sell person tree.
By fear huge very. Artist material stand.",20:29:00,UPI
DCTX14808940860840,GB94WWYR43460145320993,1/28/2015,28978.4,100001,Y,Dining,FF,POS,Dr,9:40:22,13:16:55,3/14/2021,15711991,275.29,2,"Common go run minute all as pull. Serve draw spring fly report response.
Third our middle employee financial high. Community attention certainly real serve.",11:34:49,IMPS
DCTX14808940860840,GB94WWYR43460145320993,1/28/2015,28703.11,100001,Y,Medicals,CHROME,PC,Dr,11:47:52,16:57:47,3/14/2021,39070890,275.29,4,"Meet Mr drop peace bring social. According worker law choice low.
Career radio check statement. Change these office answer good rather. Yeah owner happy into north though.",14:02:04,UPI
DCTX14808940860840,GB94WWYR43460145320993,1/28/2015,28978.4,100001,N,Credited,IE,POS,Cr,20:05:55,23:28:57,3/14/2021,26196381,275.29,7,"Hard box decision.
Sort law about direction build try almost sea. Energy course foot western themselves.
Yet policy under the. Anything performance property worry relationship adult money need.",20:56:43,DD
DCTX14808940860840,GB94WWYR43460145320993,1/28/2015,27941.26,100001,Y,Transportation,IE,MOBILE,Dr,10:26:11,16:05:10,4/4/2021,28290773,1037.14,6,"Our guy brother term sense tree art. Candidate major test little court.
Sound area another stop visit protect method. Matter myself music lot always.",13:55:32,CHEQUE
DCTX14808940860840,GB94WWYR43460145320993,1/28/2015,26904.12,100001,Y,Utilities,IE,POS,Dr,20:02:55,24:29:22,4/4/2021,48896733,1037.14,1,"Bed group move buy same. Worry best nation. Again bed collection. Include such under.
Level skin it process Republican country environmental. Television professor cut. Tend worker song.",22:45:57,NEFT
DCTX14808940860840,GB94WWYR43460145320993,1/28/2015,25272.15,100001,Y,Insurance,MI,POS,Dr,8:16:49,10:01:16,4/5/2021,80952831,1631.97,7,Debate life toward system. Image onto mission start other. Here south significant create someone evening.,8:57:13,DD
DCTX14808940860840,GB94WWYR43460145320993,1/28/2015,23640.18,100001,Y,Insurance,IE,POS,Dr,10:23:07,14:35:09,4/5/2021,6943745,1631.97,1,"Focus plant smile school action consumer movie. Eight attack feel rule decade difference recognize. Garden television treatment suggest.
Situation easy tax. I measure imagine number surface.",12:30:55,NEFT
DCTX14808940860840,GB94WWYR43460145320993,1/28/2015,25272.15,100001,N,Credited,EDGE,MOBILE,Cr,18:57:10,23:30:45,4/5/2021,81343669,1631.97,4,"Indeed around community watch new computer support. Network on view maybe.
Amount much nor nature nice minute thus. Best trial next officer skin. You scene enter decade live consider until present.",20:50:51,UPI
DCTX14808940860840,GB94WWYR43460145320993,1/28/2015,25604.11,100001,N,Credited,OPERA,PC,Cr,18:25:50,28:46:59,4/7/2021,62975964,331.96,2,"Third treat history spring. Four candidate project. Purpose open myself.
Respond unit scene able. Argue once institution much product special along experience. Member plan race vote.",23:58:47,IMPS
DCTX14808940860840,GB94WWYR43460145320993,1/28/2015,23935.65,100001,Y,Insurance,EDGE,MOBILE,Dr,15:02:13,21:18:34,4/14/2021,76225789,1668.46,2,"Offer film direction smile. Myself financial myself Republican eye night yourself college.
Second already talk. Item positive affect. Eight whom land least receive we.",16:18:48,IMPS
DCTX14808940860840,GB94WWYR43460145320993,1/28/2015,22746.52,100001,Y,Entertainment,MI,POS,Dr,3:22:19,6:21:26,4/18/2021,79580076,1189.13,5,"Than quickly control lose. Anything usually field war catch shake.
Analysis affect make pull. Me she while admit.",5:08:38,CARDS
DCTX14808940860840,GB94WWYR43460145320993,1/28/2015,23935.65,100001,N,Credited,CHROME,MOBILE,Cr,8:37:47,11:23:47,4/18/2021,88096964,1189.13,3,Traditional upon lawyer develop card either pressure. Available store themselves ability community politics majority plan. Allow serious serious field.,10:31:49,RTGS
DCTX14808940860840,GB94WWYR43460145320993,1/28/2015,25124.78,100001,N,Credited,IE,PC,Cr,13:21:01,16:19:17,4/18/2021,17956239,1189.13,7,"Quality friend high traditional these information enjoy at. Popular message expert.
Political born food than current player. Possible ability them have cold gun. School together prove wife.",15:19:14,DD
DCTX14808940860840,GB94WWYR43460145320993,1/28/2015,26313.91,100001,N,Credited,IE,MOBILE,Cr,17:57:46,20:37:51,4/18/2021,22578730,1189.13,4,Challenge little professional bring current. Reach technology I recognize. Source ago once much room.,19:31:51,UPI
DCTX14808940860840,GB94WWYR43460145320993,1/28/2015,27503.04,100001,N,Credited,OPERA,PC,Cr,23:00:53,25:42:38,4/18/2021,76112270,1189.13,4,"Employee woman animal continue table. Onto through agency white future.
Game gas technology teacher already it. Newspaper price return course they American century.",23:45:29,UPI
DCTX14808940860840,GB94WWYR43460145320993,1/28/2015,27906.4,100001,N,Credited,OPERA,POS,Cr,5:56:25,8:17:53,4/19/2021,14751783,403.36,5,One reach not research. Old then goal country allow position city. Lead again art couple. Bar his southern rate child radio member.,6:30:38,CARDS
DCTX14808940860840,GB94WWYR43460145320993,1/28/2015,28309.76,100001,N,Credited,IE,PC,Cr,7:19:04,10:46:38,4/19/2021,62853712,403.36,3,Option media million. Dream build his even training. Else else performance power I when similar. Paper dream consider born wonder step brother.,8:59:45,RTGS
DCTX14808940860840,GB94WWYR43460145320993,1/28/2015,28713.12,100001,N,Credited,MI,PC,Cr,11:09:42,13:16:48,4/19/2021,29231553,403.36,6,Relate raise break weight. Term table Republican I gun price lay. Almost style suddenly significant.,12:39:50,CHEQUE
DCTX14808940860840,GB94WWYR43460145320993,1/28/2015,29116.48,100001,N,Credited,EDGE,PC,Cr,16:23:30,19:29:44,4/19/2021,58790090,403.36,4,Individual usually fast free evidence various bring. Home the go rate. Onto politics force happen. Rich artist out little remember.,18:06:16,UPI
DCTX14808940860840,GB94WWYR43460145320993,1/28/2015,29519.84,100001,N,Credited,OPERA,MOBILE,Cr,22:51:30,24:20:36,4/19/2021,31835725,403.36,7,Tough game speech occur expert surface. Worry oil worry. Behavior opportunity city well key. Realize compare probably chance lead bring.,23:51:17,DD
DCTX14808940860840,GB94WWYR43460145320993,1/28/2015,31182.7,100001,N,Credited,SAFARI,MOBILE,Cr,9:37:51,13:36:50,4/22/2021,22429148,1662.86,1,Week clear edge control old. Letter population summer skin despite high low. Beautiful control act base green another three.,11:17:45,NEFT
DCTX14808940860840,GB94WWYR43460145320993,1/28/2015,32845.56,100001,N,Credited,EDGE,PC,Cr,14:05:48,19:39:00,4/22/2021,32782318,1662.86,2,Cup fine herself any local how. Commercial gas reach letter gun trip house. Activity ball him that itself not voice treat.,16:48:35,IMPS
DCTX14808940860840,GB94WWYR43460145320993,1/28/2015,31182.7,100001,Y,Medicals,EDGE,POS,Dr,16:06:28,19:54:58,4/22/2021,65355008,1662.86,4,Arrive minute gun represent recent. Form girl decide area loss professor. Continue stock usually especially. Or ready look do.,18:02:04,UPI
DCTX14808940860840,GB94WWYR43460145320993,1/28/2015,29454.67,100001,Y,Groceries,SAFARI,POS,Dr,21:00:52,25:53:16,4/24/2021,72836224,1728.03,2,"Glass trip something difference. Tax be able government response figure.
Medical myself brother table will.",23:35:47,IMPS
DCTX14808940860840,GB94WWYR43460145320993,1/28/2015,28526.8,100001,Y,Dining,IE,MOBILE,Dr,3:54:49,7:45:05,5/1/2021,85831377,927.87,2,"Fill product throw company. Information cultural law score pass.
Young expect executive under follow friend employee anything. Head concern girl while address environment need.",5:27:19,IMPS
DCTX14808940860840,GB94WWYR43460145320993,1/28/2015,29454.67,100001,N,Credited,SAFARI,PC,Cr,12:50:58,14:42:11,5/1/2021,53277824,927.87,7,Sometimes pull unit different onto high. Trip hard likely nothing center. Heart industry thing degree answer adult really. Ability prove without down ask professional if.,13:22:31,DD
DCTX14808940860840,GB94WWYR43460145320993,1/28/2015,30382.54,100001,N,Credited,OPERA,PC,Cr,15:28:51,18:27:49,5/1/2021,78099159,927.87,7,Cup dream would where. Box family whether phone may street case. Grow face various write.,17:28:41,DD
DCTX14808940860840,GB94WWYR43460145320993,1/28/2015,29454.67,100001,Y,Personal Care,FF,MOBILE,Dr,19:15:29,22:18:10,5/1/2021,36785711,927.87,1,Available affect must yeah could fight. Card run finally. Live customer morning note simple heart.,21:18:38,NEFT
DCTX14808940860840,GB94WWYR43460145320993,1/28/2015,31037.36,100001,N,Credited,CHROME,PC,Cr,11:59:43,19:25:46,5/6/2021,95893662,1582.69,1,Agree process bring he few draw. About peace magazine worry now growth. Factor believe old may person onto their.,17:33:58,NEFT
DCTX14808940860840,GB94WWYR43460145320993,1/28/2015,30186.81,100001,Y,Dining,SAFARI,PC,Dr,6:57:13,9:57:58,5/13/2021,11298717,850.55,7,"Price vote her run. Week Congress hundred more several claim.
Treat church past method population to control bring.",8:05:54,DD
DCTX14808940860840,GB94WWYR43460145320993,1/28/2015,31037.36,100001,N,Credited,CHROME,MOBILE,Cr,11:39:06,14:40:24,5/13/2021,92938328,850.55,4,Next skill exist account final. Behavior still best head million dinner inside. Hospital upon study go your.,13:33:48,UPI
DCTX14808940860840,GB94WWYR43460145320993,1/28/2015,30186.81,100001,Y,Groceries,FF,POS,Dr,12:57:45,15:37:18,5/13/2021,33609119,850.55,6,"Performance everyone not two could run drive. A mention poor no.
Machine generation ago position. Building nor strong of popular side. Bag couple see include fight room.",14:38:19,CHEQUE
DCTX14808940860840,GB94WWYR43460145320993,1/28/2015,31037.36,100001,N,Credited,IE,MOBILE,Cr,20:10:06,24:06:16,5/13/2021,14231582,850.55,4,"Second board law property the. Much a home money employee. Character goal maintain whose.
Reality student everything understand. Suffer research pass.",22:08:32,UPI
DCTX14808940860840,GB94WWYR43460145320993,1/28/2015,30775.24,100001,Y,Online Shopping,CHROME,PC,Dr,5:51:25,8:33:07,5/17/2021,12472864,262.12,2,"Actually myself his fast from develop end. House of they argue stop. Piece not trip both.
Pass wonder around professional throughout card. Offer trip life society. Call identify fear traditional.",7:07:38,IMPS
DCTX14808940860840,GB94WWYR43460145320993,1/28/2015,30513.12,100001,Y,Transportation,MI,PC,Dr,10:52:15,12:37:44,5/17/2021,89153246,262.12,2,"Include look general any laugh everyone produce. Environment alone color key. Whatever consumer suggest onto research billion.
Night them by total.",11:37:01,IMPS
DCTX14808940860840,GB94WWYR43460145320993,1/28/2015,30251,100001,Y,Insurance,CHROME,PC,Dr,13:55:03,15:09:56,5/17/2021,77432162,262.12,2,"Situation try keep structure prove learn stay scientist. White before security organization. Still lead political seat data.
Bad ground tough very left prove treat.",14:28:34,IMPS
DCTX14808940860840,GB94WWYR43460145320993,1/28/2015,30513.12,100001,N,Credited,SAFARI,POS,Cr,14:55:46,17:49:46,5/17/2021,41296486,262.12,5,"Size though be special. Serve drug kid. Quite them start policy clear value.
Meet force public this. Apply enjoy good.
Success matter bag situation couple.
Who lay mouth center hand security.",16:07:03,CARDS
DCTX14808940860840,GB94WWYR43460145320993,1/28/2015,30775.24,100001,N,Credited,CHROME,POS,Cr,21:18:49,23:05:33,5/17/2021,68198169,262.12,3,Likely respond small trouble. President it language often book music. Step social buy despite produce national edge.,21:47:11,RTGS
DCTX14808940860840,GB94WWYR43460145320993,1/28/2015,30570.56,100001,Y,Medicals,MI,POS,Dr,4:25:24,9:50:37,5/22/2021,58489390,204.68,6,Best better board perhaps ahead Democrat baby film. Commercial direction deal economic make imagine. Network itself card fast evidence already glass.,7:13:24,CHEQUE
DCTX14808940860840,GB94WWYR43460145320993,1/28/2015,30365.88,100001,Y,Insurance,EDGE,PC,Dr,13:40:48,16:44:23,5/22/2021,86866248,204.68,7,"Pm talk similar situation. Finish act perhaps take put senior.
Billion officer to admit. Actually method deal important. Seek ground born boy.",16:00:38,DD
DCTX14808940860840,GB94WWYR43460145320993,1/28/2015,30570.56,100001,N,Credited,EDGE,MOBILE,Cr,21:31:39,24:28:13,5/22/2021,24919364,204.68,4,"Tv phone attention everyone. Stop art community small develop off.
Everyone you goal analysis head data.",22:43:59,UPI
DCTX14808940860840,GB94WWYR43460145320993,1/28/2015,29110.29,100001,Y,Online Shopping,CHROME,MOBILE,Dr,12:30:34,15:38:59,5/25/2021,69310232,1460.27,5,"North actually child director. Claim performance view agency.
And full onto must leader foreign itself forward. Page arm national foreign language protect everyone under.",14:30:31,CARDS
DCTX14808940860840,GB94WWYR43460145320993,1/28/2015,30570.56,100001,N,Credited,SAFARI,POS,Cr,17:24:23,21:00:10,5/25/2021,74811458,1460.27,6,"Kind check wide authority. Deep mission along mouth.
Pm business air any free discuss. Daughter everybody present agent black. Degree draw west hold same. Worker job size.",18:45:20,CHEQUE
DCTX14808940860840,GB94WWYR43460145320993,1/28/2015,31834.25,100001,N,Credited,OPERA,MOBILE,Cr,18:02:42,25:41:24,5/30/2021,53534491,1263.69,2,"News experience government rich item he life. Too out whose onto.
Real performance physical rich night kind. Ask prevent view opportunity. Again loss top style parent.",23:00:21,IMPS
DCTX14808940860840,GB94WWYR43460145320993,1/28/2015,30901.61,100001,Y,Entertainment,CHROME,MOBILE,Dr,19:01:27,26:32:23,6/15/2021,65241349,932.64,1,As administration score political these while. Body television sign yet most clearly nothing.,20:49:23,NEFT
DCTX14808940860840,GB94WWYR43460145320993,1/28/2015,29572.01,100001,Y,Personal Care,IE,MOBILE,Dr,16:33:21,21:31:48,6/18/2021,45548505,1329.6,7,"Option where create sport positive budget. Positive own so would instead free pressure figure.
Help wait represent we compare billion. Tend business almost fine development car.",20:03:48,DD
DCTX14808940860840,GB94WWYR43460145320993,1/28/2015,30960.74,100001,N,Credited,OPERA,POS,Cr,13:17:22,20:45:15,6/21/2021,47961562,1388.73,7,Family could no. Important prove model somebody. Certain party finish media wall item drive.,17:02:53,DD
DCTX14808940860840,GB94WWYR43460145320993,1/28/2015,30658.18,100001,Y,Insurance,SAFARI,MOBILE,Dr,6:08:12,10:28:48,6/28/2021,40250731,302.56,5,Edge Mr quickly dream north owner claim. Describe candidate practice husband my option pick. Suddenly road need create business upon leg tend.,7:58:46,CARDS
DCTX14808940860840,GB94WWYR43460145320993,1/28/2015,30960.74,100001,N,Credited,OPERA,POS,Cr,11:08:57,13:50:07,6/28/2021,47363724,302.56,1,"Improve dream lay feeling. Film population piece tell.
Story by in hundred from style across. Couple visit reduce fall early respond second.",12:05:26,NEFT
DCTX14808940860840,GB94WWYR43460145320993,1/28/2015,30658.18,100001,Y,Insurance,CHROME,POS,Dr,19:39:44,22:22:35,6/28/2021,74085545,302.56,6,Issue page effort any involve sure. National thank audience sing. More nor these community occur.,21:07:46,CHEQUE
DCTX14808940860840,GB94WWYR43460145320993,1/28/2015,29655.38,100001,Y,Groceries,IE,PC,Dr,16:00:55,26:30:56,7/2/2021,21540011,1002.8,1,Receive him like reality describe drive. Really nothing town trial than later require happy.,21:55:01,NEFT
DCTX14808940860840,GB94WWYR43460145320993,1/28/2015,30504.88,100001,N,Credited,IE,MOBILE,Cr,13:39:28,22:40:46,7/10/2021,14290749,849.5,4,"Be mean article. Majority direction against allow game sing minute despite. Watch money happen him remain ball.
Hundred policy international large. Friend energy paper account art fear build.",19:33:07,UPI
DCTX14808940860840,GB94WWYR43460145320993,1/28/2015,29157.04,100001,Y,Personal Care,FF,POS,Dr,6:48:39,9:31:28,7/17/2021,97180272,1347.84,1,Tell reduce offer vote. Individual table control generation economic subject various bad. Then trade newspaper strong free successful.,7:43:45,NEFT
DCTX14808940860840,GB94WWYR43460145320993,1/28/2015,30504.88,100001,N,Credited,CHROME,PC,Cr,10:35:14,13:06:40,7/17/2021,78766532,1347.84,4,"Treat memory establish live law. Question size general off every.
Require poor lawyer doctor.
Space spend cultural spend measure black seven mouth. Partner throughout at lawyer range.",12:25:06,UPI
DCTX14808940860840,GB94WWYR43460145320993,1/28/2015,31852.72,100001,N,Credited,OPERA,POS,Cr,14:31:39,16:03:30,7/17/2021,40624808,1347.84,7,She stop vote serious fill every produce. Wait stock him if know paper. Against cut pull her throw home. Class yet him argue.,15:20:46,DD
DCTX14808940860840,GB94WWYR43460145320993,1/28/2015,33200.56,100001,N,Credited,MI,POS,Cr,18:08:55,22:07:25,7/17/2021,8625908,1347.84,4,"Story within dog mother. Wall television chair in boy pick generation stop. Feeling choice eight certainly.
Bag leave child explain power. Source audience control event direction.",20:00:11,UPI
DCTX14808940860840,GB94WWYR43460145320993,1/28/2015,31783.81,100001,Y,Groceries,SAFARI,POS,Dr,5:47:13,8:10:11,7/21/2021,71819860,1416.75,7,"Friend catch probably break strong manager certainly. Good relationship by describe trade. Dark similar reach.
Compare situation each huge. Occur against senior just.",6:40:55,DD
DCTX14808940860840,GB94WWYR43460145320993,1/28/2015,33200.56,100001,N,Credited,SAFARI,PC,Cr,14:24:51,17:20:31,7/21/2021,78713635,1416.75,4,"Space the recent star. Hope might participant hour field consumer seem.
Available scientist name ever.",15:53:47,UPI
DCTX14808940860840,GB94WWYR43460145320993,1/28/2015,31783.81,100001,Y,Groceries,EDGE,POS,Dr,17:36:26,19:33:08,7/21/2021,75860004,1416.75,2,Mean interesting audience difficult parent.,18:43:29,IMPS
DCTX14808940860840,GB94WWYR43460145320993,1/28/2015,31983.55,100001,N,Credited,IE,PC,Cr,7:27:42,13:47:00,7/26/2021,18202311,199.74,2,Size discuss method page painting thing coach. Shake election air. Back involve energy among local exactly.,11:18:06,IMPS
DCTX14808940860840,GB94WWYR43460145320993,1/28/2015,31783.81,100001,Y,Utilities,EDGE,POS,Dr,19:29:31,25:31:18,7/26/2021,80560838,199.74,3,"Huge position financial project imagine everyone. The yes phone receive help attention.
Guy family expert protect those. Know argue time couple deal own later.",21:36:25,RTGS
DCTX14808940860840,GB94WWYR43460145320993,1/28/2015,30228.35,100001,Y,Household Consumables,IE,PC,Dr,2:44:47,5:03:02,8/4/2021,69511325,1555.46,1,"Seek administration himself style body know. Care wind with tree treat woman Democrat decade.
Heart sort name couple those result benefit. Learn brother word yes.",4:09:35,NEFT
DCTX14808940860840,GB94WWYR43460145320993,1/28/2015,28672.89,100001,Y,Online Shopping,OPERA,PC,Dr,8:24:07,11:27:39,8/4/2021,60705068,1555.46,6,Foot score run long drug activity. Recent enter claim collection bit tell. Phone professional Democrat us shoulder attack story. Move close adult understand.,10:08:54,CHEQUE
DCTX14808940860840,GB94WWYR43460145320993,1/28/2015,30228.35,100001,N,Credited,OPERA,PC,Cr,13:01:02,14:59:00,8/4/2021,81623648,1555.46,2,"Head area science. Any site capital soldier year begin success.
Manager might industry production happy never free. Dinner theory sit him son father activity. Write crime area sit recent doctor.",14:15:58,IMPS
DCTX14808940860840,GB94WWYR43460145320993,1/28/2015,31783.81,100001,N,Credited,EDGE,POS,Cr,16:41:20,18:23:35,8/4/2021,37942588,1555.46,1,"We account test material large. Mission future condition.
Character article sit along style. President will improve rule low.",17:53:03,NEFT
DCTX14808940860840,GB94WWYR43460145320993,1/28/2015,30228.35,100001,Y,Medicals,FF,PC,Dr,19:25:08,21:20:35,8/4/2021,53593559,1555.46,1,"Card hundred service able teacher. Third allow statement hold she stop. Need test fire level my address agent.
Card network analysis animal along. Door provide reason minute.",20:16:46,NEFT
DCTX14808940860840,GB94WWYR43460145320993,1/28/2015,32019.49,100001,N,Credited,SAFARI,PC,Cr,7:24:07,11:27:48,8/16/2021,191395,1791.14,1,"Officer drive help. Discover now by economy same fly ready. Chair box though much shoulder.
Community in beautiful. Find wear security happy upon both. Red pass director scientist contain still.",8:40:36,NEFT
DCTX14808940860840,GB94WWYR43460145320993,1/28/2015,33810.63,100001,N,Credited,EDGE,POS,Cr,14:15:22,19:36:12,8/16/2021,85399495,1791.14,3,"Dream do off west little week. Choose eat positive energy chance machine responsibility. Work law camera.
Act young most role.",16:51:34,RTGS
DCTX14808940860840,GB94WWYR43460145320993,1/28/2015,32019.49,100001,Y,Transportation,EDGE,MOBILE,Dr,18:24:18,23:11:32,8/16/2021,56891034,1791.14,2,"Decade appear everything. Authority gas radio ball cost total cut.
Hand write forward probably white before. Fear member imagine. Blood dream from pressure lot modern another against.",21:03:11,IMPS
DCTX14808940860840,GB94WWYR43460145320993,1/28/2015,31222.02,100001,Y,Transportation,EDGE,POS,Dr,18:59:14,25:28:58,8/20/2021,17207133,797.47,4,"Stuff bad standard early teach. Before serve myself specific. Price behind fast actually.
Like growth maintain.
Wall make though high resource. Type international her.",23:25:46,UPI
DCTX14808940860840,GB94WWYR43460145320993,1/28/2015,32957.9,100001,N,Credited,SAFARI,MOBILE,Cr,17:09:14,20:59:57,9/1/2021,40779362,1735.88,7,"Full better former recently nature. Career full hot time. Offer item center seem.
Beautiful particularly big occur. Eye account chance recently this investment.",19:18:53,DD
DCTX14808940860840,GB94WWYR43460145320993,1/28/2015,31570.03,100001,Y,Utilities,FF,POS,Dr,9:05:03,12:34:25,9/2/2021,90859236,1387.87,4,Raise poor into Democrat hundred body. Community especially quality executive that turn. Radio get personal everything whole.,10:31:10,UPI
DCTX14808940860840,GB94WWYR43460145320993,1/28/2015,30182.16,100001,Y,Online Shopping,IE,MOBILE,Dr,18:11:19,25:52:47,9/2/2021,21467462,1387.87,4,"Manager perform fish culture scene. Democrat create song simple. Relationship contain picture real.
Young fast start lose buy. Account over bring future ask soldier. Reduce agency stage exactly per.",22:07:41,UPI
DCTX14808940860840,GB94WWYR43460145320993,1/28/2015,31629.2,100001,N,Credited,MI,MOBILE,Cr,10:49:51,17:03:52,9/5/2021,77986856,1447.04,1,"Experience husband debate concern particularly different mention.
Response money stock issue young wonder impact. Television management machine investment. Goal number use use year real perhaps case.",13:08:58,NEFT
DCTX14808940860840,GB94WWYR43460145320993,1/28/2015,31543.33,100001,Y,Rent,OPERA,MOBILE,Dr,6:51:19,10:00:41,9/8/2021,2078380,85.87,4,"Hard product ball fish until better. Choice religious information full middle suffer could soon.
Evening born huge difficult happen fly. Get tax professor.",8:15:25,UPI
DCTX14808940860840,GB94WWYR43460145320993,1/28/2015,31457.46,100001,Y,Household Consumables,OPERA,POS,Dr,12:37:42,15:05:19,9/8/2021,69874833,85.87,6,"Party certainly radio east. Support catch later sit nor collection. Stuff ago key education.
Dog song bag range. Long parent go cultural all. Mention head everyone someone air ability else.",14:06:55,CHEQUE
DCTX14808940860840,GB94WWYR43460145320993,1/28/2015,31371.59,100001,Y,Insurance,OPERA,POS,Dr,18:22:05,19:55:10,9/8/2021,57677033,85.87,2,Work house concern. Try couple wrong require. National together difficult. Leave share ball lot effort beautiful everyone.,19:16:00,IMPS
DCTX14808940860840,GB94WWYR43460145320993,1/28/2015,33013.89,100001,N,Credited,EDGE,MOBILE,Cr,16:05:20,22:32:29,9/11/2021,57545813,1642.3,1,"Like mission agree medical pressure. Away how let even may traditional task.
Pressure high live almost least whose. Leader face whose foot. It and week series option.",21:13:11,NEFT
DCTX14808940860840,GB94WWYR43460145320993,1/28/2015,32896.23,100001,Y,Rent,CHROME,MOBILE,Dr,16:12:29,20:40:06,9/18/2021,8032348,117.66,2,"Maintain base just doctor organization debate. Half eye produce this.
Risk one believe either last carry. New yourself dark able management citizen spring. Type include pass project.",18:21:54,IMPS
DCTX14808940860840,GB94WWYR43460145320993,1/28/2015,34115.78,100001,N,Credited,EDGE,PC,Cr,3:33:48,5:44:03,9/19/2021,44665432,1219.55,3,"Necessary hard traditional necessary. Keep these short pick. Only go long threat research.
Marriage face without wall. Mean everybody Congress cultural save. Drop lot use radio from teacher.",4:06:29,RTGS
DCTX14808940860840,GB94WWYR43460145320993,1/28/2015,32896.23,100001,Y,Groceries,OPERA,POS,Dr,10:05:14,11:54:11,9/19/2021,37306564,1219.55,7,"Drug machine never draw trade service central. Age worry past involve believe. Surface particularly modern individual both own.
Just likely a production continue.
Cut hope that data.",11:24:12,DD
DCTX14808940860840,GB94WWYR43460145320993,1/28/2015,34115.78,100001,N,Credited,CHROME,MOBILE,Cr,10:54:46,13:40:04,9/19/2021,35070245,1219.55,3,"Knowledge agreement course voice sell police work pressure. Even here citizen day apply.
A weight special win fight. Heavy smile common.
Soldier director smile their discussion last.",12:43:06,RTGS
DCTX14808940860840,GB94WWYR43460145320993,1/28/2015,32896.23,100001,Y,Online Shopping,FF,POS,Dr,15:39:26,18:54:11,9/19/2021,20225261,1219.55,7,"City decade this accept success water really. Able production analysis food analysis tell.
Everyone strong student. Simple until full big sense. Purpose treat American suddenly stay.",17:35:52,DD
DCTX14808940860840,GB94WWYR43460145320993,1/28/2015,34115.78,100001,N,Credited,CHROME,POS,Cr,21:10:56,24:27:05,9/19/2021,22120083,1219.55,1,"Present story even how religious. Boy end clear write while whom.
Alone entire school figure ready class. Check mission front explain concern.",22:44:46,NEFT
DCTX14808940860840,GB94WWYR43460145320993,1/28/2015,36032.2,100001,N,Credited,OPERA,PC,Cr,20:03:01,25:45:42,9/25/2021,19005157,1916.42,5,"Write action chance person. Should live material scene guy. Develop despite sing.
Data pressure whole money career room. Similar rule institution crime.",22:34:07,CARDS
DCTX14808940860840,GB94WWYR43460145320993,1/28/2015,36820.19,100001,N,Credited,OPERA,POS,Cr,14:16:31,22:57:39,9/26/2021,67679416,787.99,1,"Serious help despite about five near. Speak really watch medical treat sometimes difference. Store same occur talk.
Whole reduce language hope doctor thank. Writer white fine plan.",18:24:54,NEFT
DCTX14808940860840,GB94WWYR43460145320993,1/28/2015,37350.41,100001,N,Credited,MI,PC,Cr,8:35:38,10:50:46,9/29/2021,25892024,530.22,3,"Walk federal senior adult wonder. Similar weight card through.
How manage memory design finish manage over. Interview too share.
Lose enough cup. Hundred hit participant time Mrs pretty.",9:58:52,RTGS
DCTX14808940860840,GB94WWYR43460145320993,1/28/2015,36820.19,100001,Y,Household Consumables,FF,PC,Dr,19:57:41,25:55:40,9/29/2021,16251359,530.22,7,"Three share hope realize leave itself. Develop effect magazine sure. Item possible practice marriage.
Article beyond poor grow idea prevent. Whatever city vote build.",22:38:12,DD
DCTX14808940860840,GB94WWYR43460145320993,1/28/2015,36050.66,100001,Y,Online Shopping,SAFARI,PC,Dr,7:23:13,12:34:53,10/2/2021,14124938,769.53,7,Environmental rich billion from employee college indicate. Happy third cost care half. Station head dog goal test seek.,9:36:18,DD
DCTX14808940860840,GB94WWYR43460145320993,1/28/2015,35281.13,100001,Y,Groceries,MI,PC,Dr,11:07:06,15:30:52,10/2/2021,82321574,769.53,1,Music beat happy against military whatever travel. Eight arrive television work between. Media she recent weight under growth. Bag base laugh include clearly again pay.,14:03:23,NEFT
DCTX14808940860840,GB94WWYR43460145320993,1/28/2015,36050.66,100001,N,Credited,SAFARI,POS,Cr,19:24:15,21:58:19,10/2/2021,50228645,769.53,7,Sell hospital power have marriage. Test off sense only organization. Reveal tell property.,20:53:21,DD
DCTX14808940860840,GB94WWYR43460145320993,1/28/2015,37971.94,100001,N,Credited,MI,POS,Cr,4:00:08,7:32:27,10/4/2021,52439520,1921.28,2,"Prepare appear buy know. Almost history treat occur eight year true.
Report reveal leader Congress contain involve alone.",5:48:43,IMPS
DCTX14808940860840,GB94WWYR43460145320993,1/28/2015,36050.66,100001,Y,Medicals,IE,POS,Dr,6:45:25,9:01:39,10/4/2021,52190926,1921.28,4,"Live foot condition truth. So nation unit ten morning foot admit. Center toward beat manage effort.
Coach before write hospital. Stand pay suddenly eat add.",8:26:04,UPI
DCTX14808940860840,GB94WWYR43460145320993,1/28/2015,34129.38,100001,Y,Medicals,EDGE,MOBILE,Dr,11:59:23,14:14:37,10/4/2021,33106236,1921.28,7,"Discussion yes response marriage something. Its as yes last.
Somebody here officer help establish option. Decision moment life.
Yet build argue.",13:07:31,DD
DCTX14808940860840,GB94WWYR43460145320993,1/28/2015,32208.1,100001,Y,Insurance,MI,MOBILE,Dr,15:19:34,17:43:32,10/4/2021,46669131,1921.28,1,Sense service share follow according. Throughout benefit up. Too price energy general letter service full.,16:20:02,NEFT
DCTX14808940860840,GB94WWYR43460145320993,1/28/2015,34129.38,100001,N,Credited,EDGE,MOBILE,Cr,20:42:46,22:48:20,10/4/2021,16564626,1921.28,4,Six popular base set value throw election. Music culture season maintain world. Simply bank particular course.,22:11:38,UPI
DCTX14808940860840,GB94WWYR43460145320993,1/28/2015,34939.5,100001,N,Credited,EDGE,PC,Cr,5:26:30,7:38:30,10/8/2021,16297661,810.12,5,"Democratic first company. Break good hospital unit business sign couple.
Make today ready movement name single. Discuss star present mind.",6:14:03,CARDS
DCTX14808940860840,GB94WWYR43460145320993,1/28/2015,34129.38,100001,Y,Household Consumables,EDGE,MOBILE,Dr,10:10:48,12:49:56,10/8/2021,81379163,810.12,2,More say join cell all old. Recent his beautiful couple. Specific expect everyone our.,11:06:15,IMPS
DCTX14808940860840,GB94WWYR43460145320993,1/28/2015,33319.26,100001,Y,Personal Care,OPERA,PC,Dr,13:43:04,14:47:59,10/8/2021,70832464,810.12,3,"Goal finish center shoulder expert. Want unit major agent shake among.
World cover yet medical. Staff section stock beautiful idea job travel.",14:22:55,RTGS
DCTX14808940860840,GB94WWYR43460145320993,1/28/2015,32509.14,100001,Y,Insurance,FF,MOBILE,Dr,17:31:02,19:50:17,10/8/2021,76291449,810.12,2,Girl modern character source. Memory available realize special. Respond current line listen phone during pass. Newspaper weight help pattern western approach.,19:11:01,IMPS
DCTX14808940860840,GB94WWYR43460145320993,1/28/2015,33319.26,100001,N,Credited,EDGE,POS,Cr,22:33:18,24:10:19,10/8/2021,86180306,810.12,6,"Difficult environmental community amount bed. Prove sit international attention make. Low imagine add about movement international.
Ok like nearly good model without short. Line miss then read value.",23:43:02,CHEQUE
DCTX14808940860840,GB94WWYR43460145320993,1/28/2015,31420.32,100001,Y,Dining,CHROME,PC,Dr,6:56:38,12:02:05,10/9/2021,53962720,1898.94,5,"Indicate strong building event.
Peace this watch almost inside. Build son personal machine it ground.",8:45:53,CARDS
DCTX14808940860840,GB94WWYR43460145320993,1/28/2015,33319.26,100001,N,Credited,CHROME,PC,Cr,13:23:41,18:09:00,10/9/2021,44259471,1898.94,6,Decade computer current may add. Provide Congress understand conference center show open father. Bed try enough lot many board music.,16:17:52,CHEQUE
DCTX14808940860840,GB94WWYR43460145320993,1/28/2015,35052.48,100001,N,Credited,SAFARI,POS,Cr,21:06:13,26:33:49,10/16/2021,41417362,1733.22,1,"Fight society low table order particular. At campaign early school set save. When visit discuss role back.
Cut various business. Place join change how behavior.",23:19:52,NEFT
KXSC67285952600921,GB64WRNU86151136321109,1/28/2017,2893.8,100002,N,Credited,OPERA,POS,Cr,3:04:06,5:34:14,2/1/2017,66935797,604.14,7,Less quickly bar offer. Attack foot arm ready be prove bit own.,4:21:21,DD
KXSC67285952600921,GB64WRNU86151136321109,1/28/2017,2289.66,100002,Y,Household Consumables,OPERA,PC,Dr,9:56:40,13:45:05,2/1/2017,87028447,604.14,6,"Thus build son big sometimes run.
Enter story blood girl next. Matter deep great.
Area apply spend lay phone listen mission. Tend dream same. Service heavy response.",11:51:11,CHEQUE
KXSC67285952600921,GB64WRNU86151136321109,1/28/2017,1685.52,100002,Y,Utilities,MI,PC,Dr,13:58:10,15:59:40,2/1/2017,75484552,604.14,2,National customer help star try source speech. Environment upon defense morning certainly. Difference tough court factor ability cup floor.,14:49:37,IMPS
KXSC67285952600921,GB64WRNU86151136321109,1/28/2017,1081.38,100002,Y,Online Shopping,MI,MOBILE,Dr,15:54:57,18:27:38,2/1/2017,5628469,604.14,2,Point fight moment fight other tonight. Will figure painting might phone.,16:55:30,IMPS
KXSC67285952600921,GB64WRNU86151136321109,1/28/2017,1685.52,100002,N,Credited,MI,POS,Cr,20:20:59,21:47:26,2/1/2017,5244515,604.14,2,Particularly believe significant open set. Defense individual various two onto clearly material.,20:45:04,IMPS
KXSC67285952600921,GB64WRNU86151136321109,1/28/2017,2000.09,100002,N,Credited,FF,PC,Cr,9:14:35,12:47:59,2/5/2017,10277461,314.57,5,"Recent open series country. Doctor million day already what many.
Nature evidence produce remain career cost property. Including remember pull wonder single. Size writer whom or change onto.",11:22:17,CARDS
KXSC67285952600921,GB64WRNU86151136321109,1/28/2017,1685.52,100002,Y,Dining,IE,POS,Dr,12:16:28,15:48:34,2/5/2017,75226428,314.57,2,"Throw wind feeling over raise condition step. Fight just get series cover reduce. Pm somebody resource everything.
Government bar successful game national Democrat ten. Report wife call.",14:32:41,IMPS
KXSC67285952600921,GB64WRNU86151136321109,1/28/2017,1370.95,100002,Y,Groceries,CHROME,MOBILE,Dr,17:05:30,22:08:03,2/5/2017,42470601,314.57,2,Add it effort than. Child firm behind cold ago. Note building policy expert series ground property.,19:20:50,IMPS
KXSC67285952600921,GB64WRNU86151136321109,1/28/2017,3039.1,100002,N,Credited,EDGE,MOBILE,Cr,9:31:13,12:36:23,2/13/2017,60411815,1668.15,6,"Clear toward never prove. Thousand play short test interest.
Let late real speech add yard. Will know start try necessary. Laugh provide face report expect quickly more.",11:37:05,CHEQUE
KXSC67285952600921,GB64WRNU86151136321109,1/28/2017,4707.25,100002,N,Credited,CHROME,POS,Cr,14:03:36,18:12:22,2/13/2017,81839681,1668.15,4,Shake respond position smile would certainly deep. Agreement consumer hour impact everything war.,15:58:52,UPI
KXSC67285952600921,GB64WRNU86151136321109,1/28/2017,3039.1,100002,Y,Online Shopping,CHROME,PC,Dr,20:08:15,22:15:27,2/13/2017,54501416,1668.15,2,"Investment student culture blue walk point beyond.
Nearly firm team. Blood wind agent first investment. Those put leave decade side born too.",21:10:40,IMPS
KXSC67285952600921,GB64WRNU86151136321109,1/28/2017,3900.33,100002,N,Credited,MI,PC,Cr,12:02:31,15:59:44,3/3/2017,34453896,861.23,4,Travel certainly contain forward size I under. Account station while treat also. Speech information theory place social service.,14:03:03,UPI
KXSC67285952600921,GB64WRNU86151136321109,1/28/2017,4761.56,100002,N,Credited,IE,MOBILE,Cr,14:25:42,20:34:33,3/3/2017,97471929,861.23,5,"Black perhaps range watch body. Challenge sell because number region.
Out federal why. Together small attack job movie suffer responsibility.",18:13:35,CARDS
KXSC67285952600921,GB64WRNU86151136321109,1/28/2017,2820.34,100002,Y,Transportation,SAFARI,PC,Dr,10:08:40,12:58:37,3/4/2017,29966233,1941.22,4,"Series machine rather. I better position conference conference commercial. Half his pay nice year.
Side piece choose involve alone letter. Yet new on close. Center walk couple cup certainly close I.",11:29:28,UPI
KXSC67285952600921,GB64WRNU86151136321109,1/28/2017,879.12,100002,Y,Entertainment,SAFARI,MOBILE,Dr,13:41:35,15:52:52,3/4/2017,11106074,1941.22,1,Executive sell player take yet either. Artist plant region hospital force debate case. Identify against read keep these me. Energy always election attorney stock.,14:20:54,NEFT
KXSC67285952600921,GB64WRNU86151136321109,1/28/2017,2638.11,100002,N,Credited,EDGE,MOBILE,Cr,16:54:25,25:17:29,3/6/2017,3249819,1758.99,1,"Listen trial art research daughter. Feeling sell law response south security.
Who teacher behavior fall develop feeling final. Rise father produce picture.",20:40:30,NEFT
KXSC67285952600921,GB64WRNU86151136321109,1/28/2017,2848.28,100002,N,Credited,SAFARI,PC,Cr,6:06:24,11:03:33,3/7/2017,2304380,210.17,5,Do important process should bill never sea. Reach pick assume parent area say PM thing. Arrive popular respond.,8:52:07,CARDS
KXSC67285952600921,GB64WRNU86151136321109,1/28/2017,3058.45,100002,N,Credited,SAFARI,POS,Cr,13:02:59,15:41:32,3/7/2017,75481377,210.17,6,"Attorney century politics test letter experience. Myself explain avoid. Ball view strategy sound yes.
Space they cell political account well from. But art arm my evening degree design.",13:39:53,CHEQUE
KXSC67285952600921,GB64WRNU86151136321109,1/28/2017,2848.28,100002,Y,Household Consumables,MI,MOBILE,Dr,22:54:28,26:27:51,3/7/2017,75853365,210.17,4,"Available step result write hotel. Property boy responsibility example.
But although kid and. East much scene authority learn off.
Instead good pattern learn what best direction.",23:46:49,UPI
KXSC67285952600921,GB64WRNU86151136321109,1/28/2017,1832.02,100002,Y,Personal Care,OPERA,PC,Dr,4:38:57,7:18:04,3/9/2017,30831803,1016.26,5,"Here fall management animal. Son discuss resource time.
Floor traditional discuss her energy can improve. Couple last space training. Party wide a usually analysis thing significant force.",6:30:53,CARDS
KXSC67285952600921,GB64WRNU86151136321109,1/28/2017,815.76,100002,Y,Transportation,FF,PC,Dr,11:20:35,14:26:09,3/9/2017,24093255,1016.26,1,"Reason way street realize late. Baby look until spend election.
Camera medical road their probably. Wear most sea. Half second floor be friend interview.",13:43:57,NEFT
KXSC67285952600921,GB64WRNU86151136321109,1/28/2017,1832.02,100002,N,Credited,EDGE,MOBILE,Cr,13:13:51,17:22:37,3/9/2017,57684130,1016.26,7,"Rich though size statement physical member special area. Professor country full thousand white election. Soon put scene.
Agree your your west. World decade each certain.",15:16:38,DD
KXSC67285952600921,GB64WRNU86151136321109,1/28/2017,815.76,100002,Y,Utilities,EDGE,PC,Dr,20:57:23,22:08:34,3/9/2017,13309831,1016.26,6,"Land young house shake. Future player nearly allow.
Thank Congress sport just. Office foot wear ok among.
Process ball support billion plan professor test. Stuff cover upon series any.",21:36:52,CHEQUE
KXSC67285952600921,GB64WRNU86151136321109,1/28/2017,1240.76,100002,N,Credited,EDGE,PC,Cr,8:42:45,12:32:43,4/26/2017,66275374,425,5,Save drive live pull total window. Debate garden from many son person though sign. Administration learn note there.,11:02:29,CARDS
KXSC67285952600921,GB64WRNU86151136321109,1/28/2017,815.76,100002,Y,Household Consumables,IE,POS,Dr,9:40:45,14:03:16,4/26/2017,41739969,425,3,"Long central rate mind region issue. Develop trade never. Notice training color station. Attack indicate time body national because.
Can program sell west police bar. International simple sort whose.",12:17:40,RTGS
KXSC67285952600921,GB64WRNU86151136321109,1/28/2017,1240.76,100002,N,Credited,FF,PC,Cr,21:21:16,24:59:51,4/26/2017,54281561,425,2,"Try life particular others wrong partner artist yet. Image detail others.
Success wish then share myself each within. Serious area product air young ok form. Soldier technology choice again.",22:22:23,IMPS
KXSC67285952600921,GB64WRNU86151136321109,1/28/2017,1282.75,100002,N,Credited,SAFARI,PC,Cr,7:01:20,8:27:32,4/30/2017,34477816,41.99,7,"Defense base no himself heavy father. Answer large give.
After image rule institution. Fact member current case join tax try.
Investment yet human we continue.",7:42:17,DD
KXSC67285952600921,GB64WRNU86151136321109,1/28/2017,1240.76,100002,Y,Insurance,OPERA,MOBILE,Dr,6:37:38,9:04:22,4/30/2017,69108945,41.99,4,To Mr election factor sense radio. She offer rich maintain dark media move.,8:17:26,UPI
KXSC67285952600921,GB64WRNU86151136321109,1/28/2017,1198.77,100002,Y,Medicals,EDGE,PC,Dr,11:30:36,14:32:38,4/30/2017,71603407,41.99,6,Time trouble general bit. Project gas yourself white become film Democrat. Ten ever identify happen consider mind.,12:37:59,CHEQUE
KXSC67285952600921,GB64WRNU86151136321109,1/28/2017,1156.78,100002,Y,Online Shopping,SAFARI,MOBILE,Dr,16:13:33,18:43:28,4/30/2017,13792558,41.99,7,History court because white quality I surface. Center activity bar now her. Enter final red best machine.,18:00:45,DD
KXSC67285952600921,GB64WRNU86151136321109,1/28/2017,1114.79,100002,Y,Dining,OPERA,MOBILE,Dr,19:01:02,21:19:45,4/30/2017,18678215,41.99,3,Source yes recent almost five together activity. Room worker room world give wonder apply act.,20:49:00,RTGS
KXSC67285952600921,GB64WRNU86151136321109,1/28/2017,1567.3,100002,N,Credited,OPERA,POS,Cr,5:11:01,9:16:11,5/15/2017,80912873,452.51,5,Spring few result number gun. Reality area game west father little decide choose. Enter recent page wall four town.,7:23:36,CARDS
KXSC67285952600921,GB64WRNU86151136321109,1/28/2017,2019.81,100002,N,Credited,SAFARI,PC,Cr,11:45:04,14:25:14,5/15/2017,51524791,452.51,3,Late free tough first contain skin choice enjoy. Front appear someone attorney various two. Face work although weight else natural.,12:25:03,RTGS
KXSC67285952600921,GB64WRNU86151136321109,1/28/2017,1567.3,100002,Y,Personal Care,EDGE,MOBILE,Dr,16:02:11,19:38:40,5/15/2017,25752618,452.51,1,"Technology structure exist where. Not draw quality about officer so brother. Week treat order five.
Direction speak beautiful personal ahead he. But practice technology west check.",18:12:46,NEFT
KXSC67285952600921,GB64WRNU86151136321109,1/28/2017,2019.81,100002,N,Credited,EDGE,PC,Cr,20:24:43,22:41:01,5/15/2017,50056354,452.51,3,"Network those traditional especially rate lot fill. Wonder toward TV language. Sport relate power back however hot.
Deep us condition morning fly. Smile born here raise friend effect little director.",21:56:56,RTGS
KXSC67285952600921,GB64WRNU86151136321109,1/28/2017,428.61,100002,Y,Insurance,FF,PC,Dr,10:29:35,12:38:08,5/21/2017,52724992,1591.2,2,"Interesting agency although throughout follow.
Behavior main paper cell. Free generation collection lot wear seven key.
Let or less down cultural least. Simple office wear set take white.",11:49:52,IMPS
KXSC67285952600921,GB64WRNU86151136321109,1/28/2017,2019.81,100002,N,Credited,SAFARI,MOBILE,Cr,22:01:03,24:42:13,5/21/2017,58986561,1591.2,4,"Because could others by policy lot guy. Capital could take enjoy here.
Child best method election make reality. Style child pass likely husband four. Full city against speech suggest program.",23:39:01,UPI
KXSC67285952600921,GB64WRNU86151136321109,1/28/2017,3313.13,100002,N,Credited,FF,MOBILE,Cr,17:26:20,22:46:31,5/23/2017,69698248,1293.32,2,"Region threat program middle during. Anyone both product medical among service science.
Offer find herself town live magazine. Her course it professor once my thought. Picture pay possible walk.",20:07:22,IMPS
KXSC67285952600921,GB64WRNU86151136321109,1/28/2017,1576.49,100002,Y,Online Shopping,IE,PC,Dr,11:41:08,21:31:56,5/26/2017,23798847,1736.64,6,Glass then affect why. Professor many speech protect music while. Issue benefit evening Republican say magazine with those.,17:13:30,CHEQUE
KXSC67285952600921,GB64WRNU86151136321109,1/28/2017,573.38,100002,Y,Online Shopping,IE,PC,Dr,5:14:56,8:15:42,6/12/2017,2730943,1003.11,5,"Artist situation born use minute cell central.
Course from power past. Picture here whom green artist meeting claim. Through leader consumer available.",7:25:56,CARDS
KXSC67285952600921,GB64WRNU86151136321109,1/28/2017,1576.49,100002,N,Credited,OPERA,MOBILE,Cr,22:02:33,24:25:08,6/12/2017,71521213,1003.11,4,"Simply despite common after after unit car. Want each protect among say miss animal.
Language sell order deep election resource collection. Remain cultural stuff media. Anything budget song defense.",23:37:32,UPI
KXSC67285952600921,GB64WRNU86151136321109,1/28/2017,1725.58,100002,N,Credited,MI,POS,Cr,9:09:58,18:10:55,6/16/2017,74485819,149.09,5,Significant worry spend southern rather long. Exactly response land ahead card he understand. Nearly side five. Young bar bar imagine live low usually relationship.,14:00:03,CARDS
KXSC67285952600921,GB64WRNU86151136321109,1/28/2017,3268.6,100002,N,Credited,MI,POS,Cr,3:51:20,5:50:53,6/21/2017,74884445,1543.02,2,Reason pattern speak agent. Of recognize recognize. Food friend follow two. Final democratic Congress.,5:03:11,IMPS
KXSC67285952600921,GB64WRNU86151136321109,1/28/2017,4811.62,100002,N,Credited,MI,MOBILE,Cr,11:01:32,13:48:09,6/21/2017,41330951,1543.02,2,"Agree join agreement. Up if base true rule bill thing imagine.
Great strategy success sell. Clearly region stand factor teach. Player product fact Congress set fish.",12:22:05,IMPS
KXSC67285952600921,GB64WRNU86151136321109,1/28/2017,6354.64,100002,N,Credited,IE,MOBILE,Cr,17:53:48,19:45:42,6/21/2017,90528392,1543.02,7,"Near apply challenge among school everybody painting hair. Body stage debate cultural manage authority.
Home arm word television education take role week. Page under crime.",19:03:22,DD
KXSC67285952600921,GB64WRNU86151136321109,1/28/2017,4811.62,100002,Y,Groceries,EDGE,MOBILE,Dr,19:28:53,23:45:59,6/21/2017,92578531,1543.02,2,"Third minute feel some think science rich. Yard leave discussion drop. Relationship low court run use.
Market attack these me weight be. Writer upon low guess generation.",21:52:37,IMPS
KXSC67285952600921,GB64WRNU86151136321109,1/28/2017,4719.3,100002,Y,Utilities,SAFARI,POS,Dr,4:45:37,6:33:04,6/24/2017,7050947,92.32,3,"Forward decide operation. Run think fill up believe. Every sign film decide space.
Well season speech my market. Perform region near street set.",5:29:30,RTGS
KXSC67285952600921,GB64WRNU86151136321109,1/28/2017,4626.98,100002,Y,Personal Care,IE,POS,Dr,7:02:37,10:15:56,6/24/2017,47757837,92.32,1,"Senior opportunity offer event fire brother.
Way measure fine much money ahead. Identify way allow beyond move everything candidate. Either story store pull.",8:35:31,NEFT
KXSC67285952600921,GB64WRNU86151136321109,1/28/2017,4719.3,100002,N,Credited,CHROME,MOBILE,Cr,11:54:56,13:57:19,6/24/2017,3546512,92.32,5,"With despite stay though realize your east threat. Guess few TV board. Yard opportunity write determine color.
Across old human movie physical question appear. Read card million year investment.",13:04:59,CARDS
KXSC67285952600921,GB64WRNU86151136321109,1/28/2017,4811.62,100002,N,Credited,EDGE,POS,Cr,16:00:32,19:17:32,6/24/2017,33349237,92.32,4,"Herself film small. Bit responsibility strong star store strong ago. Trip live consider high image left gun.
Statement dream certain paper likely federal join.",17:22:46,UPI
KXSC67285952600921,GB64WRNU86151136321109,1/28/2017,4719.3,100002,Y,Medicals,MI,MOBILE,Dr,20:04:53,22:56:21,6/24/2017,40947259,92.32,3,Seven leader particular by big recently party. Politics policy cell. Into hard human case method three bank.,21:26:49,RTGS
KXSC67285952600921,GB64WRNU86151136321109,1/28/2017,6070.86,100002,N,Credited,CHROME,MOBILE,Cr,9:00:13,12:31:06,6/25/2017,21169090,1351.56,6,"Computer focus turn rest music section. Yet success with improve offer cut nothing. Over son growth international back amount.
Without movie establish to worker use set.",11:01:07,CHEQUE
KXSC67285952600921,GB64WRNU86151136321109,1/28/2017,7422.42,100002,N,Credited,IE,POS,Cr,11:27:29,15:05:07,6/25/2017,75523916,1351.56,6,"Free will truth past. Onto believe above plant prevent capital.
Statement interview draw be. Likely career think fact son.
Happy travel recent role. Leg assume first. Car free food economy not.",13:35:32,CHEQUE
KXSC67285952600921,GB64WRNU86151136321109,1/28/2017,6070.86,100002,Y,Insurance,SAFARI,MOBILE,Dr,17:54:04,20:27:47,6/25/2017,6472672,1351.56,6,"Choose quality better cut race key. Whose brother or certainly hour trip. Step animal buy.
After view weight south firm plan. Beat coach over food fast what suffer college.",19:42:51,CHEQUE
KXSC67285952600921,GB64WRNU86151136321109,1/28/2017,5489.17,100002,Y,Online Shopping,CHROME,POS,Dr,4:34:20,7:33:11,7/8/2017,35546443,581.69,3,"Popular doctor likely rise including improve. Rather race win many space almost.
Follow individual big.",5:46:47,RTGS
KXSC67285952600921,GB64WRNU86151136321109,1/28/2017,4907.48,100002,Y,Entertainment,EDGE,MOBILE,Dr,9:43:28,12:50:02,7/8/2017,53526304,581.69,1,"Player money around write little doctor reach effect. Bit his trouble.
Always painting anything control well weight good. As window painting travel sort. Number study read create.",11:42:37,NEFT
KXSC67285952600921,GB64WRNU86151136321109,1/28/2017,5489.17,100002,N,Credited,FF,PC,Cr,12:39:18,14:38:58,7/8/2017,10236604,581.69,4,Upon again south tell knowledge move care either. Low nearly gas decision street buy be. Result somebody theory direction official.,14:11:12,UPI
KXSC67285952600921,GB64WRNU86151136321109,1/28/2017,6070.86,100002,N,Credited,OPERA,PC,Cr,15:36:35,17:14:50,7/8/2017,38024221,581.69,7,"Might market suddenly report type writer. Place detail source continue huge effect sing.
Class operation pay. Our respond paper large ever performance indeed sort. Door decide low year.",16:11:09,DD
KXSC67285952600921,GB64WRNU86151136321109,1/28/2017,6652.55,100002,N,Credited,SAFARI,POS,Cr,20:57:13,23:26:17,7/8/2017,58880876,581.69,3,"Boy it site hour. Interest single early sometimes major bed way successful.
Give couple bank song subject policy hold. But focus modern care generation hit. Week early onto can herself change hope.",22:08:33,RTGS
KXSC67285952600921,GB64WRNU86151136321109,1/28/2017,8517.89,100002,N,Credited,IE,POS,Cr,11:08:53,17:32:52,7/16/2017,33925790,1865.34,4,Money deal him smile lawyer name. This develop bit whom hour. Help behavior general account yard. Magazine security particularly.,16:08:03,UPI
KXSC67285952600921,GB64WRNU86151136321109,1/28/2017,7396.55,100002,Y,Online Shopping,CHROME,MOBILE,Dr,6:57:21,9:40:47,7/20/2017,81140411,1121.34,6,Wrong safe middle chair much thing consumer central. President defense so back. Fear she them front star owner school stand.,8:34:35,CHEQUE
KXSC67285952600921,GB64WRNU86151136321109,1/28/2017,6275.21,100002,Y,Utilities,FF,MOBILE,Dr,14:47:54,17:19:09,7/20/2017,80773306,1121.34,4,"Artist population provide hot of. Choose many five friend magazine station window reason.
Lot Congress social step form. Final party draw machine push lose.",16:31:08,UPI
KXSC67285952600921,GB64WRNU86151136321109,1/28/2017,7396.55,100002,N,Credited,SAFARI,PC,Cr,17:45:00,22:45:04,7/20/2017,52966965,1121.34,4,Will although police nor child clearly. Eight during front difference practice late.,19:47:37,UPI
KXSC67285952600921,GB64WRNU86151136321109,1/28/2017,8914.3,100002,N,Credited,OPERA,PC,Cr,12:48:40,17:59:54,7/26/2017,55897846,1517.75,5,"Trade country support money. Sport final score record else difference.
Between hundred early think hair require wait. Yes take oil build onto growth. Policy expert keep door such team.",14:05:08,CARDS
KXSC67285952600921,GB64WRNU86151136321109,1/28/2017,7915.79,100002,Y,Household Consumables,CHROME,MOBILE,Dr,4:08:31,6:21:25,8/7/2017,75626631,998.51,3,Beautiful environment instead. Development door rise street either. Similar chair authority manage.,4:51:04,RTGS
KXSC67285952600921,GB64WRNU86151136321109,1/28/2017,8914.3,100002,N,Credited,EDGE,PC,Cr,8:58:57,11:42:44,8/7/2017,41411667,998.51,5,Order low yeah chair get. Stop carry together want seek happy include. Issue present score success although personal scientist.,10:22:24,CARDS
KXSC67285952600921,GB64WRNU86151136321109,1/28/2017,9912.81,100002,N,Credited,CHROME,MOBILE,Cr,13:56:44,16:00:29,8/7/2017,76369988,998.51,6,Standard find onto step discussion finish strong job. Well better same right according throughout. House discuss understand feeling project seven.,14:26:23,CHEQUE
KXSC67285952600921,GB64WRNU86151136321109,1/28/2017,10911.32,100002,N,Credited,IE,POS,Cr,17:33:33,18:34:32,8/7/2017,12026166,998.51,1,"Response tell mouth answer south simply. Value point wife policy radio toward.
Former evening reduce hotel.",18:09:32,NEFT
KXSC67285952600921,GB64WRNU86151136321109,1/28/2017,9912.81,100002,Y,Rent,MI,MOBILE,Dr,18:16:30,20:31:52,8/7/2017,24725101,998.51,6,"Republican over Mr figure stop. Career all street friend traditional month official. Form buy project force.
Film actually west size sometimes. Partner room positive same nature.",20:02:54,CHEQUE
KXSC67285952600921,GB64WRNU86151136321109,1/28/2017,11308.23,100002,N,Credited,IE,MOBILE,Cr,5:39:17,7:42:27,8/9/2017,76224362,1395.42,4,"Agent better four special prevent guy. Population American talk sing.
Try model memory house. Send floor factor pull too model executive. Eight decision power food where.",7:02:53,UPI
KXSC67285952600921,GB64WRNU86151136321109,1/28/2017,9912.81,100002,Y,Medicals,FF,MOBILE,Dr,8:56:03,11:21:11,8/9/2017,99305307,1395.42,6,Treatment unit mean father. Growth movement guy several piece many toward. Among ok rich two. Knowledge discover model investment month.,10:37:23,CHEQUE
KXSC67285952600921,GB64WRNU86151136321109,1/28/2017,11308.23,100002,N,Credited,OPERA,MOBILE,Cr,12:18:40,14:01:36,8/9/2017,56825015,1395.42,4,"Door until heavy hundred draw interesting. Third play white order occur.
Evidence form opportunity leg in if dog. Treat wish chair only simply.",12:52:13,UPI
KXSC67285952600921,GB64WRNU86151136321109,1/28/2017,9912.81,100002,Y,Transportation,IE,POS,Dr,17:48:02,20:17:59,8/9/2017,71748214,1395.42,4,"Option sound Democrat garden well. Return interest discover matter strategy able her.
Government next thousand site give call onto read. Himself life central film.",18:55:03,UPI
KXSC67285952600921,GB64WRNU86151136321109,1/28/2017,8517.39,100002,Y,Online Shopping,OPERA,POS,Dr,20:40:42,23:19:06,8/9/2017,36061099,1395.42,6,Maybe relationship article those they. Get painting other help admit training become. Lawyer network begin money dark board guy activity.,21:23:04,CHEQUE
KXSC67285952600921,GB64WRNU86151136321109,1/28/2017,7669.41,100002,Y,Personal Care,EDGE,MOBILE,Dr,7:41:44,16:15:51,8/16/2017,64247250,847.98,2,"Our history push artist wife bed. Deep everybody common administration.
Region response mean. Memory vote wrong message. Itself near together fall pretty.",12:24:24,IMPS
KXSC67285952600921,GB64WRNU86151136321109,1/28/2017,6813.61,100002,Y,Personal Care,EDGE,PC,Dr,6:58:08,11:27:58,8/17/2017,94759396,855.8,6,"Participant manage look responsibility end no.
Article question reflect certain time despite. Lawyer girl read season special task go director. Trade election hand man save probably.",9:28:15,CHEQUE
KXSC67285952600921,GB64WRNU86151136321109,1/28/2017,5957.81,100002,Y,Groceries,SAFARI,POS,Dr,10:43:44,14:57:04,8/17/2017,47764477,855.8,2,"Send radio time whether among. Turn student ability Democrat many loss political.
Sell like run economic. Give arrive behavior trouble. Community audience per be.
You go take people machine our girl.",13:33:30,IMPS
KXSC67285952600921,GB64WRNU86151136321109,1/28/2017,5102.01,100002,Y,Household Consumables,CHROME,MOBILE,Dr,18:02:18,20:35:35,8/17/2017,47586093,855.8,5,Feeling affect move total word kid process. With appear fight. Health after change contain team which chair tree.,18:50:57,CARDS
KXSC67285952600921,GB64WRNU86151136321109,1/28/2017,4685.7,100002,Y,Rent,SAFARI,PC,Dr,7:39:05,10:40:54,8/25/2017,11084495,416.31,1,Conference traditional family almost technology. You game condition continue music industry. Foot decade television.,9:14:17,NEFT
KXSC67285952600921,GB64WRNU86151136321109,1/28/2017,4269.39,100002,Y,Groceries,MI,PC,Dr,18:25:11,23:37:44,8/25/2017,50692798,416.31,4,Energy material game strong close brother simple TV. Not beautiful blood ago reflect.,19:51:24,UPI
KXSC67285952600921,GB64WRNU86151136321109,1/28/2017,4316.71,100002,N,Credited,OPERA,PC,Cr,8:18:10,13:05:43,9/4/2017,77570314,47.32,6,"Together shoulder cup culture. Young of have note itself college.
Federal study wear environment. Them realize kitchen side write.
Cup expect perform speak put. Reach time part market ten.",10:11:04,CHEQUE
KXSC67285952600921,GB64WRNU86151136321109,1/28/2017,4364.03,100002,N,Credited,OPERA,PC,Cr,11:43:20,14:52:40,9/4/2017,26408767,47.32,5,Relate which response child upon eye. Husband apply bag away officer. Two fish similar produce health trial prove.,13:12:50,CARDS
KXSC67285952600921,GB64WRNU86151136321109,1/28/2017,4411.35,100002,N,Credited,CHROME,PC,Cr,21:00:05,25:56:22,9/4/2017,3595497,47.32,5,"People economic finish program. Defense hot word carry what different world. Phone finally respond must opportunity food blood.
After your rock thought today indeed skin.",23:10:17,CARDS
KXSC67285952600921,GB64WRNU86151136321109,1/28/2017,5446.56,100002,N,Credited,IE,PC,Cr,6:00:22,9:48:33,9/16/2017,10817407,1035.21,6,"Animal serve fly painting trouble perhaps talk. Standard college money war second while enough step.
Enjoy share director great. Before sometimes see.
Development cost office nor line really item.",8:44:29,CHEQUE
KXSC67285952600921,GB64WRNU86151136321109,1/28/2017,4411.35,100002,Y,Dining,CHROME,PC,Dr,9:43:32,13:41:35,9/16/2017,84779366,1035.21,7,Feeling end night four first. Sea sign garden seem. Second while music total hot.,12:15:54,DD
KXSC67285952600921,GB64WRNU86151136321109,1/28/2017,5446.56,100002,N,Credited,EDGE,MOBILE,Cr,16:46:49,20:08:07,9/16/2017,41085936,1035.21,6,"Choose hand able describe another activity none. Audience else up partner to against.
Fact computer soldier little about. Figure stage rate as speech billion pick.",18:51:03,CHEQUE
KXSC67285952600921,GB64WRNU86151136321109,1/28/2017,6731.26,100002,N,Credited,EDGE,MOBILE,Cr,9:51:39,16:05:56,9/20/2017,8978448,1284.7,6,"Live food control fill break enough. Upon physical attack. Night red think.
Staff head federal relate some coach take. Way piece station adult. Maybe maintain son thought own.",13:15:00,CHEQUE
KXSC67285952600921,GB64WRNU86151136321109,1/28/2017,8015.96,100002,N,Credited,IE,POS,Cr,17:11:06,22:34:28,9/20/2017,89639467,1284.7,5,Natural expect task head. Stay similar right quickly PM national pressure board. Listen maintain meeting way himself five.,20:40:17,CARDS
KXSC67285952600921,GB64WRNU86151136321109,1/28/2017,6995.06,100002,Y,Personal Care,CHROME,MOBILE,Dr,12:46:01,17:41:36,9/21/2017,65624043,1020.9,2,"Doctor simple important. Question main machine inside. Although message score hard level cold.
Wonder skin catch fast already across old above. Book later hold rock hundred.",15:26:52,IMPS
KXSC67285952600921,GB64WRNU86151136321109,1/28/2017,5974.16,100002,Y,Insurance,FF,POS,Dr,17:29:50,23:34:17,9/21/2017,25608663,1020.9,5,"Movement week TV our. Tv exactly create from camera along. Ahead amount community nation dream suggest attorney executive. Dinner choose stand better.
Control adult blood important.",21:26:03,CARDS
KXSC67285952600921,GB64WRNU86151136321109,1/28/2017,6906.05,100002,N,Credited,OPERA,MOBILE,Cr,5:21:10,9:07:25,9/28/2017,73316077,931.89,7,Billion young traditional trip research. Pick or option decision whole the. World part event fish discuss in fire develop.,7:07:47,DD
KXSC67285952600921,GB64WRNU86151136321109,1/28/2017,7837.94,100002,N,Credited,FF,POS,Cr,7:48:58,11:32:59,9/28/2017,83539817,931.89,1,Themselves subject me course accept land Congress. Tv it never.,9:37:06,NEFT
KXSC67285952600921,GB64WRNU86151136321109,1/28/2017,8769.83,100002,N,Credited,FF,PC,Cr,13:08:07,15:20:24,9/28/2017,33911434,931.89,5,"Fast industry law. Left we camera report local. Describe a rest recently commercial player arm.
Difficult step everybody either. Station what low ability player general.",14:53:53,CARDS
KXSC67285952600921,GB64WRNU86151136321109,1/28/2017,7837.94,100002,Y,Dining,SAFARI,POS,Dr,19:01:49,21:20:54,9/28/2017,1250220,931.89,3,"Medical window inside north member six camera. Authority decide among. Woman office everyone high.
Example middle at team quality speech kid. Both hotel vote road would site.",19:38:12,RTGS
KXSC67285952600921,GB64WRNU86151136321109,1/28/2017,8769.83,100002,N,Credited,OPERA,POS,Cr,21:55:35,24:19:50,9/28/2017,80893561,931.89,4,"Investment try past meet field song much. Less term do size democratic. Accept not suggest character leg. Choose inside way social tree building.
Lose stay ability structure yourself.",22:21:12,UPI
KXSC67285952600921,GB64WRNU86151136321109,1/28/2017,8443.05,100002,Y,Medicals,CHROME,PC,Dr,14:53:58,22:20:47,9/29/2017,52256103,326.78,7,"Ability international time suggest possible. Year structure result until member again tonight.
Major never her indeed few hear heavy message. Thank only individual store toward spring.",18:00:24,DD
KXSC67285952600921,GB64WRNU86151136321109,1/28/2017,7717.53,100002,Y,Rent,OPERA,PC,Dr,10:06:28,15:22:09,10/3/2017,24104968,725.52,2,Rich east happy oil practice reach recent seven. Environment prevent compare success how actually. Though note why region trial. Her choice wall protect gun under.,12:17:41,IMPS
KXSC67285952600921,GB64WRNU86151136321109,1/28/2017,8443.05,100002,N,Credited,IE,MOBILE,Cr,19:18:41,25:54:52,10/3/2017,9130289,725.52,6,"Discussion toward lose tell middle. School some give will. Reality lead four stuff international ago.
Live lot wrong church. Walk contain seat foreign card.",22:14:34,CHEQUE
KXSC67285952600921,GB64WRNU86151136321109,1/28/2017,8668.41,100002,N,Credited,SAFARI,POS,Cr,10:03:39,13:27:03,10/10/2017,14491702,225.36,7,Stop need hotel ability finish science night assume. Science safe impact decide hand series phone. Area subject people research.,11:04:32,DD
KXSC67285952600921,GB64WRNU86151136321109,1/28/2017,8443.05,100002,Y,Insurance,SAFARI,POS,Dr,9:48:09,13:05:44,10/10/2017,75042028,225.36,7,"Subject behavior worry by. Treatment similar air world smile tax election. Head imagine describe evidence.
Check protect wind standard great. Writer TV answer cup.",12:05:58,DD
KXSC67285952600921,GB64WRNU86151136321109,1/28/2017,8668.41,100002,N,Credited,FF,PC,Cr,17:09:13,21:56:56,10/10/2017,43174980,225.36,2,"Specific black beat. Throw offer high well score almost believe drive. Take professional season person movement account.
Quickly property memory professor. Themselves usually enter ask.",19:47:15,IMPS
KXSC67285952600921,GB64WRNU86151136321109,1/28/2017,10575.8,100002,N,Credited,IE,PC,Cr,11:09:50,14:53:00,10/15/2017,98988877,1907.39,1,"Short here hand.
Ball through office director rise side card. Experience structure business energy former. None more particularly star both.",13:06:00,NEFT
KXSC67285952600921,GB64WRNU86151136321109,1/28/2017,12483.19,100002,N,Credited,EDGE,MOBILE,Cr,17:43:21,20:55:15,10/15/2017,10195437,1907.39,4,Increase try ago above collection cup. Study try with cup letter understand everything.,19:01:11,UPI
KXSC67285952600921,GB64WRNU86151136321109,1/28/2017,12840.91,100002,N,Credited,EDGE,PC,Cr,4:47:18,6:58:50,10/21/2017,32808957,357.72,6,Discussion then responsibility baby share education foot. Plan brother night discussion drug miss crime.,6:26:07,CHEQUE
KXSC67285952600921,GB64WRNU86151136321109,1/28/2017,13198.63,100002,N,Credited,EDGE,MOBILE,Cr,8:02:02,10:59:09,10/21/2017,79833035,357.72,2,"Debate family experience including it can. Particular whatever process training yes against.
Enjoy side today. Nation leg fire treatment good.",9:05:14,IMPS
KXSC67285952600921,GB64WRNU86151136321109,1/28/2017,12840.91,100002,Y,Medicals,MI,PC,Dr,11:12:02,14:35:17,10/21/2017,46176899,357.72,4,"Work term suffer second. Your meeting guess order. Appear dark suggest exist voice add.
Country while decade church level network. Team responsibility keep low.",12:40:29,UPI
KXSC67285952600921,GB64WRNU86151136321109,1/28/2017,13198.63,100002,N,Credited,EDGE,PC,Cr,17:31:55,20:03:27,10/21/2017,80572916,357.72,2,"Perform current role teach participant. Economy scene agree nearly.
Finish buy low test to part. Guy others seem alone study space evidence. Break stuff treat idea chair throw.",18:20:41,IMPS
KXSC67285952600921,GB64WRNU86151136321109,1/28/2017,13556.35,100002,N,Credited,OPERA,PC,Cr,21:06:53,22:24:38,10/21/2017,58630082,357.72,1,"Walk learn decade thing million. Food let experience quality sing care accept. Particularly fish arm explain.
Catch six but force. Little scientist I million study whose chance.",21:33:24,NEFT
KXSC67285952600921,GB64WRNU86151136321109,1/28/2017,12287.72,100002,Y,Household Consumables,FF,MOBILE,Dr,4:28:07,11:16:45,10/30/2017,32143386,1268.63,4,"Sign expert against image. Low exist energy all performance eye after must.
Member gas value left simple church. Hundred find floor fill its word. Bring per history group TV.",8:20:49,UPI
KXSC67285952600921,GB64WRNU86151136321109,1/28/2017,13556.35,100002,N,Credited,EDGE,MOBILE,Cr,18:09:50,22:29:41,10/30/2017,50914517,1268.63,5,Officer born issue bank. Many pressure pattern lay surface. Reveal in short mouth lot. Cost trial thought understand represent rich.,19:47:17,CARDS
KXSC67285952600921,GB64WRNU86151136321109,1/28/2017,15048.06,100002,N,Credited,FF,POS,Cr,14:06:22,21:55:32,11/14/2017,47045286,1491.71,4,Personal appear tend expert operation physical fill. Discuss interesting newspaper leader decade Congress. Relationship smile management floor not.,17:06:49,UPI
KXSC67285952600921,GB64WRNU86151136321109,1/28/2017,14755.68,100002,Y,Utilities,EDGE,MOBILE,Dr,8:00:48,12:05:49,11/19/2017,70053036,292.38,5,"Low out arrive break. Whose full tough pass. Bad throughout least son.
Force party consider its fight. Even value represent practice what kitchen.",10:25:19,CARDS
KXSC67285952600921,GB64WRNU86151136321109,1/28/2017,15048.06,100002,N,Credited,FF,POS,Cr,11:12:29,15:23:47,11/19/2017,64111186,292.38,2,Congress threat to little industry across citizen popular. Individual treatment beautiful sit read. Suggest road serious generation production.,14:11:08,IMPS
KXSC67285952600921,GB64WRNU86151136321109,1/28/2017,15340.44,100002,N,Credited,OPERA,PC,Cr,17:26:52,19:20:53,11/19/2017,96606896,292.38,1,Continue accept high wall up finally. Yard Republican stock similar shake type member. School new plant town entire.,18:43:22,NEFT
KXSC67285952600921,GB64WRNU86151136321109,1/28/2017,15272.38,100002,Y,Household Consumables,OPERA,PC,Dr,11:11:17,14:24:04,12/8/2017,75077822,68.06,2,Old specific entire write head. Effect off society suggest. Thank sell key government free positive upon. Professional pressure serious grow blue.,11:55:21,IMPS
KXSC67285952600921,GB64WRNU86151136321109,1/28/2017,15204.32,100002,Y,Dining,FF,MOBILE,Dr,13:46:54,17:58:40,12/8/2017,1229455,68.06,3,"Election relate issue democratic. Sense over trouble quite.
Might affect free. Material per size last notice term. Scientist feeling station fire live.",15:10:52,RTGS
KXSC67285952600921,GB64WRNU86151136321109,1/28/2017,15272.38,100002,N,Credited,OPERA,POS,Cr,18:10:28,23:09:07,12/8/2017,34982297,68.06,3,"Concern program employee account. Night mission involve Mr. Coach perhaps suffer.
Section discussion finally write when Republican staff term. News of today employee tough four computer.",20:55:43,RTGS
KXSC67285952600921,GB64WRNU86151136321109,1/28/2017,15060.35,100002,Y,Medicals,EDGE,MOBILE,Dr,9:41:55,13:53:31,12/12/2017,13627782,212.03,1,Five give seem record. Whom win school idea traditional explain. Compare treatment single approach TV evening ball.,11:38:14,NEFT
KXSC67285952600921,GB64WRNU86151136321109,1/28/2017,15272.38,100002,N,Credited,EDGE,PC,Cr,13:08:55,16:19:25,12/12/2017,96444191,212.03,1,"Great person enter address government evidence. Away realize game care PM.
Government appear test improve. Firm risk shake performance manage continue.",14:46:05,NEFT
KXSC67285952600921,GB64WRNU86151136321109,1/28/2017,15060.35,100002,Y,Rent,CHROME,POS,Dr,20:44:51,25:51:28,12/12/2017,6819132,212.03,2,Few everything half accept film various production maintain. Physical live street east something start but miss. Another food able when green approach. Item series develop story call than.,23:26:30,IMPS
KXSC67285952600921,GB64WRNU86151136321109,1/28/2017,16808.25,100002,N,Credited,EDGE,MOBILE,Cr,8:22:48,11:36:56,12/16/2017,11062875,1747.9,4,"Money physical budget across family. Mouth evening decision indeed conference.
Meeting finish beat imagine. Four view down floor.
Cause area red feeling arrive song. Both hear base.",10:33:32,UPI
KXSC67285952600921,GB64WRNU86151136321109,1/28/2017,18556.15,100002,N,Credited,FF,MOBILE,Cr,12:37:22,15:12:34,12/16/2017,62120012,1747.9,5,"Move blood voice him write. Up cover inside seek individual ever.
Hot must project left. Any coach likely nearly choice tax cell.",14:31:51,CARDS
KXSC67285952600921,GB64WRNU86151136321109,1/28/2017,16808.25,100002,Y,Transportation,IE,POS,Dr,16:35:39,20:34:55,12/16/2017,76858710,1747.9,3,"Tax describe skill. Outside hospital baby five.
Range throughout certain require last. Old writer fact floor he.",18:57:53,RTGS
KXSC67285952600921,GB64WRNU86151136321109,1/28/2017,17048.93,100002,N,Credited,CHROME,MOBILE,Cr,10:08:12,15:56:22,12/22/2017,60297853,240.68,7,Early boy also customer happy pass drop. Opportunity another land interest way. Drug beat civil. Face responsibility sister politics risk relate.,13:37:37,DD
KXSC67285952600921,GB64WRNU86151136321109,1/28/2017,16808.25,100002,Y,Transportation,FF,PC,Dr,16:19:07,19:28:19,12/22/2017,56274028,240.68,3,"Bag at cup benefit travel perhaps doctor.
She technology brother different service financial.
Such area near college health newspaper specific. Forward political sing play respond other.",17:39:04,RTGS
KXSC67285952600921,GB64WRNU86151136321109,1/28/2017,16080.31,100002,Y,Dining,EDGE,MOBILE,Dr,7:13:41,10:43:13,12/27/2017,79168144,727.94,4,Arm in edge standard. To growth fast it.,8:09:02,UPI
KXSC67285952600921,GB64WRNU86151136321109,1/28/2017,15352.37,100002,Y,Entertainment,SAFARI,POS,Dr,10:42:24,14:49:27,12/27/2017,42855460,727.94,5,"Clear report or sound that away increase. Could avoid month door think away. Late appear just beautiful open hotel.
Exist increase care scientist. Strong cultural above minute.",13:22:42,CARDS
KXSC67285952600921,GB64WRNU86151136321109,1/28/2017,16080.31,100002,N,Credited,FF,MOBILE,Cr,17:10:06,20:27:47,12/27/2017,87834000,727.94,1,"Chance start late.
Drug prevent place put safe southern truth. Item reason three significant TV.",19:45:26,NEFT
KXSC67285952600921,GB64WRNU86151136321109,1/28/2017,15743.53,100002,Y,Medicals,SAFARI,MOBILE,Dr,6:22:51,8:48:14,12/28/2017,75984274,336.78,7,Whether interesting use smile thousand unit another throw. Fill rest left guy really because this. Green particularly meet about director too. Last ask success science.,7:21:19,DD
KXSC67285952600921,GB64WRNU86151136321109,1/28/2017,16080.31,100002,N,Credited,FF,PC,Cr,12:47:28,15:52:59,12/28/2017,56624496,336.78,7,Voice recognize daughter some necessary land. Paper same network travel anyone easy.,13:42:19,DD
KXSC67285952600921,GB64WRNU86151136321109,1/28/2017,15743.53,100002,Y,Rent,IE,MOBILE,Dr,20:25:19,25:29:07,12/28/2017,37002053,336.78,1,"Hot lawyer wide prepare close leave. Ago card both project a choose.
Evening industry hospital crime north. Adult themselves human chair break rule. Approach garden provide movie.",22:54:00,NEFT
KXSC67285952600921,GB64WRNU86151136321109,1/28/2017,16899.83,100002,N,Credited,EDGE,POS,Cr,10:22:07,19:45:46,1/8/2018,53283832,1156.3,6,"Program at by seven report. Task effort alone result. Together radio reach like.
Support into give low. Prevent become style knowledge if. Try against include cover police so sea.",15:33:49,CHEQUE
KXSC67285952600921,GB64WRNU86151136321109,1/28/2017,18795.83,100002,N,Credited,EDGE,POS,Cr,4:35:12,7:07:27,1/16/2018,8930590,1896,6,Add something them discover character sport wife student. Compare money well whole impact. Direction those door reveal weight expert key.,6:10:16,CHEQUE
KXSC67285952600921,GB64WRNU86151136321109,1/28/2017,16899.83,100002,Y,Entertainment,MI,PC,Dr,6:13:04,8:36:03,1/16/2018,26405582,1896,3,"Number side successful myself plan. Approach first long main.
Old grow take determine probably nice. Population project significant century.",8:11:28,RTGS
KXSC67285952600921,GB64WRNU86151136321109,1/28/2017,15003.83,100002,Y,Medicals,OPERA,MOBILE,Dr,12:31:09,14:09:30,1/16/2018,60968807,1896,2,"Party test best PM help. Mission development avoid mean treatment economy glass information.
Candidate edge few us among else daughter. Agreement range ready build.",13:01:12,IMPS
KXSC67285952600921,GB64WRNU86151136321109,1/28/2017,13107.83,100002,Y,Medicals,OPERA,MOBILE,Dr,16:24:30,19:00:10,1/16/2018,37928193,1896,3,Security night card skill. Most effort somebody. Will go treatment ten mind professional.,17:46:35,RTGS
KXSC67285952600921,GB64WRNU86151136321109,1/28/2017,15003.83,100002,N,Credited,SAFARI,PC,Cr,23:03:56,25:20:37,1/16/2018,82276102,1896,5,"Impact month trade work. Nearly blue wife daughter whether be name.
Source box type worry. Clearly dinner crime.",23:47:00,CARDS
KXSC67285952600921,GB64WRNU86151136321109,1/28/2017,14964.27,100002,Y,Medicals,IE,MOBILE,Dr,5:22:19,10:48:59,1/30/2018,90687785,39.56,6,"East amount professional school present authority success. Join article part strategy.
Down there worker college tree street. Design leg to light long.",8:51:42,CHEQUE
KXSC67285952600921,GB64WRNU86151136321109,1/28/2017,15003.83,100002,N,Credited,EDGE,MOBILE,Cr,19:47:23,24:53:26,1/30/2018,11793090,39.56,6,"Every note we offer. Amount apply board major. Form compare house simply.
Mission specific speech final recent. Brother common yourself smile less maybe tough.",22:01:03,CHEQUE
KXSC67285952600921,GB64WRNU86151136321109,1/28/2017,13126.68,100002,Y,Groceries,FF,MOBILE,Dr,3:54:48,7:48:58,2/12/2018,54341210,1877.15,6,Democrat finally street article ask voice group billion. Head top idea money medical from.,5:40:07,CHEQUE
KXSC67285952600921,GB64WRNU86151136321109,1/28/2017,15003.83,100002,N,Credited,OPERA,MOBILE,Cr,10:13:51,12:40:30,2/12/2018,56049428,1877.15,1,Hear defense fear main dinner. Another adult pretty go. Respond for color Republican western everyone including.,11:05:23,NEFT
KXSC67285952600921,GB64WRNU86151136321109,1/28/2017,16880.98,100002,N,Credited,FF,POS,Cr,14:30:37,17:07:27,2/12/2018,97204848,1877.15,1,"Pick off task hundred. Network kitchen son gun. Professional throw medical around.
Center second PM blue. Suggest animal law senior letter. Risk measure interesting down.",16:23:29,NEFT
KXSC67285952600921,GB64WRNU86151136321109,1/28/2017,15003.83,100002,Y,Dining,OPERA,PC,Dr,18:19:02,20:48:31,2/12/2018,85184459,1877.15,5,Information project successful left night too. Dog get finally program debate thing. Class raise level group throw.,20:03:45,CARDS
KXSC67285952600921,GB64WRNU86151136321109,1/28/2017,15834.94,100002,N,Credited,FF,POS,Cr,5:25:16,8:43:11,2/14/2018,65401033,831.11,6,"Themselves late risk quickly eight.
Relationship bit dinner lot painting. Meeting until matter building upon buy.",6:52:32,CHEQUE
KXSC67285952600921,GB64WRNU86151136321109,1/28/2017,16666.05,100002,N,Credited,MI,PC,Cr,12:43:16,18:10:09,2/14/2018,28343042,831.11,4,"Recently build quickly line value imagine various well. Exist good trouble.
Difficult common say imagine his administration born. Perhaps condition agreement. Sing growth contain.",15:31:09,UPI
KXSC67285952600921,GB64WRNU86151136321109,1/28/2017,17497.16,100002,N,Credited,MI,POS,Cr,22:17:32,26:01:23,2/14/2018,20168131,831.11,4,Perhaps growth pick per decade newspaper must. Whose require discover prepare hundred throughout. Hotel force management seven allow.,23:40:37,UPI
KXSC67285952600921,GB64WRNU86151136321109,1/28/2017,18607.69,100002,N,Credited,IE,POS,Cr,5:37:11,9:23:53,2/19/2018,52588518,1110.53,6,"Enough recently four interview hit whole sing serious. Have executive bank ever best fly cut.
Season claim page affect program. Politics source eight some six institution.",8:15:05,CHEQUE
KXSC67285952600921,GB64WRNU86151136321109,1/28/2017,17497.16,100002,Y,Entertainment,SAFARI,POS,Dr,15:14:12,18:44:23,2/19/2018,84087553,1110.53,1,"President strong forward. Bag door make around clearly that.
Offer thus myself suggest operation. Various take system. Every of man PM interview sometimes.",17:49:33,NEFT
KXSC67285952600921,GB64WRNU86151136321109,1/28/2017,16386.63,100002,Y,Personal Care,IE,POS,Dr,20:51:41,24:40:59,2/19/2018,35147916,1110.53,5,"Wear plan allow yeah. Line let capital parent.
Include drop though various mission. Technology miss speak candidate peace customer try. Population still suddenly throughout authority task.",22:13:16,CARDS
KXSC67285952600921,GB64WRNU86151136321109,1/28/2017,17633.63,100002,N,Credited,EDGE,POS,Cr,13:19:43,20:37:39,2/28/2018,98210633,1247,5,Without also compare life decision almost. Officer father tough subject. Before toward individual record season. Republican argue education audience thus area involve.,16:48:40,CARDS
KXSC67285952600921,GB64WRNU86151136321109,1/28/2017,17944.47,100002,N,Credited,MI,MOBILE,Cr,7:40:44,12:34:11,3/1/2018,90872518,310.84,3,"East word church someone four idea.
Include weight history order including eye. Bad especially participant factor save guess. Budget side fine forget three participant.",10:34:06,RTGS
KXSC67285952600921,GB64WRNU86151136321109,1/28/2017,18255.31,100002,N,Credited,SAFARI,POS,Cr,10:27:51,16:18:27,3/1/2018,20624187,310.84,3,Test figure outside still travel middle. Garden own three draw certainly rule. Produce style best see hand. Risk soldier majority staff.,13:25:42,RTGS
KXSC67285952600921,GB64WRNU86151136321109,1/28/2017,18566.15,100002,N,Credited,EDGE,PC,Cr,21:01:34,22:22:03,3/1/2018,9256231,310.84,1,"Team happy society wide establish. Worker Republican health seven create take notice relationship. Series finish animal score including.
Cold campaign into big gas. Reflect feeling use small agency.",21:44:53,NEFT
KXSC67285952600921,GB64WRNU86151136321109,1/28/2017,19307.18,100002,N,Credited,CHROME,MOBILE,Cr,5:07:40,8:37:36,3/11/2018,90443510,741.03,1,"They participant cup table measure response whom. Man section religious also set.
Detail most onto degree understand event contain. Movement onto gun blue.",7:19:03,NEFT
KXSC67285952600921,GB64WRNU86151136321109,1/28/2017,20048.21,100002,N,Credited,EDGE,POS,Cr,9:49:38,12:41:23,3/11/2018,67423507,741.03,3,Bed hit watch real have final movement. Wife near everybody like reason. Evidence outside which style.,11:59:53,RTGS
KXSC67285952600921,GB64WRNU86151136321109,1/28/2017,20789.24,100002,N,Credited,CHROME,PC,Cr,17:05:48,18:59:13,3/11/2018,97308782,741.03,4,"Way receive its unit. Rather draw trouble year this care.
Second news probably cultural them present energy. Until this past series left agree. Sort kid with us guess kitchen public.",18:26:38,UPI
KXSC67285952600921,GB64WRNU86151136321109,1/28/2017,21530.27,100002,N,Credited,SAFARI,PC,Cr,19:57:54,23:59:04,3/11/2018,58643105,741.03,1,"Class choose sit have course huge. Bit never the student decision upon.
Person wide there item. Admit concern entire around town.
Program system yet out. Around catch include pattern.",22:04:04,NEFT
KXSC67285952600921,GB64WRNU86151136321109,1/28/2017,21285.41,100002,Y,Personal Care,SAFARI,PC,Dr,6:22:06,11:20:27,3/16/2018,64070025,244.86,1,"Represent military seek once man economy. Prove try manager. Compare rise into high natural.
From oil mind friend price. Class space hit some.",8:24:17,NEFT
KXSC67285952600921,GB64WRNU86151136321109,1/28/2017,21530.27,100002,N,Credited,MI,POS,Cr,12:23:24,17:28:16,3/16/2018,94885613,244.86,2,"Piece reduce trouble throughout rate charge. Order sell nature.
Protect past Congress military. Front scientist south theory then. Else cell despite garden stock find.",15:13:11,IMPS
KXSC67285952600921,GB64WRNU86151136321109,1/28/2017,21285.41,100002,Y,Dining,MI,MOBILE,Dr,20:32:18,23:58:08,3/16/2018,45796968,244.86,5,"Drop home happy quickly. Require to head key catch between.
Enjoy help probably move test it daughter rather. Eight kitchen candidate. Rich exactly whom.",23:20:50,CARDS
KXSC67285952600921,GB64WRNU86151136321109,1/28/2017,22429.51,100002,N,Credited,OPERA,PC,Cr,7:47:28,11:22:53,3/22/2018,49095692,1144.1,6,"Force dinner around. Begin read for minute. Team hair discover by course begin tree.
Matter four western fish sound visit. That car ability responsibility people.
Television radio develop skin me.",10:09:29,CHEQUE
KXSC67285952600921,GB64WRNU86151136321109,1/28/2017,23573.61,100002,N,Credited,FF,MOBILE,Cr,21:15:11,25:43:03,3/22/2018,78917682,1144.1,5,"Cell last listen best. Use manager realize rate.
Front each participant positive. Human fund will ago recently Mr. Another involve decade cover stand effect if. Situation report military.",23:14:18,CARDS
KXSC67285952600921,GB64WRNU86151136321109,1/28/2017,23008.65,100002,Y,Household Consumables,EDGE,PC,Dr,8:30:52,12:35:31,3/25/2018,35929611,564.96,5,Nature consumer play brother keep tonight others why. Still in establish sometimes pressure thousand strong.,10:33:07,CARDS
KXSC67285952600921,GB64WRNU86151136321109,1/28/2017,22443.69,100002,Y,Entertainment,SAFARI,MOBILE,Dr,12:20:37,14:58:02,3/25/2018,82221614,564.96,2,Catch scientist stay talk imagine. Property process head next final because. Personal require political month.,13:37:26,IMPS
KXSC67285952600921,GB64WRNU86151136321109,1/28/2017,21878.73,100002,Y,Online Shopping,FF,POS,Dr,17:15:54,21:37:42,3/25/2018,54129948,564.96,5,"Claim authority magazine gas and. Pressure and edge test. More modern item matter gas because dinner.
Them civil support popular. Speak little pass decide.",20:01:11,CARDS
KXSC67285952600921,GB64WRNU86151136321109,1/28/2017,20808.95,100002,Y,Insurance,FF,MOBILE,Dr,4:04:38,6:29:59,4/3/2018,76832987,1069.78,1,"Senior particularly west even high own. This live against realize authority nor fire drive. Miss better plant.
Believe his interesting hair. Drop yet ground very whose everyone.",4:34:43,NEFT
KXSC67285952600921,GB64WRNU86151136321109,1/28/2017,19739.17,100002,Y,Household Consumables,FF,PC,Dr,7:54:05,10:26:30,4/3/2018,24113557,1069.78,7,"Already church above not director fill. Board technology glass evening two.
I son building activity according street. Able low benefit challenge. Skin show pretty direction.",8:33:27,DD
KXSC67285952600921,GB64WRNU86151136321109,1/28/2017,20808.95,100002,N,Credited,CHROME,PC,Cr,12:27:12,14:46:26,4/3/2018,27082829,1069.78,6,"Travel find set occur for. Even finally special eat record area.
Wear push industry international pass unit research simply. Despite practice movement style attorney. Few myself bad foreign rest.",13:35:33,CHEQUE
KXSC67285952600921,GB64WRNU86151136321109,1/28/2017,21878.73,100002,N,Credited,SAFARI,POS,Cr,18:13:46,20:55:02,4/3/2018,98396719,1069.78,1,"Answer heavy address wait race. Treat box third available political. A off rich which kid.
Arm billion office medical film. Build story man cultural support.",19:51:54,NEFT
KXSC67285952600921,GB64WRNU86151136321109,1/28/2017,22948.51,100002,N,Credited,EDGE,POS,Cr,21:11:10,23:50:29,4/3/2018,60388100,1069.78,1,Recognize themselves quality or together specific star. Phone treatment card example decade area specific.,22:18:38,NEFT
KXSC67285952600921,GB64WRNU86151136321109,1/28/2017,24178.71,100002,N,Credited,FF,MOBILE,Cr,2:06:32,6:00:28,4/9/2018,93816311,1230.2,5,Yourself network participant research. Condition local certainly service Republican herself into. Hit everything thought western out job note.,4:02:52,CARDS
KXSC67285952600921,GB64WRNU86151136321109,1/28/2017,25408.91,100002,N,Credited,IE,MOBILE,Cr,10:34:58,13:42:19,4/9/2018,18197570,1230.2,7,Per research want last yes college difficult. Military last cause language body evening foreign draw.,11:55:01,DD
KXSC67285952600921,GB64WRNU86151136321109,1/28/2017,26639.11,100002,N,Credited,EDGE,POS,Cr,13:35:47,15:27:41,4/9/2018,42523819,1230.2,1,"Else trouble record manager group analysis. Kitchen brother act same party.
Site network beyond general capital federal such. Say share soldier send response address American.",14:11:27,NEFT
KXSC67285952600921,GB64WRNU86151136321109,1/28/2017,27869.31,100002,N,Credited,MI,PC,Cr,16:40:49,19:06:06,4/9/2018,25937565,1230.2,5,"Approach field town.
Sit pattern threat again throughout. Need something as human.
Center experience employee his man although. Herself writer exactly couple determine.",18:00:32,CARDS
KXSC67285952600921,GB64WRNU86151136321109,1/28/2017,29099.51,100002,N,Credited,IE,POS,Cr,20:54:53,23:00:00,4/9/2018,91874641,1230.2,1,Approach research police commercial. Piece go question than one. Free threat race player third difference.,22:01:35,NEFT
KXSC67285952600921,GB64WRNU86151136321109,1/28/2017,30672.16,100002,N,Credited,SAFARI,PC,Cr,4:35:31,6:55:33,4/19/2018,69903038,1572.65,4,Reality may else radio listen somebody. Field plant head purpose yet.,5:30:10,UPI
KXSC67285952600921,GB64WRNU86151136321109,1/28/2017,29099.51,100002,Y,Medicals,MI,POS,Dr,12:25:45,14:59:28,4/19/2018,66227823,1572.65,1,Whether whole from should save week. Reflect his huge attention recently across late thing.,14:20:34,NEFT
KXSC67285952600921,GB64WRNU86151136321109,1/28/2017,30672.16,100002,N,Credited,IE,POS,Cr,15:07:20,19:45:29,4/19/2018,76637322,1572.65,4,With sister source send our. Audience her argue interview huge last. Charge avoid make role system catch spend similar.,17:24:01,UPI
KXSC67285952600921,GB64WRNU86151136321109,1/28/2017,32244.81,100002,N,Credited,EDGE,POS,Cr,17:44:37,21:01:14,4/19/2018,29534623,1572.65,7,"Lot soon either girl money. Generation unit whose control approach.
Their official everything we campaign none up easy. Bit someone different these.",20:08:21,DD
KXSC67285952600921,GB64WRNU86151136321109,1/28/2017,30514.39,100002,Y,Insurance,CHROME,MOBILE,Dr,4:16:16,8:04:24,5/4/2018,94618464,1730.42,5,"Central get concern six walk compare. Whose production treatment concern want. Word down young technology sing.
Concern positive house late. Myself make push front. Meeting movie movie sometimes tax.",5:54:12,CARDS
KXSC67285952600921,GB64WRNU86151136321109,1/28/2017,32244.81,100002,N,Credited,OPERA,MOBILE,Cr,9:16:31,12:45:33,5/4/2018,92018754,1730.42,7,"Ball cold road always black policy. Then everybody it simple miss.
Catch young these letter possible defense everyone make. Police age event give tough others represent radio.",11:06:44,DD
KXSC67285952600921,GB64WRNU86151136321109,1/28/2017,33975.23,100002,N,Credited,MI,POS,Cr,15:15:19,18:52:54,5/4/2018,61162327,1730.42,2,"Try soldier occur especially view result. Work will likely base. Unit you which day.
Adult police next. Between center here popular whether.",16:55:32,IMPS
KXSC67285952600921,GB64WRNU86151136321109,1/28/2017,35705.65,100002,N,Credited,SAFARI,POS,Cr,20:43:20,23:35:31,5/4/2018,51453558,1730.42,3,Visit morning stay daughter. Career above best not paper some local his. Popular character plan set section sport.,22:01:07,RTGS
KXSC67285952600921,GB64WRNU86151136321109,1/28/2017,35709.11,100002,N,Credited,OPERA,POS,Cr,7:37:08,14:49:59,5/5/2018,55081320,3.46,7,"Add evening energy both. Cover provide tough third interview discussion include.
Federal hot notice anyone term respond. Analysis it force option now report. Black forget west stand.",10:59:40,DD
KXSC67285952600921,GB64WRNU86151136321109,1/28/2017,35705.65,100002,Y,Medicals,FF,POS,Dr,16:24:49,21:30:15,5/5/2018,43159147,3.46,5,Campaign or program wonder. Age activity professor never dream production stop loss. Happy item matter customer collection.,19:37:50,CARDS
KXSC67285952600921,GB64WRNU86151136321109,1/28/2017,34589.96,100002,Y,Utilities,OPERA,PC,Dr,7:43:36,17:33:10,5/7/2018,84069863,1115.69,5,"Management Democrat article memory. Human single at alone. Meeting situation whatever federal night process product boy.
Support imagine center. Behavior American information marriage anyone central.",12:18:20,CARDS
KXSC67285952600921,GB64WRNU86151136321109,1/28/2017,35203.22,100002,N,Credited,IE,PC,Cr,5:25:43,7:07:52,5/11/2018,70013184,613.26,5,Action lay card citizen risk. Future cell around lead bad determine. Listen star information method.,6:29:32,CARDS
KXSC67285952600921,GB64WRNU86151136321109,1/28/2017,35816.48,100002,N,Credited,OPERA,POS,Cr,10:57:51,15:45:47,5/11/2018,96384152,613.26,6,Win who follow free try increase film. Degree say front building also. Guess require anything fly something perform look.,13:10:14,CHEQUE
KXSC67285952600921,GB64WRNU86151136321109,1/28/2017,36429.74,100002,N,Credited,OPERA,POS,Cr,18:37:53,22:36:39,5/11/2018,50806614,613.26,7,"Seven like front room make seek maintain. Reflect arm they system particularly. Writer enough easy couple.
Evidence worry issue. Professional quality power. But sit future eight rather four.",21:26:32,DD
KXSC67285952600921,GB64WRNU86151136321109,1/28/2017,38034.58,100002,N,Credited,MI,MOBILE,Cr,8:27:31,11:30:44,5/13/2018,6696573,1604.84,4,"Current catch her boy. Young candidate yes audience dream clear. Total chance forward throughout miss sit believe.
Expert rise site point sort fight. Card protect machine forget approach.",9:21:39,UPI
KXSC67285952600921,GB64WRNU86151136321109,1/28/2017,39639.42,100002,N,Credited,EDGE,PC,Cr,8:47:35,11:01:19,5/13/2018,33352466,1604.84,6,"Marriage yard reason agreement better. Appear forward everybody star glass and.
Skill accept let benefit should argue. Positive pass while social. Physical simply although sign score far simple try.",10:24:34,CHEQUE
KXSC67285952600921,GB64WRNU86151136321109,1/28/2017,41244.26,100002,N,Credited,CHROME,PC,Cr,15:48:04,18:40:27,5/13/2018,14946943,1604.84,6,"Everything against success religious company project. Summer industry crime star full.
Can husband national remain building yet ability. Along coach three far hold.",17:15:44,CHEQUE
KXSC67285952600921,GB64WRNU86151136321109,1/28/2017,39639.42,100002,Y,Transportation,SAFARI,POS,Dr,21:40:11,23:38:54,5/13/2018,4755289,1604.84,7,Hold identify pay central subject spend. Address provide back onto cost.,22:46:48,DD
KXSC67285952600921,GB64WRNU86151136321109,1/28/2017,40414.4,100002,N,Credited,IE,POS,Cr,6:36:55,12:00:09,5/24/2018,89083796,774.98,6,Training almost friend picture need. Material rate number product pretty sit store. Treatment marriage effect support. Some idea tell food.,9:27:59,CHEQUE
KXSC67285952600921,GB64WRNU86151136321109,1/28/2017,41189.38,100002,N,Credited,OPERA,MOBILE,Cr,11:49:31,15:57:13,5/24/2018,77076618,774.98,2,"Tell court store piece rule stock game. Pressure station simply serve visit that usually. Behavior beat speak religious.
Per follow speech. Wear save he clear music plant decision research.",13:30:51,IMPS
KXSC67285952600921,GB64WRNU86151136321109,1/28/2017,41964.36,100002,N,Credited,MI,MOBILE,Cr,15:52:15,20:28:00,5/24/2018,63472110,774.98,1,"Tell best field. South key color good. Able century car describe dog.
Wait you year civil election computer. Stage soldier maintain.",18:35:58,NEFT
KXSC67285952600921,GB64WRNU86151136321109,1/28/2017,43181.96,100002,N,Credited,FF,PC,Cr,6:59:35,11:02:37,5/29/2018,37916909,1217.6,2,"Behind which wall up decide.
Box always fund certain. Phone draw style not way point factor. Democratic human page our.",9:13:03,IMPS
KXSC67285952600921,GB64WRNU86151136321109,1/28/2017,44399.56,100002,N,Credited,OPERA,PC,Cr,11:24:41,15:08:50,5/29/2018,1892277,1217.6,4,History little like bill six method. May material identify collection let. Artist bed film senior much name character democratic.,14:01:59,UPI
KXSC67285952600921,GB64WRNU86151136321109,1/28/2017,45617.16,100002,N,Credited,SAFARI,PC,Cr,20:21:23,25:19:26,5/29/2018,60522139,1217.6,7,"Often anything over somebody find action serious. Course city start skill. Positive Republican beyond.
Single game affect receive politics. Type civil box challenge back. Outside she hotel sometimes.",22:47:49,DD
KXSC67285952600921,GB64WRNU86151136321109,1/28/2017,44298.93,100002,Y,Rent,OPERA,POS,Dr,7:03:29,8:57:41,6/5/2018,77610324,1318.23,4,Day system behavior likely sister doctor. Indeed democratic writer laugh fill. Person very opportunity nothing.,7:56:39,UPI
KXSC67285952600921,GB64WRNU86151136321109,1/28/2017,42980.7,100002,Y,Household Consumables,CHROME,MOBILE,Dr,10:13:54,12:28:14,6/5/2018,55040280,1318.23,5,"Guess face arm life final method help option. People health ground learn.
Worry might course local baby church add. Dark thousand world arm.",10:52:33,CARDS
KXSC67285952600921,GB64WRNU86151136321109,1/28/2017,41662.47,100002,Y,Household Consumables,FF,PC,Dr,12:57:04,16:16:31,6/5/2018,36830459,1318.23,4,"Effect realize wear listen these large fund. Any cover party so. Success four drop also cup.
Budget point part hope interview beat. Skill authority energy huge. Test human out size brother she land.",14:39:36,UPI
KXSC67285952600921,GB64WRNU86151136321109,1/28/2017,40344.24,100002,Y,Dining,EDGE,PC,Dr,14:53:22,18:21:41,6/5/2018,97800958,1318.23,7,"Article blue any really job whose. Fish PM single say now.
Beyond agree decide. Any live five somebody study region.",16:44:43,DD
KXSC67285952600921,GB64WRNU86151136321109,1/28/2017,39026.01,100002,Y,Transportation,FF,MOBILE,Dr,18:52:49,21:59:54,6/5/2018,16135062,1318.23,6,Moment rest three. Worry executive approach meet use visit best. Too knowledge pass international sing.,20:06:59,CHEQUE
KXSC67285952600921,GB64WRNU86151136321109,1/28/2017,37886.37,100002,Y,Dining,FF,MOBILE,Dr,5:59:47,8:18:50,7/9/2018,74247493,1139.64,6,Population charge well accept series if your stuff. Both research bar fact real main standard traditional.,7:47:07,CHEQUE
KXSC67285952600921,GB64WRNU86151136321109,1/28/2017,39026.01,100002,N,Credited,CHROME,MOBILE,Cr,9:00:11,10:58:56,7/9/2018,30356412,1139.64,2,Treatment until address team act feel. Statement give the important. Consider American west thing. Wear natural either above.,9:58:13,IMPS
KXSC67285952600921,GB64WRNU86151136321109,1/28/2017,37886.37,100002,Y,Personal Care,MI,MOBILE,Dr,14:42:08,18:02:45,7/9/2018,79389426,1139.64,5,World discussion easy choice medical resource. Positive trouble must general face never throughout. Goal scientist manager figure majority.,16:34:41,CARDS
KXSC67285952600921,GB64WRNU86151136321109,1/28/2017,36746.73,100002,Y,Online Shopping,MI,PC,Dr,21:00:00,24:19:24,7/9/2018,37219697,1139.64,3,"Reach security American bank finally social woman.
Can old dinner not side spend guess. Finish better food painting. Per begin here police range.",22:39:59,RTGS
KXSC67285952600921,GB64WRNU86151136321109,1/28/2017,38300.15,100002,N,Credited,SAFARI,PC,Cr,10:02:21,12:55:40,7/19/2018,6924102,1553.42,2,Relate either official floor land issue again. Phone section cold step. Information knowledge establish finally. Line agency foot scene section training.,11:49:12,IMPS
KXSC67285952600921,GB64WRNU86151136321109,1/28/2017,39853.57,100002,N,Credited,OPERA,PC,Cr,21:46:00,25:55:28,7/19/2018,3773512,1553.42,3,"Mention help hour group. Watch who wear table practice drive future support. From chance let key card theory.
Kind reach environment include plan pass best. Such sister data business growth together.",22:52:22,RTGS
KXSC67285952600921,GB64WRNU86151136321109,1/28/2017,40464.03,100002,N,Credited,OPERA,MOBILE,Cr,7:16:47,10:01:44,7/26/2018,84005205,610.46,6,Him magazine current religious fill if. Idea machine particularly central citizen. Least modern bring order manage single office ahead.,8:13:28,CHEQUE
KXSC67285952600921,GB64WRNU86151136321109,1/28/2017,41074.49,100002,N,Credited,SAFARI,POS,Cr,15:54:26,18:10:08,7/26/2018,27889169,610.46,3,Fish would seven great city base. Memory tax experience reduce. Herself my type between dog. Apply should key television.,17:16:22,RTGS
KXSC67285952600921,GB64WRNU86151136321109,1/28/2017,40586,100002,Y,Groceries,IE,MOBILE,Dr,7:03:05,11:24:13,7/29/2018,52134319,488.49,7,"Drop lead president able. Rest treatment while cut hour light structure. Travel music organization.
Direction response floor still so. Similar five view growth.",8:28:01,DD
KXSC67285952600921,GB64WRNU86151136321109,1/28/2017,41074.49,100002,N,Credited,FF,MOBILE,Cr,17:09:43,20:06:44,7/29/2018,13827571,488.49,2,"Voice get pull. Store member but travel.
Long usually maintain term. Writer just wait force goal. Whatever only positive miss hour letter.",18:14:21,IMPS
KXSC67285952600921,GB64WRNU86151136321109,1/28/2017,42341.57,100002,N,Credited,CHROME,POS,Cr,9:26:53,12:29:14,7/30/2018,84711809,1267.08,7,"Guess just gun resource kind opportunity. Try computer war management. Stuff doctor of grow author also.
Radio attack investment heart. Newspaper pass should hear capital. Floor best tree.",10:23:39,DD
KXSC67285952600921,GB64WRNU86151136321109,1/28/2017,43608.65,100002,N,Credited,MI,MOBILE,Cr,15:31:18,19:13:02,7/30/2018,48419772,1267.08,3,"Outside answer put. Result her star husband. Exactly run money perform.
Card son want dinner wind yard.
Explain natural two account. Media job remember environment reduce begin.",17:35:42,RTGS
KXSC67285952600921,GB64WRNU86151136321109,1/28/2017,42341.57,100002,Y,Medicals,IE,MOBILE,Dr,15:31:57,19:00:06,7/30/2018,342322,1267.08,7,"Try fact force fact car some specific.
Mention year people smile. Say camera west professor together occur chair. Write meeting view cultural trip.",18:02:14,DD
KXSC67285952600921,GB64WRNU86151136321109,1/28/2017,40536.21,100002,Y,Transportation,SAFARI,MOBILE,Dr,8:18:37,10:06:45,8/1/2018,14099229,1805.36,6,"Young wrong office around think yourself. Style arrive maintain adult show police society smile.
Enough bring call. Social south middle item piece summer time. Note position shake environment.",9:06:32,CHEQUE
KXSC67285952600921,GB64WRNU86151136321109,1/28/2017,38730.85,100002,Y,Groceries,FF,POS,Dr,8:25:59,11:36:07,8/1/2018,65972762,1805.36,3,"Upon capital sense population but put.
Push billion meeting easy music less. Operation later add off gas teacher cultural.",9:55:56,RTGS
KXSC67285952600921,GB64WRNU86151136321109,1/28/2017,40536.21,100002,N,Credited,IE,POS,Cr,13:09:50,16:40:19,8/1/2018,50848096,1805.36,4,"Avoid eight behavior image summer. Main prove front but hospital idea.
Without care recently effort debate accept. Least cause firm allow student full.",14:48:11,UPI
KXSC67285952600921,GB64WRNU86151136321109,1/28/2017,42341.57,100002,N,Credited,MI,PC,Cr,19:32:52,22:39:56,8/1/2018,1470390,1805.36,3,"Nature store husband follow. Understand own vote across expert.
Consumer choice follow history citizen happen without home. Price government amount management strong.",21:25:12,RTGS
KXSC67285952600921,GB64WRNU86151136321109,1/28/2017,41738.18,100002,Y,Utilities,CHROME,MOBILE,Dr,8:44:11,10:26:47,8/10/2018,46605856,603.39,3,Over season hold easy single news. Against sport understand issue team. Moment green director white admit political.,9:23:29,RTGS
KXSC67285952600921,GB64WRNU86151136321109,1/28/2017,41134.79,100002,Y,Insurance,SAFARI,POS,Dr,14:24:49,18:47:40,8/10/2018,40464756,603.39,4,"Happy summer who agent read avoid.
Write check size artist phone start. Actually example body have thus effect hour line. Leg collection industry.",17:21:07,UPI
KXSC67285952600921,GB64WRNU86151136321109,1/28/2017,40531.4,100002,Y,Personal Care,IE,MOBILE,Dr,21:51:21,25:32:41,8/10/2018,85466548,603.39,6,"Discuss someone hard.
Six among blood study shake oil write.
Per research necessary old. Stay feeling challenge out. All operation market effect PM I.",22:56:49,CHEQUE
KXSC67285952600921,GB64WRNU86151136321109,1/28/2017,39784.33,100002,Y,Transportation,FF,PC,Dr,9:45:40,16:41:18,8/13/2018,91094766,747.07,2,Read different shoulder role. Production once easy glass meeting she.,13:10:43,IMPS
KXSC67285952600921,GB64WRNU86151136321109,1/28/2017,39037.26,100002,Y,Online Shopping,SAFARI,MOBILE,Dr,17:56:19,21:55:34,8/13/2018,79882163,747.07,7,"Tough issue real worker able light add. Civil rule skin. Remember great result.
Vote program dark. Threat identify see its how prepare impact rich.",19:34:02,DD
KXSC67285952600921,GB64WRNU86151136321109,1/28/2017,39536.79,100002,N,Credited,EDGE,PC,Cr,9:13:16,10:50:43,8/19/2018,99274214,499.53,4,"Country opportunity position energy receive or machine. Writer official general end. Arm risk might miss social such defense yard.
As window have bit. Entire staff person receive avoid reveal happen.",9:54:32,UPI
KXSC67285952600921,GB64WRNU86151136321109,1/28/2017,40036.32,100002,N,Credited,IE,POS,Cr,11:16:47,15:23:08,8/19/2018,51124700,499.53,5,Agent think product visit attack professional. Dog daughter life style concern. Down public little day free. Save information technology.,13:46:58,CARDS
KXSC67285952600921,GB64WRNU86151136321109,1/28/2017,40535.85,100002,N,Credited,IE,MOBILE,Cr,21:21:57,22:57:14,8/19/2018,13848132,499.53,3,"Attention certainly in big lose toward. International protect hour prove Mr discussion allow.
Than clearly must middle too pretty government standard. Girl radio surface TV bring thought.",22:14:05,RTGS
KXSC67285952600921,GB64WRNU86151136321109,1/28/2017,40532.6,100002,Y,Household Consumables,MI,PC,Dr,10:31:11,17:52:14,8/22/2018,68720346,3.25,3,"Until design rate often.
Maintain few place cup red short. Would page into painting. Scene before lot memory.
Firm open maybe test. State professor yet majority financial to seat.",13:14:23,RTGS
KXSC67285952600921,GB64WRNU86151136321109,1/28/2017,38901.56,100002,Y,Household Consumables,CHROME,MOBILE,Dr,10:47:12,15:48:16,8/25/2018,96636558,1631.04,1,Could second apply main report herself. Central treatment bad step. Day make much clearly tonight image pass.,11:52:20,NEFT
KXSC67285952600921,GB64WRNU86151136321109,1/28/2017,40532.6,100002,N,Credited,FF,POS,Cr,17:08:17,24:44:04,8/25/2018,15957719,1631.04,3,"Wall whom security.
Particular friend should national economic.
Employee draw structure build item dog. Walk rich through risk special fund.",20:47:03,RTGS
KXSC67285952600921,GB64WRNU86151136321109,1/28/2017,41524.73,100002,N,Credited,CHROME,POS,Cr,4:49:09,7:10:05,8/26/2018,33865850,992.13,1,Serious tend pressure treat. Ten nor eye. Themselves middle exist my enjoy probably.,5:54:26,NEFT
KXSC67285952600921,GB64WRNU86151136321109,1/28/2017,42516.86,100002,N,Credited,IE,MOBILE,Cr,8:03:37,10:10:00,8/26/2018,75119836,992.13,2,"Perhaps by hit everybody.
War soldier write outside. Actually small image. Score station seat seek.",9:41:20,IMPS
KXSC67285952600921,GB64WRNU86151136321109,1/28/2017,41524.73,100002,Y,Medicals,CHROME,POS,Dr,10:42:18,13:02:59,8/26/2018,32123944,992.13,5,"Friend rule weight trouble. Off several card share. Alone same outside baby line poor stage.
Present summer opportunity. For cost type rest maintain suggest side last. Lot culture road white.",12:07:23,CARDS
KXSC67285952600921,GB64WRNU86151136321109,1/28/2017,42516.86,100002,N,Credited,FF,PC,Cr,15:44:54,18:09:19,8/26/2018,31751490,992.13,4,"Radio player data specific push. Investment girl seven stage very authority. Result machine step book history.
Free ability security those benefit.",16:50:41,UPI
KXSC67285952600921,GB64WRNU86151136321109,1/28/2017,43508.99,100002,N,Credited,SAFARI,PC,Cr,22:03:58,24:43:25,8/26/2018,77294081,992.13,5,"City past cultural accept. Standard article pressure imagine number.
Mouth character suggest forget. Maybe these subject relate. Particular full show imagine past relate few.",23:54:10,CARDS
KXSC67285952600921,GB64WRNU86151136321109,1/28/2017,42824.59,100002,Y,Groceries,CHROME,PC,Dr,5:23:03,7:43:13,9/6/2018,24771580,684.4,6,Until month national claim what big large. Responsibility key serious door feeling. Hard as daughter case tend.,7:06:56,CHEQUE
KXSC67285952600921,GB64WRNU86151136321109,1/28/2017,42140.19,100002,Y,Medicals,OPERA,PC,Dr,14:42:34,18:11:37,9/6/2018,84559845,684.4,5,Soon sort parent simply. Sport herself nature Democrat. Almost many season hotel find. Account type once animal woman local.,15:44:41,CARDS
KXSC67285952600921,GB64WRNU86151136321109,1/28/2017,41455.79,100002,Y,Utilities,FF,POS,Dr,18:15:27,22:26:28,9/6/2018,92092952,684.4,1,"Seem nation late establish whatever investment difficult. Reach sound machine scientist. Better expert teach.
Manager him say general head language.
Necessary design couple pretty other.",20:45:02,NEFT
KXSC67285952600921,GB64WRNU86151136321109,1/28/2017,40404.59,100002,Y,Entertainment,FF,PC,Dr,5:47:26,8:23:39,9/8/2018,13575939,1051.2,2,"He company third water rich. Fill nation artist. Political answer focus.
Offer thus decide media. Play himself from owner peace everyone pick.",7:21:07,IMPS
KXSC67285952600921,GB64WRNU86151136321109,1/28/2017,41455.79,100002,N,Credited,OPERA,MOBILE,Cr,9:59:00,11:50:46,9/8/2018,78122895,1051.2,6,"Beautiful them level performance day point. Single interesting which our go country light.
My evening level. Return require range. Bring yeah per us.",11:13:34,CHEQUE
KXSC67285952600921,GB64WRNU86151136321109,1/28/2017,40404.59,100002,Y,Groceries,FF,POS,Dr,10:54:14,13:30:10,9/8/2018,29571918,1051.2,1,Still cover Congress ask newspaper give. Hand brother a such. Successful million ever staff itself message pretty. Pull reveal left food.,12:52:11,NEFT
KXSC67285952600921,GB64WRNU86151136321109,1/28/2017,41455.79,100002,N,Credited,CHROME,MOBILE,Cr,16:56:30,19:51:10,9/8/2018,46274465,1051.2,3,"Set ready news staff. Game audience already table yeah.
Congress matter ok explain church smile station. Building animal wish improve part something.",18:24:22,RTGS
KXSC67285952600921,GB64WRNU86151136321109,1/28/2017,42506.99,100002,N,Credited,EDGE,PC,Cr,19:04:07,22:23:50,9/8/2018,52850790,1051.2,1,Likely modern speech discover degree. Idea majority girl lead. Activity relate lawyer describe others.,20:40:32,NEFT
KXSC67285952600921,GB64WRNU86151136321109,1/28/2017,40652.9,100002,Y,Groceries,OPERA,POS,Dr,13:54:49,19:24:49,9/10/2018,74499489,1854.09,5,"Pull add bad wonder. Work concern gun figure must. Could may series strong.
Dog defense way science order. Interest expect together believe.",17:10:24,CARDS
KXSC67285952600921,GB64WRNU86151136321109,1/28/2017,41701.08,100002,N,Credited,FF,MOBILE,Cr,7:41:07,10:07:51,9/16/2018,61385276,1048.18,3,Through husband first message miss really skill. Think away hold travel international out. Resource sound program fight listen.,8:46:53,RTGS
KXSC67285952600921,GB64WRNU86151136321109,1/28/2017,42749.26,100002,N,Credited,EDGE,MOBILE,Cr,11:21:10,15:34:29,9/16/2018,17172820,1048.18,7,"Personal boy party city grow upon. Reveal Republican term billion foot much begin spring.
Clearly family political kind behind. Although decide thousand how stuff everybody production.",14:15:28,DD
KXSC67285952600921,GB64WRNU86151136321109,1/28/2017,43797.44,100002,N,Credited,MI,PC,Cr,18:49:47,23:34:32,9/16/2018,43713530,1048.18,4,"Police effect raise can laugh respond also.
Style meeting common beat wrong product hour attack. Car memory staff imagine. Gun although community large manager type form.",21:46:01,UPI
KXSC67285952600921,GB64WRNU86151136321109,1/28/2017,45386.67,100002,N,Credited,CHROME,PC,Cr,6:16:25,11:02:58,9/29/2018,27931233,1589.23,2,"Treatment treatment it success believe other blood lot. Total catch in.
Make perhaps industry outside eye air. Air campaign billion light first middle. Call chance site since military team.",8:55:35,IMPS
KXSC67285952600921,GB64WRNU86151136321109,1/28/2017,46975.9,100002,N,Credited,OPERA,MOBILE,Cr,20:13:09,24:05:14,9/29/2018,63571684,1589.23,3,"Dog draw project past. Agreement carry him above entire value break.
Cover various modern turn whether treatment though also. I friend most everyone.",22:13:52,RTGS
KXSC67285952600921,GB64WRNU86151136321109,1/28/2017,45709.14,100002,Y,Groceries,CHROME,PC,Dr,4:24:13,8:02:59,10/2/2018,24408080,1266.76,3,"Hotel should term movie more. Concern player check. Clear raise admit clearly.
Push evidence do bit. Student probably college activity animal pressure.",6:43:09,RTGS
KXSC67285952600921,GB64WRNU86151136321109,1/28/2017,46975.9,100002,N,Credited,OPERA,POS,Cr,10:28:32,14:21:47,10/2/2018,86085199,1266.76,4,"Simple team mouth tough education every. Ago describe should great.
Yourself together various nation radio add. Room hospital campaign. Method these minute job meet dark impact.",12:40:50,UPI
KXSC67285952600921,GB64WRNU86151136321109,1/28/2017,45709.14,100002,Y,Rent,IE,MOBILE,Dr,16:55:25,20:37:30,10/2/2018,47760493,1266.76,2,"Three remain research involve. New issue born public hair alone.
Not son difference food.",19:05:46,IMPS
KXSC67285952600921,GB64WRNU86151136321109,1/28/2017,44442.38,100002,Y,Household Consumables,EDGE,PC,Dr,21:14:44,23:35:37,10/2/2018,82809942,1266.76,2,"Door suggest family front while. Like challenge street small effect official.
Instead wall allow along camera three. Several across democratic your later my I.",22:41:19,IMPS
KXSC67285952600921,GB64WRNU86151136321109,1/28/2017,42806.8,100002,Y,Transportation,OPERA,POS,Dr,8:05:48,17:54:08,10/4/2018,78946125,1635.58,3,"Head recently economic pretty. Need occur itself identify behind partner against hospital.
Fine lead head amount. Win memory effort learn future detail capital.",12:04:45,RTGS
KXSC67285952600921,GB64WRNU86151136321109,1/28/2017,41265.29,100002,Y,Medicals,EDGE,POS,Dr,11:51:14,16:04:53,10/14/2018,27607961,1541.51,4,"Want threat yes.
Get least environmental learn drop allow. Sometimes finish lead well increase.
This year ok away appear certainly international. System action ball person say.",14:18:51,UPI
KXSC67285952600921,GB64WRNU86151136321109,1/28/2017,42806.8,100002,N,Credited,MI,MOBILE,Cr,17:19:09,23:29:50,10/14/2018,58497951,1541.51,2,"After music throughout discuss line its. Result bar above.
Man small interview yard remember performance expert. Change stage indicate whatever enjoy red. Business garden kind far bill.",21:16:58,IMPS
KXSC67285952600921,GB64WRNU86151136321109,1/28/2017,42335.58,100002,Y,Personal Care,OPERA,PC,Dr,7:43:46,8:57:03,10/18/2018,9897625,471.22,4,"Summer glass agency political. Pm one charge treatment report moment occur. Research consider dinner particularly.
Because exist painting create month near during. Simply try require paper.",8:23:53,UPI
KXSC67285952600921,GB64WRNU86151136321109,1/28/2017,41864.36,100002,Y,Transportation,OPERA,MOBILE,Dr,9:22:04,12:16:34,10/18/2018,31079105,471.22,5,Arm every plant require within. Inside easy shake choose professor agree especially. Mouth sea price music. Program start scientist likely.,11:39:18,CARDS
KXSC67285952600921,GB64WRNU86151136321109,1/28/2017,41393.14,100002,Y,Personal Care,IE,MOBILE,Dr,17:08:16,20:52:07,10/18/2018,13815356,471.22,7,"Late like force. Society probably growth scientist carry style magazine.
Hundred concern rich program trouble. Interesting especially lose at foot culture.",18:30:18,DD
KXSC67285952600921,GB64WRNU86151136321109,1/28/2017,40921.92,100002,Y,Insurance,FF,PC,Dr,21:49:29,24:28:15,10/18/2018,3403624,471.22,4,"Bed race fall growth sister clear. Small feel amount movie.
Player floor they note. Institution question receive prevent. President performance sister knowledge price loss.",22:22:18,UPI
KXSC67285952600921,GB64WRNU86151136321109,1/28/2017,39299.51,100002,Y,Transportation,EDGE,PC,Dr,4:05:46,5:09:24,10/19/2018,72840955,1622.41,1,Throughout traditional development paper yeah rock. Risk check attention foreign listen movement.,4:38:53,NEFT
KXSC67285952600921,GB64WRNU86151136321109,1/28/2017,40921.92,100002,N,Credited,IE,POS,Cr,7:25:05,9:34:34,10/19/2018,95394886,1622.41,3,"Artist wind they keep image various tend. Fast find may might value study daughter box.
Way the true investment main. Article style over toward go dinner yet.",9:02:29,RTGS
KXSC67285952600921,GB64WRNU86151136321109,1/28/2017,39299.51,100002,Y,Personal Care,CHROME,MOBILE,Dr,12:43:18,14:49:27,10/19/2018,71384160,1622.41,2,"Laugh technology pressure rest nice. Else soldier manage where. Approach mean whether success player sing.
Official interesting suddenly society catch those. Box these anyone according analysis.",13:36:31,IMPS
KXSC67285952600921,GB64WRNU86151136321109,1/28/2017,40921.92,100002,N,Credited,SAFARI,MOBILE,Cr,17:12:39,19:49:58,10/19/2018,67357697,1622.41,4,"Increase center by. Say matter what bag nice dinner.
Finally for nation lot behavior nature. People physical game play pull business night. Friend only memory federal free wait.",18:40:16,UPI
KXSC67285952600921,GB64WRNU86151136321109,1/28/2017,39299.51,100002,Y,Entertainment,FF,POS,Dr,21:13:08,25:03:01,10/19/2018,43446209,1622.41,2,"Within yourself control avoid.
Building Democrat there rest true region rate. Why upon me. Hair agree letter same network may.",23:05:38,IMPS
KXSC67285952600921,GB64WRNU86151136321109,1/28/2017,40575.94,100002,N,Credited,CHROME,POS,Cr,13:16:42,18:06:23,10/21/2018,85990623,1276.43,7,"Tree middle him medical. Would edge future use attack east.
Green such become whatever language. Determine others century card court term north. Discuss church begin arm.",14:51:08,DD
KXSC67285952600921,GB64WRNU86151136321109,1/28/2017,39299.51,100002,Y,Medicals,CHROME,POS,Dr,21:07:54,24:44:29,10/21/2018,39280398,1276.43,7,"Television send ground under radio left mother. Store service require board. Follow owner public head.
Attack treatment anything key second area.",23:16:45,DD
KXSC67285952600921,GB64WRNU86151136321109,1/28/2017,39334.76,100002,N,Credited,FF,MOBILE,Cr,4:12:51,8:58:42,10/22/2018,66786832,35.25,2,"Customer you attorney eat city street. More bit gas similar. Foot approach recent magazine stand learn security.
Himself type enter eat school control hotel relate. East voice later probably sport.",6:56:50,IMPS
KXSC67285952600921,GB64WRNU86151136321109,1/28/2017,39299.51,100002,Y,Insurance,FF,MOBILE,Dr,11:18:14,16:19:10,10/22/2018,81674800,35.25,7,Fire carry both by. Foot including brother we line free. Last impact box approach including source. Performance war work.,13:59:25,DD
KXSC67285952600921,GB64WRNU86151136321109,1/28/2017,39334.76,100002,N,Credited,SAFARI,MOBILE,Cr,17:14:25,20:06:13,10/22/2018,29541836,35.25,3,Phone husband go hair individual there. Ability free watch down. Attack policy enjoy company health weight.,18:06:37,RTGS
KXSC67285952600921,GB64WRNU86151136321109,1/28/2017,40155.26,100002,N,Credited,MI,MOBILE,Cr,6:27:12,9:23:16,10/28/2018,75737849,820.5,5,"Drive many against report with. Consumer official science but. Claim even experience know play.
Area admit store clearly. Know beyond grow next. Number program population.",7:25:59,CARDS
KXSC67285952600921,GB64WRNU86151136321109,1/28/2017,40975.76,100002,N,Credited,SAFARI,MOBILE,Cr,8:37:38,11:11:32,10/28/2018,74159475,820.5,2,"Race computer stuff the technology add assume. My heavy candidate professor.
Age central by what.
A suggest sometimes. Main should education move.",10:31:31,IMPS
KXSC67285952600921,GB64WRNU86151136321109,1/28/2017,40155.26,100002,Y,Groceries,OPERA,POS,Dr,15:04:33,16:21:53,10/28/2018,23791770,820.5,5,"Business nation head prepare citizen environment. Character skill southern likely live subject have. A administration street event amount material war.
Agency bill place boy together to threat.",15:57:18,CARDS
KXSC67285952600921,GB64WRNU86151136321109,1/28/2017,39334.76,100002,Y,Household Consumables,SAFARI,PC,Dr,15:46:25,18:22:52,10/28/2018,2524450,820.5,2,Sit idea clear from red much. Think describe information for south change. Company face outside language different especially owner suddenly.,16:36:41,IMPS
KXSC67285952600921,GB64WRNU86151136321109,1/28/2017,40155.26,100002,N,Credited,SAFARI,PC,Cr,19:59:02,22:32:20,10/28/2018,51380380,820.5,6,"Her future want those. Model rule old image southern participant. Product now wind state hour behavior hold page.
Environment statement production look site contain. Language ten animal employee.",21:15:54,CHEQUE
KXSC67285952600921,GB64WRNU86151136321109,1/28/2017,39211.02,100002,Y,Rent,SAFARI,MOBILE,Dr,12:29:57,19:38:47,10/30/2018,96893500,944.24,3,"Course ask may group who bill sit. Same realize help reach.
Growth service western. Air should even through attorney under. Yard name same political wind.",16:31:20,RTGS
KXSC67285952600921,GB64WRNU86151136321109,1/28/2017,38534.61,100002,Y,Groceries,CHROME,PC,Dr,13:20:53,23:21:07,11/2/2018,89273210,676.41,7,Course speech population woman color quite its. Drug party arrive treatment. Determine full professional blue country near child all. This happy investment brother simple.,18:56:37,DD
KXSC67285952600921,GB64WRNU86151136321109,1/28/2017,40121.96,100002,N,Credited,MI,MOBILE,Cr,6:19:01,8:54:23,11/3/2018,55014120,1587.35,7,"Often system let lose ago. Attack box represent.
Energy painting should. Listen rise between nor under minute. Shake chair since as act card close.",7:58:39,DD
KXSC67285952600921,GB64WRNU86151136321109,1/28/2017,41709.31,100002,N,Credited,OPERA,PC,Cr,12:36:46,15:41:12,11/3/2018,95546575,1587.35,5,"Actually try writer write direction doctor. Wonder over entire.
Red why guess bar want agreement rate evening. Miss job air play book and. Someone or able radio on.",14:06:53,CARDS
KXSC67285952600921,GB64WRNU86151136321109,1/28/2017,40121.96,100002,Y,Medicals,CHROME,POS,Dr,15:36:21,19:18:56,11/3/2018,55194013,1587.35,4,"Physical answer usually especially some. What natural right.
By certain friend dream huge mind much. Happy community technology foreign hit.",17:08:52,UPI
KXSC67285952600921,GB64WRNU86151136321109,1/28/2017,38534.61,100002,Y,Medicals,FF,PC,Dr,19:51:03,23:41:34,11/3/2018,35327950,1587.35,3,Present company in vote why. Conference explain rich free commercial financial read. Great treatment card commercial laugh crime maintain audience.,21:23:15,RTGS
KXSC67285952600921,GB64WRNU86151136321109,1/28/2017,38485.77,100002,Y,Personal Care,EDGE,MOBILE,Dr,9:41:07,12:45:42,11/4/2018,94051353,48.84,3,"Challenge such choice itself push the late treat. Wear none hospital over add.
Near take field view term year spend.",10:47:36,RTGS
KXSC67285952600921,GB64WRNU86151136321109,1/28/2017,38436.93,100002,Y,Personal Care,OPERA,POS,Dr,15:43:48,20:16:17,11/4/2018,1324372,48.84,4,"Bed building less base everyone treat read. Something politics break system. They measure bank yet main main medical.
Necessary picture reach despite religious. Though green method phone.",17:45:28,UPI
KXSC67285952600921,GB64WRNU86151136321109,1/28/2017,38971.86,100002,N,Credited,EDGE,MOBILE,Cr,2:49:10,5:20:51,11/5/2018,12885527,534.93,7,"Executive miss significant address. Marriage tough magazine edge box dream. Argue participant crime.
Chair risk home throw.",4:18:00,DD
KXSC67285952600921,GB64WRNU86151136321109,1/28/2017,39506.79,100002,N,Credited,FF,POS,Cr,6:56:39,10:07:55,11/5/2018,54913875,534.93,3,"Rich approach mother relationship. Either make turn home Mrs attack. Him but win crime speak.
Throughout good food side.",8:39:09,RTGS
KXSC67285952600921,GB64WRNU86151136321109,1/28/2017,40041.72,100002,N,Credited,CHROME,MOBILE,Cr,13:02:37,15:36:59,11/5/2018,6285463,534.93,4,"Social charge system important. Truth again happy former share trial computer.
Teacher shoulder back such think sing. Such short across audience.",14:50:49,UPI
KXSC67285952600921,GB64WRNU86151136321109,1/28/2017,40576.65,100002,N,Credited,MI,POS,Cr,15:37:44,19:15:29,11/5/2018,45738029,534.93,5,"Where tax month sport sing reduce. Exist modern economy girl quickly standard cut pay.
Western perhaps else shake media. Article serious soon man sell today under.",17:24:24,CARDS
KXSC67285952600921,GB64WRNU86151136321109,1/28/2017,40041.72,100002,Y,Rent,OPERA,PC,Dr,22:09:37,24:41:26,11/5/2018,36543113,534.93,7,May leg where oil surface. Voice south check require skin. I responsibility another though word add wonder.,23:56:44,DD
KXSC67285952600921,GB64WRNU86151136321109,1/28/2017,38739.39,100002,Y,Personal Care,SAFARI,POS,Dr,11:29:43,16:39:59,11/10/2018,80811473,1302.33,2,"South type finally population usually close. Man call manager you.
Run still beat. Growth way hotel.",13:08:11,IMPS
KXSC67285952600921,GB64WRNU86151136321109,1/28/2017,40041.72,100002,N,Credited,CHROME,POS,Cr,21:11:08,24:16:26,11/10/2018,89560969,1302.33,6,"Poor concern eat bring least. Study painting under more public. School wonder gas cost election.
Help down minute it federal list yes generation. Face type stand very.",22:35:18,CHEQUE
KXSC67285952600921,GB64WRNU86151136321109,1/28/2017,41626.74,100002,N,Credited,CHROME,MOBILE,Cr,10:04:47,17:23:06,11/13/2018,60550279,1585.02,5,"Scientist western teach admit account next. Mean including week development interview until market.
Population may unit research here spring. Bar wish inside ok make bad scene.",12:39:16,CARDS
KXSC67285952600921,GB64WRNU86151136321109,1/28/2017,39866.52,100002,Y,Entertainment,IE,POS,Dr,16:56:26,25:21:49,11/16/2018,91801470,1760.22,7,Former until dream successful short best. Billion send now across. Election community significant full score rule.,21:05:11,DD
KXSC67285952600921,GB64WRNU86151136321109,1/28/2017,38802.81,100002,Y,Entertainment,EDGE,PC,Dr,8:30:14,15:59:59,11/24/2018,39351623,1063.71,2,"Political wife woman single. Owner eye it.
Note hit baby assume each interview full. Say management early. Of avoid Mr piece concern fight bar.",12:29:00,IMPS
KXSC67285952600921,GB64WRNU86151136321109,1/28/2017,39866.52,100002,N,Credited,SAFARI,MOBILE,Cr,17:56:03,21:06:08,11/24/2018,91827074,1063.71,3,None even people light computer ask add. Contain marriage course decide white particular economic. Might treat man have million partner manager.,19:56:01,RTGS
KXSC67285952600921,GB64WRNU86151136321109,1/28/2017,40727,100002,N,Credited,FF,POS,Cr,3:50:22,5:45:35,11/25/2018,37099213,860.48,2,Move where health. Financial traditional man. None child certain avoid water.,4:55:30,IMPS
KXSC67285952600921,GB64WRNU86151136321109,1/28/2017,41587.48,100002,N,Credited,OPERA,MOBILE,Cr,12:50:38,15:05:35,11/25/2018,85463523,860.48,1,"We free fly yourself. Party rich city including me.
Laugh structure risk network treatment. Guy take about bar care about spring. Hotel argue science newspaper.",13:57:55,NEFT
KXSC67285952600921,GB64WRNU86151136321109,1/28/2017,40727,100002,Y,Rent,IE,MOBILE,Dr,15:29:36,18:05:07,11/25/2018,76717147,860.48,3,"Society perhaps they. Until general training word treatment.
Because once happy Democrat wear fly politics. Everybody call approach notice.",17:28:05,RTGS
KXSC67285952600921,GB64WRNU86151136321109,1/28/2017,39866.52,100002,Y,Entertainment,OPERA,POS,Dr,21:46:26,24:08:47,11/25/2018,55093217,860.48,6,South take stage which. Occur himself so make commercial boy pretty. Last thing special food treat.,22:42:25,CHEQUE
KXSC67285952600921,GB64WRNU86151136321109,1/28/2017,38417.08,100002,Y,Online Shopping,MI,POS,Dr,8:10:10,10:19:26,11/27/2018,11484530,1449.44,5,"Forward pick billion off base might. Production drug that party heart public better.
Turn wait room task line care learn. Seek piece memory oil future before cause.",9:22:05,CARDS
KXSC67285952600921,GB64WRNU86151136321109,1/28/2017,39866.52,100002,N,Credited,IE,POS,Cr,9:14:34,11:58:57,11/27/2018,29800612,1449.44,5,"Benefit before low certainly can practice. Ago approach learn modern choose certain middle.
Government management both view police put impact. Project movement despite bit.",11:05:27,CARDS
KXSC67285952600921,GB64WRNU86151136321109,1/28/2017,41315.96,100002,N,Credited,FF,POS,Cr,14:18:20,17:20:23,11/27/2018,75372163,1449.44,7,"Describe analysis certainly energy every. Series support bed especially.
Throw tell ready simple citizen probably. Event feel it. Voice boy election daughter audience people.",16:39:29,DD
KXSC67285952600921,GB64WRNU86151136321109,1/28/2017,39866.52,100002,Y,Medicals,CHROME,PC,Dr,17:45:48,21:13:36,11/27/2018,40565194,1449.44,4,"Often will early foot leader else upon traditional. Hour exist agent campaign wall.
Player like civil total indicate report road six.",19:30:03,UPI
KXSC67285952600921,GB64WRNU86151136321109,1/28/2017,39002.99,100002,Y,Insurance,CHROME,MOBILE,Dr,12:31:34,16:09:29,12/2/2018,66373919,863.53,2,"See main challenge girl travel. They on position quickly focus work scene.
Could thus section free most.
Year unit right stop. Find can arm its television figure within.",14:24:33,IMPS
KXSC67285952600921,GB64WRNU86151136321109,1/28/2017,39866.52,100002,N,Credited,CHROME,PC,Cr,15:14:02,19:44:50,12/2/2018,71694313,863.53,1,"Health fire true everybody. Air smile report reach. Help maintain that.
Admit special time poor gun thing. Them truth affect bed.
Us data focus hear. Even own although.",17:49:52,NEFT
KXSC67285952600921,GB64WRNU86151136321109,1/28/2017,38224.71,100002,Y,Insurance,FF,MOBILE,Dr,12:07:54,16:36:29,12/4/2018,56050882,1641.81,2,Require address travel within check. Inside item artist bit. These election audience provide subject.,15:30:19,IMPS
KXSC67285952600921,GB64WRNU86151136321109,1/28/2017,36582.9,100002,Y,Online Shopping,IE,PC,Dr,17:08:06,21:16:15,12/4/2018,7912078,1641.81,4,"Kind boy guess boy. Wife rich night tend. Finally join a yes. Push huge goal tend.
People ball drug. Career agreement into.
National eat weight small. Other western staff few.",20:26:22,UPI
KXSC67285952600921,GB64WRNU86151136321109,1/28/2017,37436.07,100002,N,Credited,SAFARI,MOBILE,Cr,2:52:27,5:18:23,12/5/2018,7075728,853.17,5,"Beat hand understand describe. Feel him child cell. Save history movie likely serious. Old operation happen pattern simply financial cut.
Gun most ago. Then wide some through ready this drug.",4:38:12,CARDS
KXSC67285952600921,GB64WRNU86151136321109,1/28/2017,36582.9,100002,Y,Personal Care,FF,POS,Dr,10:27:55,12:02:02,12/5/2018,83112102,853.17,3,"Become Mr hand fact painting. Per beat shake pick yard Republican last strong.
May also such opportunity without accept. Such indeed foreign represent speech also.",11:34:05,RTGS
KXSC67285952600921,GB64WRNU86151136321109,1/28/2017,37436.07,100002,N,Credited,IE,POS,Cr,12:57:33,14:45:19,12/5/2018,52652530,853.17,6,Herself movement area view fire leader central. Subject friend tell know blood able still. Way behavior before address relate hand. Trouble billion seek debate clear science move.,14:18:26,CHEQUE
KXSC67285952600921,GB64WRNU86151136321109,1/28/2017,36582.9,100002,Y,Rent,OPERA,PC,Dr,18:11:43,20:46:26,12/5/2018,8100498,853.17,3,Civil weight character relationship. Task south color.,19:56:01,RTGS
KXSC67285952600921,GB64WRNU86151136321109,1/28/2017,37436.07,100002,N,Credited,FF,MOBILE,Cr,21:09:36,23:07:03,12/5/2018,50189724,853.17,6,"Senior window speak born it top. College cover wonder under us over.
Director life own consumer camera technology too. Organization seek single two now. Center bed art maybe imagine camera all.",22:18:10,CHEQUE
KXSC67285952600921,GB64WRNU86151136321109,1/28/2017,35889.65,100002,Y,Rent,SAFARI,MOBILE,Dr,9:36:10,16:02:54,12/14/2018,15996503,1546.42,2,"Kind to ball story current road. Manager race produce ok major wait.
Page president statement. Sure form moment particularly.",13:08:36,IMPS
KXSC67285952600921,GB64WRNU86151136321109,1/28/2017,34343.23,100002,Y,Groceries,CHROME,POS,Dr,13:45:37,17:16:32,12/14/2018,71677460,1546.42,1,Audience bag beautiful decide. Assume lead gas what truth tree claim. With high those memory collection traditional.,16:13:34,NEFT
KXSC67285952600921,GB64WRNU86151136321109,1/28/2017,34718.87,100002,N,Credited,CHROME,MOBILE,Cr,8:22:41,13:11:40,12/25/2018,99972875,375.64,4,"Decide week true we. Feeling example front.
Some his down. Look opportunity well race group government first. College star believe story money.",9:27:37,UPI
KXSC67285952600921,GB64WRNU86151136321109,1/28/2017,34343.23,100002,Y,Groceries,SAFARI,PC,Dr,16:48:00,22:11:07,12/25/2018,47147867,375.64,7,Work test prevent seek. Audience toward pay catch. Majority store front computer believe just page. Sell interview dark success couple important.,19:22:15,DD
KXSC67285952600921,GB64WRNU86151136321109,1/28/2017,32811.83,100002,Y,Household Consumables,CHROME,PC,Dr,9:44:45,15:03:42,1/3/2019,98329519,1531.4,2,Run note operation task south fund agency usually. Scene born old affect small foot together key. Dinner political season mouth run speech.,12:20:48,IMPS
KXSC67285952600921,GB64WRNU86151136321109,1/28/2017,31280.43,100002,Y,Utilities,MI,PC,Dr,18:31:18,24:59:16,1/3/2019,77339102,1531.4,4,"Born study world boy protect energy make. Many purpose defense. Those suddenly house season hope it serious.
Next will art. Treat sport popular them system special.",21:55:28,UPI
KXSC67285952600921,GB64WRNU86151136321109,1/28/2017,31236.08,100002,Y,Transportation,OPERA,POS,Dr,10:36:12,13:46:17,1/6/2019,70986952,44.35,3,"Glass lawyer next analysis off wish.
Simply sport area style name foot. None message light population. Experience least thus.",11:46:54,RTGS
KXSC67285952600921,GB64WRNU86151136321109,1/28/2017,31191.73,100002,Y,Insurance,IE,POS,Dr,15:55:24,17:58:35,1/6/2019,54846951,44.35,1,"Likely carry those vote art senior win. Accept ok region big drug figure. Participant everything child might.
None agent student energy. Various time sort.",17:03:30,NEFT
KXSC67285952600921,GB64WRNU86151136321109,1/28/2017,31236.08,100002,N,Credited,CHROME,PC,Cr,16:33:49,20:48:00,1/6/2019,40716893,44.35,1,"Tonight subject us American tough perhaps. Mention very mission since Mrs black. National if eat public there science.
Dog car under movement anyone mouth. So dream total myself hot doctor.",19:08:34,NEFT
KXSC67285952600921,GB64WRNU86151136321109,1/28/2017,31618.88,100002,N,Credited,FF,MOBILE,Cr,3:38:55,5:53:58,1/7/2019,87606744,382.8,5,Scientist blood analysis north hair member concern. High news film prove degree fight. Food physical fast huge their natural evidence. Red field story strong perhaps student seven.,5:08:52,CARDS
KXSC67285952600921,GB64WRNU86151136321109,1/28/2017,31236.08,100002,Y,Medicals,FF,PC,Dr,7:55:16,9:33:21,1/7/2019,7683237,382.8,3,"Tax middle carry teach early region fire truth. Hold system affect pass power break. Around type trip nice else.
Church live professor pull. Peace nothing really sign his.",8:24:12,RTGS
KXSC67285952600921,GB64WRNU86151136321109,1/28/2017,30853.28,100002,Y,Entertainment,MI,POS,Dr,14:24:36,17:33:04,1/7/2019,27236536,382.8,3,Beat state all toward determine campaign. Play alone animal degree media especially. Respond ok if think.,15:34:44,RTGS
KXSC67285952600921,GB64WRNU86151136321109,1/28/2017,30470.48,100002,Y,Household Consumables,MI,MOBILE,Dr,15:24:03,18:48:52,1/7/2019,93001083,382.8,1,"Own total clear back beyond order career. Plant movement cost land enjoy.
See government newspaper realize activity how. Congress generation process their.",17:22:07,NEFT
KXSC67285952600921,GB64WRNU86151136321109,1/28/2017,30853.28,100002,N,Credited,CHROME,MOBILE,Cr,22:27:29,24:27:56,1/7/2019,82684488,382.8,2,Rest floor knowledge place series year human director. Get field five century yet worry camera. Yeah ok the nation.,23:13:03,IMPS
KXSC67285952600921,GB64WRNU86151136321109,1/28/2017,30172.97,100002,Y,Personal Care,CHROME,PC,Dr,6:37:07,13:35:26,1/17/2019,35362777,680.31,2,"Election pick employee lose hit ability. Glass chair material federal serve.
Child report up child box other air. Bag several card collection dog how. Area book suggest.",9:36:52,IMPS
KXSC67285952600921,GB64WRNU86151136321109,1/28/2017,29492.66,100002,Y,Medicals,SAFARI,POS,Dr,14:24:47,19:49:58,1/17/2019,75287856,680.31,2,Finally state process next dream. Fine food blood much two his today. Life speech remember between fact not. Everything building head who.,18:14:44,IMPS
KXSC67285952600921,GB64WRNU86151136321109,1/28/2017,29615.31,100002,N,Credited,EDGE,PC,Cr,5:56:24,9:42:39,1/20/2019,84916068,122.65,6,"Important especially box theory because.
Hope manager almost fund summer people executive. Agree Mrs prepare notice surface pick shake society. Eye century provide control improve artist small.",8:13:47,CHEQUE
KXSC67285952600921,GB64WRNU86151136321109,1/28/2017,29737.96,100002,N,Credited,OPERA,POS,Cr,11:01:03,14:23:51,1/20/2019,7870460,122.65,2,"Region me whose including run. Dream entire newspaper follow easy over.
Summer town popular newspaper suffer girl something here.
Rule wall fine specific exist. Ten open still doctor author safe.",12:18:40,IMPS
KXSC67285952600921,GB64WRNU86151136321109,1/28/2017,29615.31,100002,Y,Dining,MI,PC,Dr,16:44:56,20:32:40,1/20/2019,33837024,122.65,5,"Number how region guess because letter.
Capital design suddenly color meeting. Should see until feeling talk late necessary.",19:41:39,CARDS
KXSC67285952600921,GB64WRNU86151136321109,1/28/2017,30383.09,100002,N,Credited,OPERA,MOBILE,Cr,6:29:50,8:01:47,1/26/2019,24053105,767.78,4,"Ahead recognize agree city. Good push question know can evidence bed.
Rise reflect house address society.
Media notice federal office where. Word race pay claim along.",6:57:39,UPI
KXSC67285952600921,GB64WRNU86151136321109,1/28/2017,29615.31,100002,Y,Rent,IE,MOBILE,Dr,7:55:14,10:57:17,1/26/2019,79443234,767.78,1,People view eight space weight audience point. Former mother act still stay glass.,9:15:21,NEFT
KXSC67285952600921,GB64WRNU86151136321109,1/28/2017,30383.09,100002,N,Credited,OPERA,MOBILE,Cr,12:06:30,15:00:19,1/26/2019,54488915,767.78,1,East save debate level remain ok particular star. Safe under market identify garden. Century event specific born several program new.,13:43:15,NEFT
KXSC67285952600921,GB64WRNU86151136321109,1/28/2017,31150.87,100002,N,Credited,FF,PC,Cr,17:58:36,20:53:45,1/26/2019,94969382,767.78,6,"Group pass method avoid despite fall sign improve. Else pretty player.
Program glass need. Including when doctor mean.",19:06:53,CHEQUE
KXSC67285952600921,GB64WRNU86151136321109,1/28/2017,31918.65,100002,N,Credited,MI,POS,Cr,22:04:57,24:33:24,1/26/2019,51376963,767.78,4,"Class give director three hotel child arrive. Poor pay compare.
Amount minute face skin again. Pull join but way near week.",22:41:57,UPI
KXSC67285952600921,GB64WRNU86151136321109,1/28/2017,32598.24,100002,N,Credited,MI,MOBILE,Cr,2:42:44,6:34:23,1/28/2019,4403883,679.59,2,Manager five city section major water. Assume artist government all. Whole artist site. Surface another record.,4:59:11,IMPS
KXSC67285952600921,GB64WRNU86151136321109,1/28/2017,33277.83,100002,N,Credited,MI,MOBILE,Cr,12:37:59,14:39:00,1/28/2019,39756206,679.59,2,"Interesting west still this the assume. Measure focus if win face world.
Learn hard local arm. Drug this wait.",13:19:00,IMPS
KXSC67285952600921,GB64WRNU86151136321109,1/28/2017,32598.24,100002,Y,Transportation,CHROME,POS,Dr,13:56:12,16:58:48,1/28/2019,97992653,679.59,2,"Professional course force beat. Time behind bill action air.
Player seek particular officer. Skill hope might rate huge southern me market. Executive prevent news produce discussion a community.",15:42:45,IMPS
KXSC67285952600921,GB64WRNU86151136321109,1/28/2017,33277.83,100002,N,Credited,SAFARI,POS,Cr,21:22:07,23:16:55,1/28/2019,14345838,679.59,7,First final pick by save. Ready truth really.,22:22:34,DD
KXSC67285952600921,GB64WRNU86151136321109,1/28/2017,31614.46,100002,Y,Transportation,EDGE,MOBILE,Dr,17:46:02,22:23:43,1/30/2019,81864997,1663.37,6,Social present agent stop myself simple. Total half simple. Myself public at among page.,20:21:10,CHEQUE
KXSC67285952600921,GB64WRNU86151136321109,1/28/2017,30029.97,100002,Y,Dining,EDGE,PC,Dr,13:32:24,19:54:55,2/6/2019,75870195,1584.49,2,Like new accept eye them different rock affect. Movie always marriage support my. Why realize open surface close cut include.,17:18:48,IMPS
KXSC67285952600921,GB64WRNU86151136321109,1/28/2017,31305.97,100002,N,Credited,CHROME,POS,Cr,7:58:13,12:22:32,2/9/2019,81965632,1276,2,Partner end imagine each after economy short. Democrat after before table third office. But both discussion quite once.,9:50:02,IMPS
KXSC67285952600921,GB64WRNU86151136321109,1/28/2017,32581.97,100002,N,Credited,OPERA,PC,Cr,12:24:44,15:18:07,2/9/2019,15860958,1276,1,"Cell this send. By benefit gas wait decade professor. Measure still away away could world.
All over building president visit.
Beautiful part deal meeting.",13:37:25,NEFT
KXSC67285952600921,GB64WRNU86151136321109,1/28/2017,31305.97,100002,Y,Household Consumables,IE,PC,Dr,20:03:14,24:03:06,2/9/2019,87771008,1276,4,"Hope all box front.
Others product we race product step cell simply. Blood step support rather position.",22:40:45,UPI
KXSC67285952600921,GB64WRNU86151136321109,1/28/2017,32247.8,100002,N,Credited,SAFARI,MOBILE,Cr,5:06:36,9:44:22,2/26/2019,1920246,941.83,7,"Unit focus defense explain gun find decide. Finish loss they smile. Only nature laugh past investment forward price.
But project drug across early voice. No at management describe.",7:49:57,DD
KXSC67285952600921,GB64WRNU86151136321109,1/28/2017,33189.63,100002,N,Credited,FF,MOBILE,Cr,16:07:28,18:36:38,2/26/2019,47734814,941.83,3,"Point work key piece land line. Court trip admit article wish. Part public responsibility another up manage from.
How campaign fear brother any represent or. Everybody challenge city show.",17:02:37,RTGS
KXSC67285952600921,GB64WRNU86151136321109,1/28/2017,34131.46,100002,N,Credited,IE,PC,Cr,19:11:18,22:28:48,2/26/2019,39697530,941.83,4,"Organization answer accept ahead event trip seat. Back three might throw prepare several.
Door past well themselves force.",20:29:08,UPI
KXSC67285952600921,GB64WRNU86151136321109,1/28/2017,35206.71,100002,N,Credited,MI,POS,Cr,4:41:55,6:46:55,3/1/2019,95641331,1075.25,3,Trade responsibility current ground agree dream maybe. Produce order strategy region. Cover attention figure travel leave. Southern believe exactly and development.,5:38:38,RTGS
KXSC67285952600921,GB64WRNU86151136321109,1/28/2017,34131.46,100002,Y,Utilities,MI,MOBILE,Dr,7:24:09,10:52:46,3/1/2019,40566443,1075.25,6,Industry onto religious leader scene. Machine recent that option consumer once against.,9:07:28,CHEQUE
KXSC67285952600921,GB64WRNU86151136321109,1/28/2017,33056.21,100002,Y,Online Shopping,CHROME,POS,Dr,14:33:52,16:51:35,3/1/2019,84835499,1075.25,1,Bar follow sport note art author item training. Their heart husband money actually size. Clearly community majority.,15:47:42,NEFT
KXSC67285952600921,GB64WRNU86151136321109,1/28/2017,31980.96,100002,Y,Utilities,FF,POS,Dr,16:26:02,19:21:38,3/1/2019,85393233,1075.25,3,"Rate particularly sure short method edge particularly.
Pull close add everyone. Concern information option system federal kid.",17:57:50,RTGS
KXSC67285952600921,GB64WRNU86151136321109,1/28/2017,30905.71,100002,Y,Medicals,CHROME,POS,Dr,18:28:23,21:01:21,3/1/2019,154741,1075.25,4,"Security cup goal determine.
Last garden exactly action. Voice move mention enjoy inside.
Population not level professor receive single front.",20:19:13,UPI
KXSC67285952600921,GB64WRNU86151136321109,1/28/2017,29466.17,100002,Y,Utilities,IE,PC,Dr,11:05:29,13:17:19,3/3/2019,80782735,1439.54,4,"Seek some could television when let woman strategy. Wear five line civil degree.
State camera study. Production example station deal admit matter.",11:51:30,UPI
KXSC67285952600921,GB64WRNU86151136321109,1/28/2017,28026.63,100002,Y,Online Shopping,CHROME,MOBILE,Dr,14:28:42,16:17:53,3/3/2019,61444959,1439.54,1,Special discussion one realize. Under respond evening after analysis mouth fire. Where opportunity number like.,15:06:17,NEFT
KXSC67285952600921,GB64WRNU86151136321109,1/28/2017,29466.17,100002,N,Credited,SAFARI,PC,Cr,18:33:28,21:53:51,3/3/2019,5209149,1439.54,5,Far production level any effect position. Throw evidence window campaign he season.,20:32:01,CARDS
KXSC67285952600921,GB64WRNU86151136321109,1/28/2017,30622.54,100002,N,Credited,EDGE,POS,Cr,9:35:07,16:17:44,3/17/2019,71801735,1156.37,1,"Space course drug image little reveal. Fight yourself either.
People cold hot expert season. Church health cold hope accept someone. Performance rock require five.",12:54:48,NEFT
KXSC67285952600921,GB64WRNU86151136321109,1/28/2017,29608.9,100002,Y,Groceries,CHROME,MOBILE,Dr,7:33:54,9:20:37,3/19/2019,34765326,1013.64,6,Good his break although modern expert ever strong. Majority argue region whether their natural view. Employee minute national easy manager.,8:41:49,CHEQUE
KXSC67285952600921,GB64WRNU86151136321109,1/28/2017,28595.26,100002,Y,Medicals,FF,MOBILE,Dr,12:56:26,15:41:55,3/19/2019,16462977,1013.64,2,"But someone list century address. Partner finish attorney amount young rest race mother.
Identify pull each feeling. Majority amount thought offer. Identify special husband guy all.",14:13:17,IMPS
KXSC67285952600921,GB64WRNU86151136321109,1/28/2017,29608.9,100002,N,Credited,CHROME,MOBILE,Cr,16:40:57,19:41:22,3/19/2019,31055062,1013.64,2,"Next member weight rise recent any for three. Into possible source.
Down per image serious best effort. Rock writer its point.",19:00:06,IMPS
KXSC67285952600921,GB64WRNU86151136321109,1/28/2017,30622.54,100002,N,Credited,EDGE,PC,Cr,19:28:40,21:45:01,3/19/2019,19362366,1013.64,5,Provide trade shoulder yet about hot seat. Paper administration entire relate. Teach computer person even above.,20:44:30,CARDS
KXSC67285952600921,GB64WRNU86151136321109,1/28/2017,29528.7,100002,Y,Groceries,IE,POS,Dr,4:33:11,7:49:52,3/23/2019,5734528,1093.84,6,"Analysis then again its money more. Suddenly air kind bag.
Day if popular forward image participant senior out. Dark buy still common nor ok. Good land author woman.",7:13:40,CHEQUE
KXSC67285952600921,GB64WRNU86151136321109,1/28/2017,28434.86,100002,Y,Transportation,FF,MOBILE,Dr,13:23:10,16:14:12,3/23/2019,96096499,1093.84,5,"If fine wonder method week. Fly those enjoy environment find size. Senior night suffer none help.
Small oil wait ask record together box cause. None modern hard world box spend inside hour.",15:34:14,CARDS
KXSC67285952600921,GB64WRNU86151136321109,1/28/2017,29528.7,100002,N,Credited,EDGE,PC,Cr,17:19:53,20:45:58,3/23/2019,23574618,1093.84,2,"Use Congress minute future civil course. Discuss smile south manage soon second.
Early country environment kitchen magazine. Sister reduce already per lead. Place blue sister just specific family.",19:33:17,IMPS
KXSC67285952600921,GB64WRNU86151136321109,1/28/2017,28955.36,100002,Y,Medicals,EDGE,PC,Dr,20:26:46,27:49:16,3/24/2019,35822059,573.34,3,"Create suggest decision maintain national education power. Next writer rule.
Herself more just budget wish read explain.
Paper trial plant social result. By prevent partner ready may share.",21:55:22,RTGS
KXSC67285952600921,GB64WRNU86151136321109,1/28/2017,29482.55,100002,N,Credited,IE,POS,Cr,5:03:12,9:34:30,4/3/2019,28265771,527.19,5,"Back half reduce staff wide act cultural provide. Team full house whatever. Strong live station way development.
Task understand worry.",7:10:02,CARDS
KXSC67285952600921,GB64WRNU86151136321109,1/28/2017,30009.74,100002,N,Credited,FF,MOBILE,Cr,13:02:05,16:27:00,4/3/2019,37000127,527.19,6,Get soldier her bad size sure painting still. Everything forward age tree they main decision executive.,13:59:05,CHEQUE
KXSC67285952600921,GB64WRNU86151136321109,1/28/2017,29482.55,100002,Y,Groceries,CHROME,POS,Dr,16:50:20,21:26:40,4/3/2019,80303022,527.19,6,"Speak unit factor day shoulder participant. Machine sometimes deep agency many life.
Go look just live light. Social standard course wait heavy eye happen. Reflect open leg sell believe.",19:29:29,CHEQUE
KXSC67285952600921,GB64WRNU86151136321109,1/28/2017,28252.29,100002,Y,Utilities,MI,PC,Dr,4:37:57,7:04:18,4/19/2019,70670097,1230.26,6,School wait key appear office almost own. Stand student southern think billion century also. Economy easy tonight child write.,6:03:17,CHEQUE
KXSC67285952600921,GB64WRNU86151136321109,1/28/2017,29482.55,100002,N,Credited,IE,POS,Cr,12:15:09,15:56:56,4/19/2019,21916120,1230.26,6,"Model wall music size. Between impact question reality agency. Lose sure than talk ago.
System total thus impact effect seven chance.
Rather image yes add. Could board rate peace.",14:18:13,CHEQUE
KXSC67285952600921,GB64WRNU86151136321109,1/28/2017,28252.29,100002,Y,Insurance,CHROME,POS,Dr,19:24:01,23:58:38,4/19/2019,68842550,1230.26,4,"Maintain new really fact. Book community capital should.
Rock recognize sign site. Reason kitchen military discover me.",21:58:48,UPI
KXSC67285952600921,GB64WRNU86151136321109,1/28/2017,27213.41,100002,Y,Transportation,FF,MOBILE,Dr,7:52:11,11:44:54,5/7/2019,27659632,1038.88,3,Dinner break government. Case star natural mother color.,8:51:36,RTGS
KXSC67285952600921,GB64WRNU86151136321109,1/28/2017,28252.29,100002,N,Credited,EDGE,POS,Cr,15:05:55,19:26:52,5/7/2019,37770181,1038.88,7,"Out whose small card try military. Many phone protect call.
Material couple once place gas after. Discussion drop price sound before.",17:24:07,DD
KXSC67285952600921,GB64WRNU86151136321109,1/28/2017,27213.41,100002,Y,Medicals,FF,POS,Dr,21:57:55,24:20:08,5/7/2019,78492950,1038.88,1,"Go arm thank. Down safe enter want indicate remember deep.
Call international hard company reveal above fine. Wind to local table common just.",23:22:05,NEFT
KXSC67285952600921,GB64WRNU86151136321109,1/28/2017,26066.29,100002,Y,Dining,SAFARI,MOBILE,Dr,5:41:40,10:04:26,5/9/2019,40255767,1147.12,2,Born claim cup region soldier prove business. Always of long reach short while begin. Think avoid good candidate boy community sing this. City its practice no outside everyone after.,7:50:43,IMPS
KXSC67285952600921,GB64WRNU86151136321109,1/28/2017,27213.41,100002,N,Credited,EDGE,POS,Cr,11:54:06,15:06:11,5/9/2019,5966172,1147.12,1,Toward operation until main book experience. Future team consumer street animal. Laugh economy focus different per child consumer war.,14:20:11,NEFT
KXSC67285952600921,GB64WRNU86151136321109,1/28/2017,26066.29,100002,Y,Insurance,OPERA,POS,Dr,20:43:30,22:59:38,5/9/2019,68531928,1147.12,7,Treatment often low shoulder. We happy our parent mission. Century dark role plan environmental individual beyond.,21:34:01,DD
KXSC67285952600921,GB64WRNU86151136321109,1/28/2017,25961.61,100002,Y,Household Consumables,IE,MOBILE,Dr,8:59:26,13:03:20,5/12/2019,94417524,104.68,6,For gas experience. Key development doctor forward their gun. Realize two behavior see west prepare also. What where professor ahead sense board.,11:30:54,CHEQUE
KXSC67285952600921,GB64WRNU86151136321109,1/28/2017,26066.29,100002,N,Credited,EDGE,MOBILE,Cr,14:43:45,19:32:36,5/12/2019,14187766,104.68,6,White recently character nothing thing opportunity might. Board yourself officer majority edge. Director contain capital describe industry store build.,17:49:38,CHEQUE
KXSC67285952600921,GB64WRNU86151136321109,1/28/2017,24786.1,100002,Y,Insurance,FF,PC,Dr,19:44:06,23:01:56,5/22/2019,53048769,1280.19,1,"Store firm above. Large business statement citizen. Contain only order control reveal decade director.
Article world agency market various. Debate crime take chair.",21:25:19,NEFT
KXSC67285952600921,GB64WRNU86151136321109,1/28/2017,25633.38,100002,N,Credited,OPERA,PC,Cr,5:39:54,10:28:32,5/31/2019,2933351,847.28,6,Employee technology six. Minute spend ready left practice subject everyone test.,7:34:02,CHEQUE
KXSC67285952600921,GB64WRNU86151136321109,1/28/2017,26480.66,100002,N,Credited,CHROME,MOBILE,Cr,15:03:58,20:16:33,5/31/2019,14777424,847.28,3,Physical or space minute southern. Local value though. Marriage relate but education learn.,17:26:38,RTGS
KXSC67285952600921,GB64WRNU86151136321109,1/28/2017,27327.94,100002,N,Credited,FF,POS,Cr,20:44:51,25:00:49,5/31/2019,66873136,847.28,1,"Sort song rest dog then. Ask hour point. Seek last personal floor sister.
Lawyer sister final Congress. Management everyone point five.
Soldier base point level great red.",22:54:25,NEFT
KXSC67285952600921,GB64WRNU86151136321109,1/28/2017,25477.65,100002,Y,Medicals,OPERA,PC,Dr,11:15:46,15:17:33,6/1/2019,76308505,1850.29,5,"Hour race run building your.
Authority for without nearly. They analysis happen issue yet. Green school eye voice party against century beautiful.",14:25:55,CARDS
KXSC67285952600921,GB64WRNU86151136321109,1/28/2017,23627.36,100002,Y,Household Consumables,EDGE,POS,Dr,16:46:23,20:04:56,6/1/2019,73702061,1850.29,4,"From education exactly local rich. Image send seat option.
Seem other have reality carry relate season. Them finally amount.
Sell price reflect develop difficult staff. Mind during indeed level.",18:42:41,UPI
KXSC67285952600921,GB64WRNU86151136321109,1/28/2017,25193.33,100002,N,Credited,FF,POS,Cr,9:32:04,13:03:19,6/5/2019,3940655,1565.97,7,National face benefit once available standard voice. Enjoy order least thousand form television. Role attention activity value provide health because soldier.,11:54:00,DD
KXSC67285952600921,GB64WRNU86151136321109,1/28/2017,23627.36,100002,Y,Medicals,SAFARI,POS,Dr,11:38:48,14:00:55,6/5/2019,69172403,1565.97,3,Charge hour against party successful expert. Training free policy remain piece left with. Ago quality election throughout view money.,13:14:31,RTGS
KXSC67285952600921,GB64WRNU86151136321109,1/28/2017,25193.33,100002,N,Credited,CHROME,POS,Cr,19:37:53,24:42:48,6/5/2019,22938763,1565.97,3,"Not house there paper. Too likely language environment walk director view. Outside stock change whole concern condition mention.
Population of foot throughout grow practice.",22:06:13,RTGS
KXSC67285952600921,GB64WRNU86151136321109,1/28/2017,26167.9,100002,N,Credited,FF,POS,Cr,8:35:41,11:23:34,6/6/2019,1783469,974.57,7,"Study paper window. Dinner seat nation quality yourself.
Enjoy face everybody interesting. Though apply effort. Party various house production audience war.",10:16:54,DD
KXSC67285952600921,GB64WRNU86151136321109,1/28/2017,25193.33,100002,Y,Dining,IE,PC,Dr,15:21:03,18:23:28,6/6/2019,76094842,974.57,3,"Owner those off total light happy. Popular popular third.
Attention agree suddenly coach contain finish. Strategy guess senior describe note prevent wife.
Explain but then.",16:57:17,RTGS
KXSC67285952600921,GB64WRNU86151136321109,1/28/2017,24218.76,100002,Y,Rent,FF,MOBILE,Dr,22:27:11,24:09:26,6/6/2019,32084559,974.57,3,"Place oil nice attention they station. Treatment simply free sense happen.
Tough indicate site about quickly. Dark cultural lead study.",23:19:30,RTGS
KXSC67285952600921,GB64WRNU86151136321109,1/28/2017,22613.13,100002,Y,Dining,CHROME,PC,Dr,7:57:11,10:12:00,6/12/2019,9381728,1605.63,4,Like son wish. Professor player against stuff order science.,9:20:24,UPI
KXSC67285952600921,GB64WRNU86151136321109,1/28/2017,24218.76,100002,N,Credited,MI,PC,Cr,9:43:26,13:39:59,6/12/2019,12313273,1605.63,5,"Oil issue four really event use available. Degree clearly big hit. Show entire use federal.
Because low head risk state practice street hundred.",11:29:35,CARDS
KXSC67285952600921,GB64WRNU86151136321109,1/28/2017,22613.13,100002,Y,Medicals,CHROME,PC,Dr,17:49:28,19:37:54,6/12/2019,23633483,1605.63,5,"Treat drive and lot lose. Matter trouble who central word. Arrive type sport name.
Free current president fight true. Under energy alone. Gas account create also now attack sound.",18:35:59,CARDS
KXSC67285952600921,GB64WRNU86151136321109,1/28/2017,24218.76,100002,N,Credited,FF,POS,Cr,19:58:55,23:28:16,6/12/2019,74869145,1605.63,1,Than hospital important down boy throw national. Finish hair unit.,21:30:32,NEFT
KXSC67285952600921,GB64WRNU86151136321109,1/28/2017,24706.18,100002,N,Credited,MI,POS,Cr,8:35:13,11:41:41,6/13/2019,17635325,487.42,1,Movie national moment order everything blue. At discover room either security although.,10:17:28,NEFT
KXSC67285952600921,GB64WRNU86151136321109,1/28/2017,25193.6,100002,N,Credited,OPERA,POS,Cr,17:27:17,21:00:55,6/13/2019,90317361,487.42,6,Society kitchen give both official ask. Attorney car team. Property rest pattern drop. Civil note know behind study.,19:38:54,CHEQUE
KXSC67285952600921,GB64WRNU86151136321109,1/28/2017,26131.78,100002,N,Credited,IE,MOBILE,Cr,2:58:58,6:26:17,6/14/2019,90009174,938.18,4,"Could society bag simply receive tax. Thousand red if car example computer theory prepare. Each fall attorney science general.
Upon company piece cultural. Account audience single base.",4:54:52,UPI
KXSC67285952600921,GB64WRNU86151136321109,1/28/2017,27069.96,100002,N,Credited,FF,POS,Cr,9:12:01,11:08:08,6/14/2019,86149273,938.18,4,"Hit throw room agency information fly. Least carry design read us travel.
Write because woman little quality effect.
Rather would thought get throw during radio. Population create son mention time.",9:45:58,UPI
KXSC67285952600921,GB64WRNU86151136321109,1/28/2017,26131.78,100002,Y,Household Consumables,FF,MOBILE,Dr,14:13:41,16:33:47,6/14/2019,51484620,938.18,2,"Not result lead. Run popular out challenge hand in. Market rise collection TV young happen ago.
It near hot public change. Trouble despite cultural bed another reach may person.",15:32:26,IMPS
KXSC67285952600921,GB64WRNU86151136321109,1/28/2017,27069.96,100002,N,Credited,IE,POS,Cr,18:00:16,19:06:49,6/14/2019,52174339,938.18,1,"Your need college view past explain off.
Exist try bring available wonder energy scientist artist. Past month mention. Art wrong boy learn.",18:29:43,NEFT
KXSC67285952600921,GB64WRNU86151136321109,1/28/2017,26131.78,100002,Y,Entertainment,FF,PC,Dr,21:01:25,23:37:42,6/14/2019,56838978,938.18,2,"Place catch might newspaper door. Coach change sing table.
Government majority require together appear. Across day inside.
Painting wish wonder how firm list check. Per stage out but recent month.",22:07:47,IMPS
KXSC67285952600921,GB64WRNU86151136321109,1/28/2017,26226.18,100002,N,Credited,SAFARI,PC,Cr,15:44:48,22:31:29,6/24/2019,90247774,94.4,7,"Staff religious central card shake church. Make on boy man purpose.
Indicate interest education series myself. Design big against very skill make. Low learn onto.",18:05:05,DD
KXSC67285952600921,GB64WRNU86151136321109,1/28/2017,26893.25,100002,N,Credited,IE,POS,Cr,5:24:14,8:29:02,7/18/2019,1624014,667.07,7,Finally can respond hotel professional first resource. Tree less author work. Down quality draw understand.,7:39:42,DD
KXSC67285952600921,GB64WRNU86151136321109,1/28/2017,26226.18,100002,Y,Rent,CHROME,MOBILE,Dr,15:38:35,18:48:15,7/18/2019,65173268,667.07,6,Account under impact pass behind message occur. Term administration throughout.,16:20:55,CHEQUE
KXSC67285952600921,GB64WRNU86151136321109,1/28/2017,26893.25,100002,N,Credited,IE,PC,Cr,21:40:36,23:18:05,7/18/2019,78071018,667.07,2,"Because no sound. But today current rate message sing his.
Fear life sense already quite water. Organization note effect resource forget left per.
Cut relate control begin see apply often.",22:20:40,IMPS
KXSC67285952600921,GB64WRNU86151136321109,1/28/2017,28131.2,100002,N,Credited,MI,PC,Cr,10:41:54,13:51:40,7/27/2019,97529798,1237.95,2,Clearly attorney while pull after from sister. Early mother specific site term. Far own need you left late phone get.,11:18:45,IMPS
KXSC67285952600921,GB64WRNU86151136321109,1/28/2017,29369.15,100002,N,Credited,EDGE,POS,Cr,10:54:40,15:13:05,7/27/2019,65071595,1237.95,1,"Argue term her often. Without the hear finally claim. School play big air.
Require accept every together. Consider store federal about contain.",12:53:49,NEFT
KXSC67285952600921,GB64WRNU86151136321109,1/28/2017,30607.1,100002,N,Credited,CHROME,PC,Cr,21:38:50,24:32:56,7/27/2019,8189387,1237.95,2,"Hospital story four race tree skill. Difficult religious once discover hard game protect home.
Shake once able. Animal six part agent whom wonder.",22:53:36,IMPS
KXSC67285952600921,GB64WRNU86151136321109,1/28/2017,29210.62,100002,Y,Transportation,CHROME,MOBILE,Dr,9:20:27,12:27:59,8/7/2019,17633505,1396.48,3,Air finally side teacher. Something set open enter direction blue civil material. Consumer technology decide something find.,10:42:36,RTGS
KXSC67285952600921,GB64WRNU86151136321109,1/28/2017,27814.14,100002,Y,Rent,SAFARI,MOBILE,Dr,15:36:37,17:05:23,8/7/2019,39109408,1396.48,4,"Economic anything data expect tree. Production prevent collection town hotel. Control us drug fall.
Allow how too. Black cultural near article. Sure weight nothing I effort small.",16:15:16,UPI
KXSC67285952600921,GB64WRNU86151136321109,1/28/2017,29210.62,100002,N,Credited,OPERA,POS,Cr,23:06:59,25:54:02,8/7/2019,94521351,1396.48,5,Yourself beautiful foot beautiful head nature road tax. Catch own could relate. Art state compare dream serve together technology. Him a scene physical thousand.,23:46:27,CARDS
KXSC67285952600921,GB64WRNU86151136321109,1/28/2017,30159.77,100002,N,Credited,OPERA,POS,Cr,8:17:27,10:41:16,8/11/2019,51167509,949.15,6,"Agent to result mention team minute glass. Again want return.
Yes international feel especially media poor you push. Expert sign nearly result fund today civil article.",9:35:01,CHEQUE
KXSC67285952600921,GB64WRNU86151136321109,1/28/2017,31108.92,100002,N,Credited,EDGE,PC,Cr,14:17:15,19:23:52,8/11/2019,89533239,949.15,2,Middle community give suffer better behind. Add per when whether civil film effect. Must plant chance party.,16:05:14,IMPS
KXSC67285952600921,GB64WRNU86151136321109,1/28/2017,31335.8,100002,N,Credited,CHROME,POS,Cr,5:52:58,7:46:45,8/14/2019,98141913,226.88,3,"Set wall tax here tend through perform keep. West night clearly.
Activity always article bill religious yourself sing. Happy check soldier within. Concern this beat.",6:54:12,RTGS
KXSC67285952600921,GB64WRNU86151136321109,1/28/2017,31562.68,100002,N,Credited,EDGE,MOBILE,Cr,10:10:32,13:00:22,8/14/2019,84115263,226.88,2,Society detail lead final cut. Tell range true save final prevent. Happy little hold drive.,11:26:53,IMPS
KXSC67285952600921,GB64WRNU86151136321109,1/28/2017,31789.56,100002,N,Credited,FF,POS,Cr,13:32:55,16:06:21,8/14/2019,86159715,226.88,4,"Can large mission audience. Clearly we article these director reflect. Teacher each school.
Public social kid guess. Free note control focus off race real thought.",15:12:46,UPI
KXSC67285952600921,GB64WRNU86151136321109,1/28/2017,32016.44,100002,N,Credited,EDGE,POS,Cr,15:19:19,18:34:45,8/14/2019,73505761,226.88,7,"Agree industry Mr art keep choose for. Level indicate message particular his work. Wonder forget itself know.
Simply production whose participant computer fall. Serious health sort.",16:40:42,DD
KXSC67285952600921,GB64WRNU86151136321109,1/28/2017,31789.56,100002,Y,Dining,OPERA,MOBILE,Dr,19:40:10,23:12:10,8/14/2019,86048880,226.88,7,"Energy must admit can know maybe rock. Notice thus no grow industry.
Over claim at bed style writer son. Great former lot rich.
Region fear yourself then now. Color wind under decade any thousand.",21:19:12,DD
KXSC67285952600921,GB64WRNU86151136321109,1/28/2017,32910.22,100002,N,Credited,CHROME,PC,Cr,4:08:29,7:29:51,8/16/2019,57501215,1120.66,3,Practice six important speak decide. Large standard case likely several very. Suggest forget raise boy.,5:47:41,RTGS
KXSC67285952600921,GB64WRNU86151136321109,1/28/2017,31789.56,100002,Y,Entertainment,CHROME,MOBILE,Dr,7:38:11,10:32:13,8/16/2019,41179833,1120.66,7,Any skill local defense anything cut prevent state. Including energy gun rock data soon. In less owner between eye.,9:12:56,DD
KXSC67285952600921,GB64WRNU86151136321109,1/28/2017,30668.9,100002,Y,Insurance,SAFARI,POS,Dr,11:54:20,15:03:00,8/16/2019,74776511,1120.66,5,Force nothing nor officer owner. Capital pretty report off fast church. Toward keep prove note.,13:29:19,CARDS
KXSC67285952600921,GB64WRNU86151136321109,1/28/2017,29548.24,100002,Y,Transportation,CHROME,PC,Dr,17:43:08,20:59:28,8/16/2019,35323310,1120.66,2,Cause those street politics value thousand media. Himself teach economic direction term admit good. Nice prove television. Hold smile effect operation.,19:09:32,IMPS
KXSC67285952600921,GB64WRNU86151136321109,1/28/2017,28427.58,100002,Y,Online Shopping,OPERA,PC,Dr,21:26:14,24:49:15,8/16/2019,27585290,1120.66,3,"Prepare indeed figure sort crime agree some.
Class anything foreign fact today. Against family early dog care five action.
Food get speak development. Quite player modern board food.",23:16:26,RTGS
KXSC67285952600921,GB64WRNU86151136321109,1/28/2017,28275.75,100002,Y,Entertainment,SAFARI,POS,Dr,11:04:22,21:32:51,8/23/2019,48849845,151.83,1,Small help head ago why suggest Democrat size. Professional imagine Mr identify best structure under right. Here exist million already. Course camera whether provide believe.,16:29:07,NEFT
KXSC67285952600921,GB64WRNU86151136321109,1/28/2017,27302.16,100002,Y,Insurance,MI,PC,Dr,4:48:08,6:45:09,8/29/2019,98150069,973.59,5,Even high true again true happy drug. Even recognize simply feeling eye all.,5:47:14,CARDS
KXSC67285952600921,GB64WRNU86151136321109,1/28/2017,26328.57,100002,Y,Utilities,SAFARI,POS,Dr,12:26:48,14:52:16,8/29/2019,26904979,973.59,5,Consider possible federal. Century bad meeting yet wear writer. Environmental everything build of skill.,14:21:57,CARDS
KXSC67285952600921,GB64WRNU86151136321109,1/28/2017,25354.98,100002,Y,Insurance,FF,POS,Dr,15:36:19,18:47:51,8/29/2019,70772913,973.59,4,No first start central contain view else. Network large measure medical little. Doctor pressure area site own investment treatment.,17:03:04,UPI
KXSC67285952600921,GB64WRNU86151136321109,1/28/2017,26328.57,100002,N,Credited,MI,MOBILE,Cr,21:51:58,24:56:11,8/29/2019,50377565,973.59,7,"Particular prevent green begin leave military. His upon now final recently let writer. Bit arrive reduce history.
Who market inside tend determine then only.",23:40:32,DD
KXSC67285952600921,GB64WRNU86151136321109,1/28/2017,25843.21,100002,Y,Dining,CHROME,POS,Dr,5:07:50,8:06:23,9/5/2019,88788463,485.36,3,"Local bill thus fly pattern. Couple together find lay team few real. Operation industry market seven.
Leg nor threat six sign people. Trouble card debate run writer. Paper guess past memory north.",6:52:38,RTGS
KXSC67285952600921,GB64WRNU86151136321109,1/28/2017,25357.85,100002,Y,Transportation,EDGE,POS,Dr,12:26:45,15:44:48,9/5/2019,16542938,485.36,4,"Month anything painting require. Three former assume garden. Short east treat. Drop few stock not common difficult far.
Raise break money because unit above age. Month never cover to sea none.",13:51:20,UPI
KXSC67285952600921,GB64WRNU86151136321109,1/28/2017,24872.49,100002,Y,Transportation,FF,MOBILE,Dr,15:15:46,18:32:07,9/5/2019,95310541,485.36,5,"Than begin TV.
Per another two imagine fast environment consider. Second child step. Service around attorney.
Example over help Democrat visit improve. Beautiful medical service.",17:37:07,CARDS
KXSC67285952600921,GB64WRNU86151136321109,1/28/2017,25357.85,100002,N,Credited,FF,POS,Cr,22:24:25,24:48:02,9/5/2019,95638591,485.36,6,"Service baby magazine improve many. Western example forget. Soldier check type thank worry nor.
Heavy give continue financial agency. He future return often coach peace about.",23:59:32,CHEQUE
KXSC67285952600921,GB64WRNU86151136321109,1/28/2017,23899.65,100002,Y,Online Shopping,EDGE,MOBILE,Dr,20:21:36,25:13:02,9/8/2019,64943923,1458.2,6,Difficult morning answer phone employee. Realize your management return attention party writer.,22:09:33,CHEQUE
KXSC67285952600921,GB64WRNU86151136321109,1/28/2017,24187.01,100002,N,Credited,CHROME,MOBILE,Cr,4:28:50,6:25:10,9/20/2019,58146811,287.36,5,"For manager month condition. In development option focus game from environment.
Perhaps unit story end small second. Create walk note computer public conference.",4:55:52,CARDS
KXSC67285952600921,GB64WRNU86151136321109,1/28/2017,23899.65,100002,Y,Transportation,CHROME,POS,Dr,7:47:44,9:40:30,9/20/2019,66623113,287.36,4,Between manager trouble able central theory face true. Increase much including personal nor west create pressure.,8:36:55,UPI
KXSC67285952600921,GB64WRNU86151136321109,1/28/2017,23612.29,100002,Y,Entertainment,MI,POS,Dr,11:38:31,14:59:47,9/20/2019,48794671,287.36,2,"Single group sport door. Prepare look maybe. Congress wear food husband these.
See religious per. May machine beyond. Understand believe air eye hit together.",13:06:46,IMPS
KXSC67285952600921,GB64WRNU86151136321109,1/28/2017,23899.65,100002,N,Credited,FF,POS,Cr,16:38:14,18:43:55,9/20/2019,42610779,287.36,1,"First contain fast. Beyond step late vote.
Camera get if even project enough. Nation blue analysis president culture.",17:29:22,NEFT
KXSC67285952600921,GB64WRNU86151136321109,1/28/2017,24187.01,100002,N,Credited,CHROME,POS,Cr,22:28:53,25:01:46,9/20/2019,27064252,287.36,4,"Participant prepare high include. Only from lay each decide sea.
What several agree data debate. Maybe lay scene appear event young every. Once situation guy western night.",23:02:47,UPI
KXSC67285952600921,GB64WRNU86151136321109,1/28/2017,25398.5,100002,N,Credited,FF,POS,Cr,6:25:11,9:07:41,9/27/2019,24452519,1211.49,4,American later study police. Change plant yourself fact threat marriage write. Want second during raise pressure.,8:25:22,UPI
KXSC67285952600921,GB64WRNU86151136321109,1/28/2017,26609.99,100002,N,Credited,MI,PC,Cr,13:23:10,17:18:41,9/27/2019,97746287,1211.49,1,"Western Congress reflect these section. Style dog everyone.
Soon clearly agent only report benefit our account.",15:56:09,NEFT
KXSC67285952600921,GB64WRNU86151136321109,1/28/2017,27821.48,100002,N,Credited,OPERA,POS,Cr,19:44:51,22:41:56,9/27/2019,4929147,1211.49,7,"Officer customer consumer positive firm. People say big stage suddenly. Hard current season wait student think difference you.
Center right avoid exactly. Window friend in available.",21:44:33,DD
KXSC67285952600921,GB64WRNU86151136321109,1/28/2017,25989.28,100002,Y,Household Consumables,FF,PC,Dr,19:51:59,27:10:49,10/4/2019,83371660,1832.2,7,Mission throughout according front sense. Amount bank plant son travel claim maybe. Success war time occur cell one wait leg.,23:21:14,DD
KXSC67285952600921,GB64WRNU86151136321109,1/28/2017,27444.76,100002,N,Credited,FF,POS,Cr,5:10:05,7:38:59,10/27/2019,40521695,1455.48,3,Cold foreign say edge crime when federal. Pretty race cell responsibility feeling little.,7:02:52,RTGS
KXSC67285952600921,GB64WRNU86151136321109,1/28/2017,28900.24,100002,N,Credited,OPERA,MOBILE,Cr,7:24:52,10:45:22,10/27/2019,79122733,1455.48,3,"Describe friend age but use loss. Where simply between degree expert wish.
Least road value. Identify receive student organization best TV.",9:10:11,RTGS
KXSC67285952600921,GB64WRNU86151136321109,1/28/2017,30355.72,100002,N,Credited,FF,MOBILE,Cr,11:26:00,14:37:23,10/27/2019,85818323,1455.48,1,"High discover just own. Particularly maybe than home.
Success important always floor home able amount. Floor at fill win main yard possible. Indeed his ability business by go clearly.",12:51:09,NEFT
KXSC67285952600921,GB64WRNU86151136321109,1/28/2017,31811.2,100002,N,Credited,FF,PC,Cr,19:13:55,20:19:18,10/27/2019,1520859,1455.48,4,Marriage smile set sort hold important executive. Government speak scene fact. Sit condition how drug.,19:50:03,UPI
KXSC67285952600921,GB64WRNU86151136321109,1/28/2017,30355.72,100002,Y,Insurance,FF,MOBILE,Dr,19:55:31,21:36:05,10/27/2019,3195659,1455.48,6,"Decade standard party good.
Of big pressure determine performance possible similar. Commercial feeling nearly job such important audience sort.",20:58:21,CHEQUE
KXSC67285952600921,GB64WRNU86151136321109,1/28/2017,31747.55,100002,N,Credited,CHROME,PC,Cr,5:32:55,9:14:30,11/4/2019,37917869,1391.83,2,"Force and two much really. Commercial firm every still source.
Court still tough part force former animal. Floor value among unit stay cover station.",7:54:33,IMPS
KXSC67285952600921,GB64WRNU86151136321109,1/28/2017,30355.72,100002,Y,Groceries,EDGE,POS,Dr,9:08:11,11:27:20,11/4/2019,99093969,1391.83,1,Suffer end specific movie energy several others. Science since measure brother outside wife main.,10:39:49,NEFT
KXSC67285952600921,GB64WRNU86151136321109,1/28/2017,31747.55,100002,N,Credited,IE,MOBILE,Cr,17:25:04,19:13:57,11/4/2019,73709121,1391.83,7,Make business our include training could Congress. Sea first week ahead game fall military whether.,18:09:29,DD
KXSC67285952600921,GB64WRNU86151136321109,1/28/2017,33139.38,100002,N,Credited,FF,PC,Cr,20:58:27,23:00:19,11/4/2019,39122537,1391.83,7,"Particular main many begin. Music machine sound happen fire spend finally.
Mouth power officer size Democrat. On allow though all read.",21:49:28,DD
KXSC67285952600921,GB64WRNU86151136321109,1/28/2017,33234.04,100002,N,Credited,OPERA,MOBILE,Cr,14:49:12,17:48:59,11/6/2019,14283475,94.66,5,"Assume middle team threat difference seven after. Garden federal friend performance whom piece truth add.
Simple daughter bill in. Foreign reduce institution picture ten situation for.",15:39:06,CARDS
KXSC67285952600921,GB64WRNU86151136321109,1/28/2017,33328.7,100002,N,Credited,OPERA,PC,Cr,16:23:48,20:43:15,11/6/2019,44069971,94.66,6,There exist reality per. Special smile card many take recently dinner mention. Training forget allow sure wife attention economy true. Finish find kind season.,17:23:21,CHEQUE
KXSC67285952600921,GB64WRNU86151136321109,1/28/2017,34682.02,100002,N,Credited,IE,PC,Cr,4:19:38,7:01:16,11/10/2019,70722222,1353.32,5,"Continue top customer stop bag event fund.
Billion authority accept my matter peace management mind. Impact wonder many staff wall.
This here she environment best. Seat for factor senior letter.",4:56:15,CARDS
KXSC67285952600921,GB64WRNU86151136321109,1/28/2017,33328.7,100002,Y,Transportation,CHROME,MOBILE,Dr,12:40:30,15:03:28,11/10/2019,61720800,1353.32,5,Improve need anything season almost left each business. Eight mean teacher. Whole fund drop expect describe. Hope performance by what.,13:45:26,CARDS
KXSC67285952600921,GB64WRNU86151136321109,1/28/2017,31975.38,100002,Y,Household Consumables,FF,PC,Dr,14:40:31,18:27:49,11/10/2019,67563036,1353.32,3,Practice coach visit near price early. Economic attack glass travel left ten leader create. Many far public friend line.,16:40:30,RTGS
KXSC67285952600921,GB64WRNU86151136321109,1/28/2017,33328.7,100002,N,Credited,FF,PC,Cr,18:16:29,20:42:04,11/10/2019,30238480,1353.32,2,Whose such pattern glass board. Plant join general attack minute gas high a. Born might present space ok skin kind.,19:18:58,IMPS
KXSC67285952600921,GB64WRNU86151136321109,1/28/2017,32975.38,100002,Y,Groceries,EDGE,POS,Dr,20:40:02,28:23:24,11/14/2019,99060473,353.32,2,"Walk wall your offer magazine. Person fine clearly agency control science why. Bed option board hair raise course. Share director star avoid free inside type necessary.
Certainly ability site low.",23:11:14,IMPS
KXSC67285952600921,GB64WRNU86151136321109,1/28/2017,34174.85,100002,N,Credited,FF,MOBILE,Cr,7:44:00,8:52:08,11/20/2019,18328240,1199.47,4,"Impact big election senior play role begin. Special perhaps whole defense out administration else.
Quite exactly produce memory reflect drive memory ok.",8:20:27,UPI
KXSC67285952600921,GB64WRNU86151136321109,1/28/2017,32975.38,100002,Y,Transportation,FF,PC,Dr,10:48:43,12:27:06,11/20/2019,75922566,1199.47,2,"Last way by state yourself. Town season look national gun any simple.
Concern box world let. Place beat ahead stuff. Couple machine central.",11:45:50,IMPS
KXSC67285952600921,GB64WRNU86151136321109,1/28/2017,31775.91,100002,Y,Dining,SAFARI,MOBILE,Dr,15:41:07,18:22:02,11/20/2019,59311171,1199.47,7,"Cost in seat. Toward southern history.
Mrs article until. His structure good indicate help financial explain. Foreign take see certain land live. Along performance catch.",17:03:35,DD
KXSC67285952600921,GB64WRNU86151136321109,1/28/2017,32975.38,100002,N,Credited,SAFARI,POS,Cr,20:46:24,22:10:51,11/20/2019,75104269,1199.47,4,"Small sign model arm bed treat strategy. Continue shoulder activity develop though dark ok.
Else memory girl agreement. Give professor raise area hour across.",21:31:41,UPI
KXSC67285952600921,GB64WRNU86151136321109,1/28/2017,33790.78,100002,N,Credited,EDGE,PC,Cr,8:02:53,11:40:40,11/30/2019,11812517,815.4,7,"Hundred forward live catch lose. Type blue issue total can.
Pick song newspaper or go clearly black mission. More carry region property seven art organization. Hit add sport back gas.",10:40:24,DD
KXSC67285952600921,GB64WRNU86151136321109,1/28/2017,32975.38,100002,Y,Household Consumables,EDGE,MOBILE,Dr,11:00:00,14:16:34,11/30/2019,68516055,815.4,7,"Officer feeling reduce cultural actually window bar.
Fear his song but dark prepare process give.",12:42:41,DD
KXSC67285952600921,GB64WRNU86151136321109,1/28/2017,33790.78,100002,N,Credited,FF,MOBILE,Cr,20:01:39,21:59:34,11/30/2019,72535592,815.4,6,Wind mission some key ready. Region church throw.,21:00:40,CHEQUE
KXSC67285952600921,GB64WRNU86151136321109,1/28/2017,32807.24,100002,Y,Groceries,FF,MOBILE,Dr,11:25:01,16:47:48,12/4/2019,56367171,983.54,3,"Choose own ever accept man stand prevent. Several have husband watch career sport.
Money ten arm peace. Fill occur available past hospital provide about step. South stage society environment.",13:34:40,RTGS
KXSC67285952600921,GB64WRNU86151136321109,1/28/2017,31823.7,100002,Y,Dining,FF,PC,Dr,19:06:04,24:56:13,12/4/2019,24137836,983.54,4,"To way social campaign. Effort center former. Act Mr improve prove cold gas bar. Call hope article factor.
Her author until will.
Red few later your. All house style law year reach.",21:21:43,UPI
KXSC67285952600921,GB64WRNU86151136321109,1/28/2017,32819.28,100002,N,Credited,FF,PC,Cr,10:55:26,18:06:24,12/16/2019,23199064,995.58,6,"Center book yourself dark quality still. Word show though daughter cost. Professional term less hour. Among discover letter hold necessary.
Upon surface process article material. Wind less past more.",13:43:54,CHEQUE
KXSC67285952600921,GB64WRNU86151136321109,1/28/2017,34489.15,100002,N,Credited,CHROME,PC,Cr,3:18:52,5:12:55,12/23/2019,10223246,1669.87,2,"Night avoid not mention organization economy. Put investment surface even. Affect majority protect election investment look.
Possible better serve sit civil. Method democratic win lot effect myself.",4:21:58,IMPS
KXSC67285952600921,GB64WRNU86151136321109,1/28/2017,36159.02,100002,N,Credited,SAFARI,POS,Cr,6:46:21,8:38:53,12/23/2019,55692038,1669.87,5,"Action some night standard. Draw security term indeed.
In long send article feel quickly. Response ever off mother record. For get in single.",8:03:26,CARDS
KXSC67285952600921,GB64WRNU86151136321109,1/28/2017,34489.15,100002,Y,Dining,IE,POS,Dr,12:41:42,13:57:22,12/23/2019,25356953,1669.87,5,"Them degree picture yeah smile that on. Which know south these.
Face toward society style.
Discover sing since. Across still century attorney laugh company center. Long ten Congress anything trouble.",13:32:47,CARDS
KXSC67285952600921,GB64WRNU86151136321109,1/28/2017,32819.28,100002,Y,Utilities,EDGE,PC,Dr,16:42:14,19:14:13,12/23/2019,11600381,1669.87,2,"Professor present world appear above hard. Quality million team question worry.
Sort state service attack summer second. Image type parent value step.",17:17:10,IMPS
KXSC67285952600921,GB64WRNU86151136321109,1/28/2017,31149.41,100002,Y,Transportation,EDGE,POS,Dr,19:39:11,22:23:55,12/23/2019,79755672,1669.87,6,"Remember but economic first blood my. Time early else music sort talk author law. Reach able thank voice.
Major experience begin really more tree life hotel. Long day will leg. Movement anyone item.",20:47:58,CHEQUE
KXSC67285952600921,GB64WRNU86151136321109,1/28/2017,31473.83,100002,N,Credited,OPERA,POS,Cr,4:16:17,7:30:29,12/27/2019,85803060,324.42,2,"Use and always full major. As each past popular under.
Trip hotel so indeed I. Sea relationship these stock other call every.
Community upon share forget part.",5:56:22,IMPS
KXSC67285952600921,GB64WRNU86151136321109,1/28/2017,31149.41,100002,Y,Personal Care,OPERA,PC,Dr,8:30:35,9:59:42,12/27/2019,35020707,324.42,5,"Marriage role action area case. Politics American buy prevent wall.
Example order audience enjoy low explain develop player. Particular article another.",9:17:17,CARDS
KXSC67285952600921,GB64WRNU86151136321109,1/28/2017,31473.83,100002,N,Credited,CHROME,PC,Cr,14:14:46,16:21:56,12/27/2019,79997072,324.42,2,"Standard service car. Game animal win little discover itself.
Idea unit southern black special. Education song source support player tonight much say.",15:22:19,IMPS
KXSC67285952600921,GB64WRNU86151136321109,1/28/2017,31798.25,100002,N,Credited,OPERA,PC,Cr,17:55:31,19:55:32,12/27/2019,46817006,324.42,3,"Media thank wife somebody player level top. Author Mr teach fast voice.
Between final green recent capital voice. A Democrat war about ago leave interesting sit.",19:19:42,RTGS
KXSC67285952600921,GB64WRNU86151136321109,1/28/2017,31473.83,100002,Y,Personal Care,OPERA,POS,Dr,22:01:01,24:47:21,12/27/2019,77725295,324.42,7,Your early under early memory oil natural. Southern media week property likely quickly. Economy born traditional consumer ten responsibility attorney team. Left nice near important.,23:39:46,DD
KXSC67285952600921,GB64WRNU86151136321109,1/28/2017,32805.52,100002,N,Credited,CHROME,PC,Cr,7:25:27,13:12:18,1/7/2020,91482884,1331.69,4,Pm career decide. Be black blood charge. See address full keep employee. Approach yes rate ok.,9:45:28,UPI
KXSC67285952600921,GB64WRNU86151136321109,1/28/2017,34137.21,100002,N,Credited,CHROME,PC,Cr,15:20:38,17:27:58,1/7/2020,17976251,1331.69,7,"Candidate entire defense seat foot. Become read just beyond specific.
Enjoy science either listen. Product glass test PM world.",16:34:02,DD
KXSC67285952600921,GB64WRNU86151136321109,1/28/2017,34405.45,100002,N,Credited,EDGE,POS,Cr,12:26:13,22:53:55,1/16/2020,68280550,268.24,3,"Dinner people report they important. Degree middle include wait attention political ground own.
Ok prevent walk realize return resource. Character which feeling threat guess. So send country.",17:01:38,RTGS
KXSC67285952600921,GB64WRNU86151136321109,1/28/2017,35682.49,100002,N,Credited,CHROME,PC,Cr,5:24:03,7:37:46,1/21/2020,20786632,1277.04,2,"Through job total part adult rather surface.
Seat however southern through. Service most three generation west minute second.
Would around human specific. Final group raise everybody.",6:15:29,IMPS
KXSC67285952600921,GB64WRNU86151136321109,1/28/2017,36959.53,100002,N,Credited,SAFARI,POS,Cr,8:51:15,11:24:52,1/21/2020,10840757,1277.04,1,Seem special make hot policy high enough. A low it back. Concern section star analysis board environmental.,9:41:31,NEFT
KXSC67285952600921,GB64WRNU86151136321109,1/28/2017,35682.49,100002,Y,Groceries,CHROME,PC,Dr,11:55:19,14:52:06,1/21/2020,24093941,1277.04,3,Bill mind short man able someone music. Ability not town leader. Body summer director morning create. Result federal community suffer.,13:24:08,RTGS
KXSC67285952600921,GB64WRNU86151136321109,1/28/2017,34405.45,100002,Y,Household Consumables,CHROME,PC,Dr,17:53:56,19:38:57,1/21/2020,84914620,1277.04,2,Available leg fill trade week law reason certainly. Team although challenge bill turn action. Alone true fly side item ball peace.,19:10:32,IMPS
KXSC67285952600921,GB64WRNU86151136321109,1/28/2017,33128.41,100002,Y,Insurance,MI,PC,Dr,20:01:45,21:06:50,1/21/2020,51169930,1277.04,5,"Condition become must method hospital. Movement her work behavior dark head which.
Beat see lose citizen lay myself. Each crime make which example. Senior ok black lawyer.",20:39:03,CARDS
KXSC67285952600921,GB64WRNU86151136321109,1/28/2017,33099.6,100002,Y,Online Shopping,SAFARI,POS,Dr,9:54:30,14:38:33,2/4/2020,4530312,28.81,6,"Dark listen adult whom like. They half soon middle easy you or election.
Subject cell career human second. Record language against phone take similar speech exactly.",12:39:23,CHEQUE
KXSC67285952600921,GB64WRNU86151136321109,1/28/2017,33128.41,100002,N,Credited,FF,POS,Cr,17:11:01,20:48:49,2/4/2020,73289289,28.81,1,"Always the view fund include power act page. Election go factor evening southern economy admit. Work from practice management positive treat.
Pattern pass item quite.",18:59:05,NEFT
KXSC67285952600921,GB64WRNU86151136321109,1/28/2017,32948.85,100002,Y,Insurance,OPERA,POS,Dr,10:51:44,15:50:40,2/12/2020,13749859,179.56,6,Another training over lose total feeling. Event make clear analysis. Color Congress increase attack interest.,12:33:42,CHEQUE
KXSC67285952600921,GB64WRNU86151136321109,1/28/2017,33128.41,100002,N,Credited,SAFARI,POS,Cr,17:14:51,23:26:21,2/12/2020,21571169,179.56,3,"Everybody rest mother everyone. With return piece size leg sense.
Degree window baby. Own term agent job.
Environment traditional late maintain. News view use play writer huge.",19:33:01,RTGS
KXSC67285952600921,GB64WRNU86151136321109,1/28/2017,33485.67,100002,N,Credited,EDGE,PC,Cr,12:12:55,17:03:46,2/22/2020,93056960,357.26,4,"Hit necessary film Mr. American figure hard there. Start beyond describe.
Mind tonight carry force water. Top daughter someone instead also soon value.",13:28:03,UPI
KXSC67285952600921,GB64WRNU86151136321109,1/28/2017,33842.93,100002,N,Credited,SAFARI,MOBILE,Cr,19:56:07,25:54:14,2/22/2020,18497311,357.26,2,Test just you no seat indeed player. Agreement close main research. View improve attack star close you.,22:12:33,IMPS
KXSC67285952600921,GB64WRNU86151136321109,1/28/2017,34911.37,100002,N,Credited,SAFARI,PC,Cr,4:56:08,6:44:43,2/29/2020,83734779,1068.44,4,"Position film prevent civil including organization explain. Hair past moment three teach.
Responsibility analysis put. Hand indicate loss can.",5:55:20,UPI
KXSC67285952600921,GB64WRNU86151136321109,1/28/2017,33842.93,100002,Y,Transportation,FF,PC,Dr,10:37:53,13:22:35,2/29/2020,93194860,1068.44,6,Unit stand draw party. Bit public bad study message. College drive to toward scientist our million. Control want condition soldier.,11:25:50,CHEQUE
KXSC67285952600921,GB64WRNU86151136321109,1/28/2017,34911.37,100002,N,Credited,MI,POS,Cr,14:50:07,17:42:13,2/29/2020,948449,1068.44,6,"Follow natural TV market though point. Special method run each sometimes personal meeting. Represent thought this radio. Third scientist although.
Child company every smile nature poor mind.",15:25:57,CHEQUE
KXSC67285952600921,GB64WRNU86151136321109,1/28/2017,35979.81,100002,N,Credited,EDGE,MOBILE,Cr,19:03:19,22:35:46,2/29/2020,44981020,1068.44,2,"Sound TV suffer people blue brother themselves.
All once business blue pretty strong. Big source end pick west alone. System such various total gun view color.",21:22:45,IMPS
KXSC67285952600921,GB64WRNU86151136321109,1/28/2017,37499.26,100002,N,Credited,IE,PC,Cr,8:11:43,9:49:31,3/1/2020,97464792,1519.45,7,"You particularly exactly even put. Car easy live defense act. Light more late message.
Miss west course science need garden. Stage voice anyone offer.",9:10:50,DD
KXSC67285952600921,GB64WRNU86151136321109,1/28/2017,39018.71,100002,N,Credited,EDGE,MOBILE,Cr,9:28:42,12:20:12,3/1/2020,54900714,1519.45,3,"Into listen wish fund subject game truth throw. Add call operation determine energy. Wife but understand science.
Water choose summer simply over affect. Child despite heart represent hot rate heart.",10:03:11,RTGS
KXSC67285952600921,GB64WRNU86151136321109,1/28/2017,37499.26,100002,Y,Transportation,EDGE,MOBILE,Dr,12:33:39,17:12:13,3/1/2020,33277561,1519.45,7,"Determine top push whatever. Serious key letter. Able ask central allow onto could.
Themselves skill I hundred knowledge. Who adult leader goal current something two sea.",14:51:53,DD
KXSC67285952600921,GB64WRNU86151136321109,1/28/2017,35979.81,100002,Y,Utilities,CHROME,MOBILE,Dr,17:49:42,21:21:00,3/1/2020,47457256,1519.45,3,Win glass suggest process cost. Investment mission oil strong election. Prepare identify network attention ten.,19:54:02,RTGS
KXSC67285952600921,GB64WRNU86151136321109,1/28/2017,35335.59,100002,Y,Online Shopping,CHROME,POS,Dr,6:03:55,7:42:44,3/2/2020,9504226,644.22,7,"Personal summer how. A better middle cost.
Bank member view know. Wonder stuff interesting begin class. Hit bring yet majority large daughter tax.",6:52:37,DD
KXSC67285952600921,GB64WRNU86151136321109,1/28/2017,34691.37,100002,Y,Insurance,MI,MOBILE,Dr,8:11:00,9:40:51,3/2/2020,72041727,644.22,4,"Memory manager partner future party type. South lead create computer college herself. Or present cultural call after.
Story matter help case budget. Smile nature great certain plan again concern.",9:08:15,UPI
KXSC67285952600921,GB64WRNU86151136321109,1/28/2017,34047.15,100002,Y,Online Shopping,FF,PC,Dr,12:36:11,15:28:03,3/2/2020,7138737,644.22,6,"Follow easy piece specific notice situation.
Expert issue tell want. Economy within prove truth religious author. Stage address campaign law. Establish consider clear name call.",14:25:01,CHEQUE
KXSC67285952600921,GB64WRNU86151136321109,1/28/2017,33402.93,100002,Y,Online Shopping,MI,MOBILE,Dr,15:53:49,17:27:57,3/2/2020,66510956,644.22,4,Drug major difference indeed agree production. Similar high speech environmental national draw. Bill while total.,16:59:35,UPI
KXSC67285952600921,GB64WRNU86151136321109,1/28/2017,34047.15,100002,N,Credited,OPERA,PC,Cr,18:57:38,22:33:33,3/2/2020,7171628,644.22,1,Accept company Democrat parent establish American as. Certainly standard force box simply.,20:38:04,NEFT
KXSC67285952600921,GB64WRNU86151136321109,1/28/2017,34730.31,100002,N,Credited,SAFARI,POS,Cr,21:46:34,29:24:00,3/4/2020,65281093,683.16,6,"Impact should or apply culture machine back hospital. Up most stock even. Something suffer close culture program.
Act region tonight bring easy low. Sport answer rather participant how reach.",23:43:55,CHEQUE
KXSC67285952600921,GB64WRNU86151136321109,1/28/2017,32855.88,100002,Y,Online Shopping,EDGE,MOBILE,Dr,15:54:15,21:53:08,3/7/2020,98090051,1874.43,3,"Just professor central prove learn truth open.
Amount ask benefit south material beat rather. Point picture law president.",20:39:33,RTGS
KXSC67285952600921,GB64WRNU86151136321109,1/28/2017,33649.94,100002,N,Credited,OPERA,POS,Cr,5:24:48,8:29:39,3/14/2020,56526028,794.06,1,"Administration whose tax what off indicate recently. Between tree they. Positive plan result street standard land concern so.
Different include Republican young.",7:19:21,NEFT
KXSC67285952600921,GB64WRNU86151136321109,1/28/2017,32855.88,100002,Y,Personal Care,MI,PC,Dr,8:55:31,12:03:51,3/14/2020,5834303,794.06,2,"Stock become use as culture particular.
Inside degree clearly out his beautiful there. Church catch audience necessary star.",10:45:31,IMPS
KXSC67285952600921,GB64WRNU86151136321109,1/28/2017,32061.82,100002,Y,Rent,OPERA,PC,Dr,14:42:49,16:24:21,3/14/2020,93491082,794.06,6,Nothing cut another church. Move sister behind whose true financial you collection. Week poor natural need.,15:13:14,CHEQUE
KXSC67285952600921,GB64WRNU86151136321109,1/28/2017,32855.88,100002,N,Credited,FF,MOBILE,Cr,15:07:28,17:38:45,3/14/2020,24428781,794.06,5,Act wife me perhaps. Figure cost dream condition.,16:26:39,CARDS
KXSC67285952600921,GB64WRNU86151136321109,1/28/2017,33649.94,100002,N,Credited,OPERA,POS,Cr,21:29:59,23:32:53,3/14/2020,30407985,794.06,3,Staff one each per soon. Time resource for stop cause career. Prepare clearly have my administration goal matter.,22:56:01,RTGS
KXSC67285952600921,GB64WRNU86151136321109,1/28/2017,31715.68,100002,Y,Personal Care,OPERA,MOBILE,Dr,11:46:26,17:58:38,3/15/2020,90462948,1934.26,6,Pay business born whatever evening evidence. Southern husband evidence for pay. General case wall like miss. Itself much baby.,14:35:30,CHEQUE
KXSC67285952600921,GB64WRNU86151136321109,1/28/2017,33649.94,100002,N,Credited,IE,MOBILE,Cr,16:09:40,23:30:12,3/15/2020,95632964,1934.26,1,"Increase international brother. Have difference discuss late.
Card degree approach travel human great lose. Friend sea during song dog. Rather exist whose piece audience later house material.",19:48:44,NEFT
KXSC67285952600921,GB64WRNU86151136321109,1/28/2017,33230,100002,Y,Groceries,SAFARI,MOBILE,Dr,5:01:29,7:39:28,3/18/2020,95714684,419.94,3,"Yeah what go maintain stock must huge. Political quality say she artist police.
Your current always. What only herself rest once.",5:49:33,RTGS
KXSC67285952600921,GB64WRNU86151136321109,1/28/2017,32810.06,100002,Y,Dining,MI,PC,Dr,10:23:19,12:08:04,3/18/2020,90049668,419.94,7,Age toward community pass child job quite. Line probably receive.,11:03:37,DD
KXSC67285952600921,GB64WRNU86151136321109,1/28/2017,32390.12,100002,Y,Dining,OPERA,POS,Dr,11:08:17,13:29:20,3/18/2020,8192639,419.94,1,"Behind those not whether summer. Wrong eight call point experience. As he close.
Together short act him. Recognize mission they necessary expert heart green.",12:36:17,NEFT
KXSC67285952600921,GB64WRNU86151136321109,1/28/2017,32810.06,100002,N,Credited,MI,POS,Cr,18:20:35,20:47:53,3/18/2020,38025792,419.94,5,"Nature pull fact laugh hour most commercial. Doctor learn both sit rock. Fire wife west writer.
Decide source low black. Father too president these. State meet hear benefit machine body.",19:11:09,CARDS
KXSC67285952600921,GB64WRNU86151136321109,1/28/2017,33230,100002,N,Credited,IE,PC,Cr,19:23:49,22:56:25,3/18/2020,17601894,419.94,1,"More toward put game. Red concern form step upon.
Explain either act save away. Couple father positive oil garden town simple responsibility. Finally tough kitchen onto figure where.",21:02:55,NEFT
KXSC67285952600921,GB64WRNU86151136321109,1/28/2017,34837.18,100002,N,Credited,EDGE,MOBILE,Cr,18:38:15,24:32:37,3/22/2020,46579881,1607.18,7,"Any affect serious question TV pick form test. Fine control which identify born.
Camera consider worker either social either end. Pm education question general. Charge station break set nature price.",20:48:37,DD
KXSC67285952600921,GB64WRNU86151136321109,1/28/2017,32926.85,100002,Y,Groceries,MI,POS,Dr,14:59:31,21:14:20,3/28/2020,75383770,1910.33,6,"Huge show notice center attention Congress less. Summer agreement begin later.
Office police audience keep career four save pass. Return series purpose place.",19:00:20,CHEQUE
KXSC67285952600921,GB64WRNU86151136321109,1/28/2017,33252.54,100002,N,Credited,SAFARI,PC,Cr,3:25:50,5:48:03,3/31/2020,72342879,325.69,2,"Site ask more life toward. Popular interview fire statement hope goal.
Everybody rule beyond serve sea.",4:19:06,IMPS
KXSC67285952600921,GB64WRNU86151136321109,1/28/2017,32926.85,100002,Y,Medicals,CHROME,POS,Dr,10:12:05,11:22:42,3/31/2020,5536948,325.69,3,South four ahead where threat any. Together friend together be ago everybody.,10:39:51,RTGS
KXSC67285952600921,GB64WRNU86151136321109,1/28/2017,32601.16,100002,Y,Insurance,SAFARI,POS,Dr,12:58:31,15:55:48,3/31/2020,95734118,325.69,5,"Or treat ahead. Mind hundred imagine lead once man.
Travel ball interview particularly occur. Try lot type if shoulder food.",14:51:43,CARDS
KXSC67285952600921,GB64WRNU86151136321109,1/28/2017,32275.47,100002,Y,Dining,MI,POS,Dr,18:30:36,20:01:42,3/31/2020,359375,325.69,5,"Note world mission off evening also. Throw interview American range seem author.
Local Democrat history expert left. Brother majority class treatment understand house.",19:15:28,CARDS
KXSC67285952600921,GB64WRNU86151136321109,1/28/2017,31949.78,100002,Y,Dining,FF,MOBILE,Dr,20:00:51,23:08:24,3/31/2020,82833169,325.69,3,"Must four make town general tough up. Man most player start rest only.
Phone alone hand staff sea former be. Sound discover throughout if debate. Star there several against.",21:36:01,RTGS
KXSC67285952600921,GB64WRNU86151136321109,1/28/2017,30463.84,100002,Y,Rent,OPERA,PC,Dr,7:07:00,10:20:24,4/21/2020,24675352,1485.94,2,Despite positive show challenge event anything leg. Any such country whom success beat. Power guy along set any.,8:44:02,IMPS
KXSC67285952600921,GB64WRNU86151136321109,1/28/2017,28977.9,100002,Y,Personal Care,SAFARI,POS,Dr,14:17:57,18:02:23,4/21/2020,89182758,1485.94,1,"List watch budget six. Space probably leg him. Clearly main artist hundred.
Coach ever if business person turn. Very both long establish majority as fund per. Bag gun main Congress event.",16:20:52,NEFT
KXSC67285952600921,GB64WRNU86151136321109,1/28/2017,28934.88,100002,Y,Utilities,SAFARI,POS,Dr,6:24:14,9:32:26,4/24/2020,42818564,43.02,4,Hard himself write give decide face anything dinner. Late special administration coach also character.,8:01:48,UPI
KXSC67285952600921,GB64WRNU86151136321109,1/28/2017,28891.86,100002,Y,Household Consumables,OPERA,PC,Dr,17:09:35,22:18:02,4/24/2020,12505692,43.02,3,"Question standard practice. Your itself turn tell.
Treat visit space even political. Also choose that participant friend.",20:19:54,RTGS
KXSC67285952600921,GB64WRNU86151136321109,1/28/2017,29837.26,100002,N,Credited,SAFARI,POS,Cr,8:19:15,9:54:21,5/1/2020,82914110,945.4,5,"Small child art long last bank son. Everyone area green society will listen a say.
Thought pick of yes his east where. Cover cover development ground wife.",8:55:16,CARDS
KXSC67285952600921,GB64WRNU86151136321109,1/28/2017,30782.66,100002,N,Credited,CHROME,POS,Cr,9:45:24,12:28:55,5/1/2020,19060361,945.4,5,"Loss environmental husband line check.
Performance worker my your any sound. Not laugh hand support suddenly.",11:36:30,CARDS
KXSC67285952600921,GB64WRNU86151136321109,1/28/2017,31728.06,100002,N,Credited,SAFARI,MOBILE,Cr,15:41:40,18:17:04,5/1/2020,73706960,945.4,1,"Politics entire together manager research. Rock music machine training. Front that step gun.
Tonight foreign charge civil. Center quality step.",17:02:09,NEFT
KXSC67285952600921,GB64WRNU86151136321109,1/28/2017,32673.46,100002,N,Credited,SAFARI,POS,Cr,20:09:52,22:40:24,5/1/2020,7262111,945.4,2,Social director blood mouth. Put time cultural dark. Full letter can heart. Human let dream score source reduce measure official.,21:01:41,IMPS
KXSC67285952600921,GB64WRNU86151136321109,1/28/2017,33499.74,100002,N,Credited,FF,MOBILE,Cr,6:42:16,9:09:03,5/4/2020,35622758,826.28,3,Late simple our statement wrong. Could suddenly end method. Stay interest kitchen shake arm worry PM. Themselves yet nice much account similar.,7:21:54,RTGS
KXSC67285952600921,GB64WRNU86151136321109,1/28/2017,32673.46,100002,Y,Utilities,MI,MOBILE,Dr,11:46:35,15:00:18,5/4/2020,27310687,826.28,2,"Food north similar music season. Level save generation green design month. Between dog black cause project but heavy.
Energy word she investment. Campaign next change.",13:21:00,IMPS
KXSC67285952600921,GB64WRNU86151136321109,1/28/2017,33499.74,100002,N,Credited,EDGE,PC,Cr,22:04:16,25:38:00,5/4/2020,80083405,826.28,3,"Wide network cut successful. Discussion evening race pretty per study five.
Create local generation senior degree right. Answer smile town begin particular beautiful.",23:30:59,RTGS
KXSC67285952600921,GB64WRNU86151136321109,1/28/2017,34370.64,100002,N,Credited,FF,POS,Cr,13:42:25,23:32:23,5/17/2020,48360623,870.9,3,Choice child of well memory. Base including quite ago choose. Compare billion practice little else.,19:26:32,RTGS
KXSC67285952600921,GB64WRNU86151136321109,1/28/2017,34392.65,100002,N,Credited,EDGE,PC,Cr,3:25:51,5:17:25,5/19/2020,92299641,22.01,5,"Whatever risk seven challenge stay store matter. Actually especially low than treatment war.
Guy later wait performance authority. Upon push happen unit off defense. Step between deep piece.",4:22:28,CARDS
KXSC67285952600921,GB64WRNU86151136321109,1/28/2017,34370.64,100002,Y,Groceries,SAFARI,POS,Dr,9:54:56,12:09:10,5/19/2020,17627818,22.01,6,"Yeah federal well. According despite line next decade word enjoy. Most moment or on.
Easy us including state firm country. Executive why watch position author true. Use baby act eye middle sport.",10:59:43,CHEQUE
KXSC67285952600921,GB64WRNU86151136321109,1/28/2017,34392.65,100002,N,Credited,MI,MOBILE,Cr,13:32:16,16:38:02,5/19/2020,37929251,22.01,1,"Decide same still affect. So matter edge beyond worker share.
Save event plant how song staff. Beat organization help business young us word.",14:49:09,NEFT
KXSC67285952600921,GB64WRNU86151136321109,1/28/2017,34370.64,100002,Y,Rent,IE,MOBILE,Dr,17:48:18,19:41:38,5/19/2020,99279653,22.01,5,"Main prevent space health account.
Assume million inside society month network between. Employee attention wait threat end. Get will somebody only.",18:30:39,CARDS
KXSC67285952600921,GB64WRNU86151136321109,1/28/2017,34348.63,100002,Y,Medicals,MI,POS,Dr,20:48:37,23:52:52,5/19/2020,78771116,22.01,5,"Give thank near keep product visit.
Must manage occur six contain side natural. Loss indeed interview hospital top might receive indeed.",22:14:38,CARDS
KXSC67285952600921,GB64WRNU86151136321109,1/28/2017,34614.86,100002,N,Credited,EDGE,PC,Cr,19:14:38,26:18:49,5/22/2020,55279123,266.23,7,"Field heart both partner down. When rich home eye factor fill race.
You throw open east up area. Agree hotel daughter air hour short boy. Class the whether chair.",21:53:31,DD
KXSC67285952600921,GB64WRNU86151136321109,1/28/2017,33042.01,100002,Y,Groceries,OPERA,POS,Dr,16:18:18,24:01:07,5/24/2020,37189280,1572.85,3,"Health pressure church. Issue policy age cold present idea around character. Pick want spring cut boy defense.
Final event seek direction. Ask most since red.",20:47:35,RTGS
KXSC67285952600921,GB64WRNU86151136321109,1/28/2017,34400.74,100002,N,Credited,EDGE,MOBILE,Cr,8:59:19,12:16:20,5/31/2020,30648807,1358.73,4,Read face stop quality style. Strategy member tough son recognize process compare. Miss while win new something risk.,10:07:09,UPI
KXSC67285952600921,GB64WRNU86151136321109,1/28/2017,33042.01,100002,Y,Insurance,CHROME,POS,Dr,15:55:02,19:47:20,5/31/2020,74978656,1358.73,7,Audience idea interest price enter everybody everyone. Contain performance evidence. Idea next rest trial born investment five. Hard chance such program drug issue.,17:54:21,DD
KXSC67285952600921,GB64WRNU86151136321109,1/28/2017,34400.74,100002,N,Credited,IE,PC,Cr,22:19:50,25:25:43,5/31/2020,69087806,1358.73,4,Individual generation success sometimes. Sure college large all paper some lot. Evening our want why.,22:56:16,UPI
KXSC67285952600921,GB64WRNU86151136321109,1/28/2017,35807.2,100002,N,Credited,MI,PC,Cr,8:27:57,11:57:41,6/1/2020,91013316,1406.46,3,"Hour certainly son new bank. Reason street training society cost whom. Five find onto produce stage. Table moment law.
Son word computer performance me shake down billion. Type next build role.",10:05:07,RTGS
KXSC67285952600921,GB64WRNU86151136321109,1/28/2017,34400.74,100002,Y,Insurance,EDGE,POS,Dr,11:06:41,14:54:12,6/1/2020,17660044,1406.46,1,Law summer hold ground trial everybody. Family community quality eye else cold public side. Finish among myself factor build identify anything.,13:46:51,NEFT
KXSC67285952600921,GB64WRNU86151136321109,1/28/2017,32994.28,100002,Y,Entertainment,SAFARI,MOBILE,Dr,21:40:10,24:02:42,6/1/2020,59743361,1406.46,1,During free office general. Shake both decide able represent staff. National attorney PM attention sound right.,22:58:19,NEFT
KXSC67285952600921,GB64WRNU86151136321109,1/28/2017,33422.65,100002,N,Credited,MI,POS,Cr,5:33:43,9:05:18,6/4/2020,74991617,428.37,6,Information training little wait research. Speech couple agency operation every. Society can crime ability drop foot.,6:57:03,CHEQUE
KXSC67285952600921,GB64WRNU86151136321109,1/28/2017,33851.02,100002,N,Credited,OPERA,POS,Cr,11:26:14,14:11:03,6/4/2020,42356332,428.37,3,"Glass throw raise seem as lawyer. Long better lead win religious popular. Hope work hold other.
Home education doctor. Teach break sport.
Present contain between TV region tend. Minute arm such sell.",12:47:29,RTGS
KXSC67285952600921,GB64WRNU86151136321109,1/28/2017,33422.65,100002,Y,Dining,FF,MOBILE,Dr,18:38:14,24:31:40,6/4/2020,70927658,428.37,2,"War hair space watch size similar. Also see myself nearly might budget miss off. Relate real tree threat career dog never.
Same home girl ask appear. Reason hard sell.",21:36:41,IMPS
KXSC67285952600921,GB64WRNU86151136321109,1/28/2017,33679.76,100002,N,Credited,IE,PC,Cr,15:27:23,26:34:51,6/8/2020,92058392,257.11,4,"Research environmental child sometimes really. Home must remain movement Mrs world.
Apply year price especially meet by me. Direction image behind general them language international.",21:20:50,UPI
KXSC67285952600921,GB64WRNU86151136321109,1/28/2017,33165.63,100002,Y,Entertainment,SAFARI,PC,Dr,17:47:34,26:58:10,6/17/2020,28375043,514.13,3,Discover care others that particularly manage water. Have get administration long every success.,23:04:41,RTGS
KXSC67285952600921,GB64WRNU86151136321109,1/28/2017,34700.57,100002,N,Credited,OPERA,MOBILE,Cr,19:37:38,26:35:55,6/23/2020,26049298,1534.94,3,"Enter quickly reflect agreement effect security past.
No these left far reduce. Onto agency like church station various. Cover business somebody capital those note.",22:14:16,RTGS
KXSC67285952600921,GB64WRNU86151136321109,1/28/2017,34979.23,100002,N,Credited,EDGE,PC,Cr,8:30:34,11:46:56,6/25/2020,35365020,278.66,3,"Successful couple difficult tend to suddenly.
Around go last moment gun return foot. Energy whom include Mrs still he anyone.",10:32:19,RTGS
KXSC67285952600921,GB64WRNU86151136321109,1/28/2017,35257.89,100002,N,Credited,IE,MOBILE,Cr,10:19:30,13:40:33,6/25/2020,11428756,278.66,6,"Firm foreign fill ground remember. Improve black ground. Program test speech light rather.
Service operation operation recent spend head nature. Color security only true.",12:04:51,CHEQUE
KXSC67285952600921,GB64WRNU86151136321109,1/28/2017,34979.23,100002,Y,Personal Care,FF,MOBILE,Dr,21:27:31,25:13:59,6/25/2020,76157295,278.66,7,"Set manager either investment. Me business process treat growth hot.
Without again with born work. If claim consumer space.",23:49:50,DD
KXSC67285952600921,GB64WRNU86151136321109,1/28/2017,36497.74,100002,N,Credited,SAFARI,POS,Cr,9:42:08,17:38:35,7/6/2020,60298966,1518.51,6,"Wonder writer commercial body. Too concern boy watch.
Area wish interesting among. Morning together professor entire movie else.",15:17:35,CHEQUE
KXSC67285952600921,GB64WRNU86151136321109,1/28/2017,37112.22,100002,N,Credited,OPERA,POS,Cr,3:41:47,7:29:56,7/13/2020,37833367,614.48,2,"Nearly himself shoulder total past instead floor. Reason direction dinner nature character think sit. Least under my some each out.
Glass shoulder role. Condition analysis decide television.",5:23:17,IMPS
KXSC67285952600921,GB64WRNU86151136321109,1/28/2017,36497.74,100002,Y,Insurance,MI,PC,Dr,9:58:11,13:43:38,7/13/2020,30936669,614.48,7,"Adult will mother arrive. Owner simple step. All the than city.
Machine develop everybody left skill. It interesting you store lot.
Do job avoid big knowledge court tell.",11:55:17,DD
KXSC67285952600921,GB64WRNU86151136321109,1/28/2017,35883.26,100002,Y,Rent,FF,PC,Dr,14:08:24,16:45:32,7/13/2020,68349707,614.48,4,"Color run because customer decide. Respond it we sell begin. Design now thank officer several.
Cut across full interview southern watch. Bill doctor reduce color.",14:46:42,UPI
KXSC67285952600921,GB64WRNU86151136321109,1/28/2017,36497.74,100002,N,Credited,OPERA,POS,Cr,17:56:55,20:33:01,7/13/2020,49435108,614.48,5,"Out smile shoulder safe with. Generation collection factor defense nature perform. Him cold low energy stock.
Day big news church.",20:03:05,CARDS
KXSC67285952600921,GB64WRNU86151136321109,1/28/2017,38490.92,100002,N,Credited,IE,POS,Cr,3:37:26,6:09:11,7/17/2020,79969581,1993.18,1,Once pass single kind. Upon book society character visit. Adult assume happy discussion. Worry represent cut deal trade choice indicate.,4:39:16,NEFT
KXSC67285952600921,GB64WRNU86151136321109,1/28/2017,36497.74,100002,Y,Transportation,EDGE,MOBILE,Dr,8:05:44,10:05:30,7/17/2020,42524557,1993.18,2,Green any operation keep program relate candidate. Available see decide operation avoid factor local. Build step parent raise attention really maintain.,8:48:00,IMPS
KXSC67285952600921,GB64WRNU86151136321109,1/28/2017,38490.92,100002,N,Credited,SAFARI,POS,Cr,14:20:49,16:04:43,7/17/2020,18448580,1993.18,2,State as participant continue attention happen. Certainly identify interview help. Positive lot special decision understand spend.,15:37:27,IMPS
KXSC67285952600921,GB64WRNU86151136321109,1/28/2017,40484.1,100002,N,Credited,IE,MOBILE,Cr,18:06:57,20:34:42,7/17/2020,66809470,1993.18,1,Nearly music watch study statement improve. Best school unit particularly fill through.,19:10:12,NEFT
KXSC67285952600921,GB64WRNU86151136321109,1/28/2017,42477.28,100002,N,Credited,FF,PC,Cr,20:12:32,21:56:14,7/17/2020,76717093,1993.18,1,"Without computer mind factor. Ask under western consider million television reveal.
Section authority until power. Bit common break daughter person husband science house.",21:22:55,NEFT
KXSC67285952600921,GB64WRNU86151136321109,1/28/2017,43490.55,100002,N,Credited,OPERA,POS,Cr,10:24:40,16:35:51,7/18/2020,59848080,1013.27,3,"Seem fight present develop western pressure usually. Reveal some responsibility trial necessary population north.
Bed try beautiful his. Cut Congress environmental very.",15:08:49,RTGS
KXSC67285952600921,GB64WRNU86151136321109,1/28/2017,42243.94,100002,Y,Utilities,OPERA,MOBILE,Dr,8:02:17,10:38:10,7/23/2020,63588064,1246.61,4,"Arrive want floor spring own again. Such now nice medical main.
Along major remember point wrong air. Him probably plan eight.",9:28:27,UPI
KXSC67285952600921,GB64WRNU86151136321109,1/28/2017,43490.55,100002,N,Credited,FF,PC,Cr,9:30:43,12:00:12,7/23/2020,26708874,1246.61,1,Indeed our smile area class measure. Stop gun firm. Home before civil every population issue foreign turn.,10:25:51,NEFT
KXSC67285952600921,GB64WRNU86151136321109,1/28/2017,44737.16,100002,N,Credited,FF,POS,Cr,14:25:50,15:48:26,7/23/2020,46774606,1246.61,4,Mr customer newspaper last. Along girl appear accept she spend officer. Fund tax different military.,15:01:16,UPI
KXSC67285952600921,GB64WRNU86151136321109,1/28/2017,43490.55,100002,Y,Transportation,MI,PC,Dr,17:26:12,21:05:55,7/23/2020,21419430,1246.61,6,"Stage model see teach best space. Finish kitchen decide opportunity fund. Quality when clear same poor.
Democratic live feel believe maybe.",19:16:18,CHEQUE
KXSC67285952600921,GB64WRNU86151136321109,1/28/2017,42848.31,100002,Y,Utilities,IE,POS,Dr,21:04:26,27:56:13,7/29/2020,75089672,642.24,6,"Organization consumer policy. Receive debate process central minute. Police employee career.
Off which suffer. Power music by community another next.",22:16:46,CHEQUE
KXSC67285952600921,GB64WRNU86151136321109,1/28/2017,42142.91,100002,Y,Household Consumables,CHROME,MOBILE,Dr,6:38:33,13:47:34,8/1/2020,22881632,705.4,5,"Above suddenly let central because oil example type. Term unit bag rest spend than.
Traditional through share dog.
There table detail.",12:26:51,CARDS
KXSC67285952600921,GB64WRNU86151136321109,1/28/2017,41343.64,100002,Y,Insurance,FF,MOBILE,Dr,7:51:25,11:42:05,8/11/2020,21084232,799.27,5,Inside decision light talk stage kid again. Key traditional also top. Feel life work though read learn. Help for son main together case share.,9:07:18,CARDS
KXSC67285952600921,GB64WRNU86151136321109,1/28/2017,42142.91,100002,N,Credited,OPERA,MOBILE,Cr,11:21:56,14:09:45,8/11/2020,91042019,799.27,5,Short best list heart suffer. Seven herself pay check prove. Mother important view senior save.,12:01:41,CARDS
KXSC67285952600921,GB64WRNU86151136321109,1/28/2017,41343.64,100002,Y,Online Shopping,OPERA,PC,Dr,19:39:16,23:31:02,8/11/2020,93954549,799.27,3,"Model entire able. Outside through let me guess always.
Education design night carry term. Real guess leader nearly piece. Lead may who product window.",22:36:55,RTGS
KXSC67285952600921,GB64WRNU86151136321109,1/28/2017,41750.11,100002,N,Credited,EDGE,PC,Cr,5:56:32,9:59:56,8/16/2020,3994122,406.47,4,"Couple beat structure thing hour door resource major. Fly summer near house.
Heart weight choose cup room knowledge brother. Thousand sister dark thing will cause they.",7:45:33,UPI
KXSC67285952600921,GB64WRNU86151136321109,1/28/2017,42156.58,100002,N,Credited,IE,MOBILE,Cr,13:30:32,17:32:58,8/16/2020,92842557,406.47,3,"Teacher certainly activity board later need it guess. Staff campaign positive weight wonder officer.
Kid agency dark.",14:45:29,RTGS
KXSC67285952600921,GB64WRNU86151136321109,1/28/2017,41750.11,100002,Y,Personal Care,SAFARI,POS,Dr,18:37:09,21:47:59,8/16/2020,95453620,406.47,6,"Million respond organization camera near. Rate newspaper report prepare degree.
Study laugh upon. Election pay control financial just as something. Book to would until answer job loss.",20:36:40,CHEQUE
KXSC67285952600921,GB64WRNU86151136321109,1/28/2017,40485.98,100002,Y,Medicals,FF,POS,Dr,3:47:14,6:08:38,8/18/2020,77233523,1264.13,5,Firm able old shake continue. Him executive population other campaign point value. Beautiful heavy Mr under be I whose him.,4:57:21,CARDS
KXSC67285952600921,GB64WRNU86151136321109,1/28/2017,39221.85,100002,Y,Transportation,MI,PC,Dr,9:47:26,12:14:23,8/18/2020,16196353,1264.13,6,"Rule court adult first final. Risk leg about likely charge sport lot budget.
Nice long care trial room shake. Picture east half its than former finally.",11:03:57,CHEQUE
KXSC67285952600921,GB64WRNU86151136321109,1/28/2017,37957.72,100002,Y,Groceries,MI,PC,Dr,15:30:43,17:51:19,8/18/2020,94993318,1264.13,5,Decision campaign rate exactly young laugh. Dog job article pretty entire keep take. On reflect significant impact concern.,16:45:33,CARDS
KXSC67285952600921,GB64WRNU86151136321109,1/28/2017,39221.85,100002,N,Credited,IE,MOBILE,Cr,20:29:17,22:46:50,8/18/2020,40117195,1264.13,6,"Go read number general. Apply see discussion send line.
Feeling magazine ahead today. But anyone rich.
Watch per may Mrs.",21:53:07,CHEQUE
KXSC67285952600921,GB64WRNU86151136321109,1/28/2017,38086.22,100002,Y,Utilities,OPERA,MOBILE,Dr,2:49:36,6:42:15,8/21/2020,54674349,1135.63,7,Order upon alone. And center down husband court this woman. Mean science eight.,4:49:06,DD
KXSC67285952600921,GB64WRNU86151136321109,1/28/2017,36950.59,100002,Y,Personal Care,CHROME,POS,Dr,6:51:00,9:22:17,8/21/2020,26481227,1135.63,2,"Tax rate yeah. Seem able yet simply shake cause laugh admit.
Interview figure family grow. Such will focus learn. Game include organization past if.",8:25:43,IMPS
KXSC67285952600921,GB64WRNU86151136321109,1/28/2017,35814.96,100002,Y,Online Shopping,SAFARI,POS,Dr,11:40:45,13:05:13,8/21/2020,65224366,1135.63,1,"Safe can only. Discussion lawyer set up song today factor. Store investment direction cup several make.
Few step draw order idea upon family. Form after upon. Window Republican office.",12:20:37,NEFT
KXSC67285952600921,GB64WRNU86151136321109,1/28/2017,34679.33,100002,Y,Utilities,MI,POS,Dr,16:12:43,18:23:51,8/21/2020,51445713,1135.63,3,Hot I region watch see certainly prove forget. Record of nice recognize his approach store. Keep yourself add direction factor particularly.,17:44:19,RTGS
KXSC67285952600921,GB64WRNU86151136321109,1/28/2017,33543.7,100002,Y,Groceries,OPERA,PC,Dr,20:02:03,21:26:06,8/21/2020,7187148,1135.63,6,"Sign dinner mouth mention tough without list Republican. Million various finish story.
Reduce live order. Pm size want wife land get sport. Second section politics.",20:58:49,CHEQUE
KXSC67285952600921,GB64WRNU86151136321109,1/28/2017,32717.98,100002,Y,Medicals,EDGE,MOBILE,Dr,7:59:56,11:50:14,8/22/2020,10718360,825.72,6,"Control sit about although both. Gas face show dream its.
Add push draw art again. Strategy organization require hundred area for car.
Space firm be system miss meeting. Too keep expect away.",8:59:10,CHEQUE
KXSC67285952600921,GB64WRNU86151136321109,1/28/2017,33543.7,100002,N,Credited,EDGE,PC,Cr,13:22:24,16:53:24,8/22/2020,95772776,825.72,6,"Sing four reality doctor democratic we resource.
This company edge when just process not. Figure parent relationship some.
About left pay production. Plant sport strategy center contain.",15:17:09,CHEQUE
KXSC67285952600921,GB64WRNU86151136321109,1/28/2017,32717.98,100002,Y,Medicals,SAFARI,PC,Dr,17:31:35,19:58:32,8/22/2020,52776649,825.72,7,War together head heavy that. Student well seek manager garden however.,18:41:16,DD
KXSC67285952600921,GB64WRNU86151136321109,1/28/2017,31172.37,100002,Y,Insurance,MI,POS,Dr,6:19:45,10:05:20,8/24/2020,65310267,1545.61,3,"Of serious about because head. Able skin animal employee. Wide likely item.
Us conference this popular for offer. Particularly red become nature choice. Whole couple all drop.",7:52:52,RTGS
KXSC67285952600921,GB64WRNU86151136321109,1/28/2017,32717.98,100002,N,Credited,IE,PC,Cr,14:50:31,16:39:57,8/24/2020,49336849,1545.61,5,"Enough keep myself. Attention hair arm without miss team according. Special should near view effect buy.
Of reason dream. Identify now try. While ago hundred again sit general.",15:26:52,CARDS
KXSC67285952600921,GB64WRNU86151136321109,1/28/2017,34263.59,100002,N,Credited,MI,PC,Cr,21:34:44,25:17:55,8/24/2020,11160816,1545.61,3,"Say apply detail outside himself. Personal really exist sign show must item age.
Current mind around its room. Within task avoid.
Six treat sense spend year. Size threat describe popular wind.",22:39:17,RTGS
KXSC67285952600921,GB64WRNU86151136321109,1/28/2017,34360.67,100002,N,Credited,IE,MOBILE,Cr,5:29:01,11:54:30,8/26/2020,34660775,97.08,3,Necessary adult main beat audience human industry.,8:28:59,RTGS
KXSC67285952600921,GB64WRNU86151136321109,1/28/2017,34263.59,100002,Y,Transportation,MI,PC,Dr,17:40:00,22:59:17,8/26/2020,16638372,97.08,3,"Check tell take standard risk much. Subject move various key. Several rule little bit someone.
Decision test report agent like ahead. Case head push him himself right politics weight.",20:38:21,RTGS
KXSC67285952600921,GB64WRNU86151136321109,1/28/2017,34093.35,100002,Y,Entertainment,FF,POS,Dr,11:44:18,19:22:21,8/27/2020,53746757,170.24,7,"Fact strong defense PM technology plant summer. Decide fine where discover hope.
Mouth drop finally. Nation yeah teach cell.",14:15:33,DD
KXSC67285952600921,GB64WRNU86151136321109,1/28/2017,33718.8,100002,Y,Dining,CHROME,PC,Dr,6:47:39,9:53:28,9/3/2020,46013200,374.55,1,Consumer build put middle rest girl government. Put author wonder cultural. Local page bank back party.,9:06:23,NEFT
KXSC67285952600921,GB64WRNU86151136321109,1/28/2017,34093.35,100002,N,Credited,SAFARI,POS,Cr,12:05:53,16:25:05,9/3/2020,19964089,374.55,1,"Director cold official shake. Possible marriage laugh although.
Economy mouth central country ahead huge. Trip someone at within. Congress agency card ten throughout.",14:57:59,NEFT
KXSC67285952600921,GB64WRNU86151136321109,1/28/2017,34467.9,100002,N,Credited,SAFARI,PC,Cr,21:20:48,23:15:15,9/3/2020,25705546,374.55,3,"East production be early meeting. Already summer military position.
Eat return his glass leg. Since until sister line realize treat such. National husband edge investment.",22:12:03,RTGS
KXSC67285952600921,GB64WRNU86151136321109,1/28/2017,34622.35,100002,N,Credited,OPERA,PC,Cr,7:06:25,10:08:32,9/16/2020,48908870,154.45,4,"Agency training free ten.
Collection show though. Everyone city machine behind rest. Billion without actually will.",9:24:04,UPI
KXSC67285952600921,GB64WRNU86151136321109,1/28/2017,34467.9,100002,Y,Rent,MI,MOBILE,Dr,9:27:38,13:04:19,9/16/2020,16625365,154.45,5,Guy truth morning thought network knowledge several. Executive learn medical indeed of continue while.,11:05:14,CARDS
KXSC67285952600921,GB64WRNU86151136321109,1/28/2017,34313.45,100002,Y,Insurance,FF,MOBILE,Dr,15:11:55,18:39:57,9/16/2020,39759610,154.45,4,"Cultural fly mind hope. Exactly community result.
Son rest them cost bad sit. Number power job next guy member prevent.
His late machine sister throw staff why. Work majority no executive.",17:06:38,UPI
KXSC67285952600921,GB64WRNU86151136321109,1/28/2017,34467.9,100002,N,Credited,OPERA,MOBILE,Cr,22:25:34,23:37:33,9/16/2020,69014079,154.45,2,"Say fill civil avoid. Least treat poor laugh.
Suffer well certainly report pick Mrs draw. Financial serve heart. Similar drug year security just Mr. Husband too possible phone safe attention.",23:00:16,IMPS
KXSC67285952600921,GB64WRNU86151136321109,1/28/2017,35140.21,100002,N,Credited,SAFARI,PC,Cr,7:29:02,12:50:58,9/22/2020,367455,672.31,5,"Present drive blue live per change. Material without sort or five. Political seek off source.
Edge rise purpose college admit edge court. Store play ever reduce oil.",10:42:55,CARDS
KXSC67285952600921,GB64WRNU86151136321109,1/28/2017,35812.52,100002,N,Credited,FF,PC,Cr,17:31:48,22:56:20,9/22/2020,45588358,672.31,6,"Dark bag network.
That foot break lead remain job good. Kitchen gun society miss only sing. Read only technology perhaps mention win food. Always consumer call take again according how.",19:50:32,CHEQUE
KXSC67285952600921,GB64WRNU86151136321109,1/28/2017,36105,100002,N,Credited,OPERA,PC,Cr,5:46:49,8:11:31,9/23/2020,82796549,292.48,1,"Prove four choose only drug personal. Institution over space draw. Most amount prove until into.
Turn field forget so lead and television. Figure never us right inside bed send.",6:54:14,NEFT
KXSC67285952600921,GB64WRNU86151136321109,1/28/2017,36397.48,100002,N,Credited,FF,PC,Cr,9:41:36,12:14:06,9/23/2020,98658985,292.48,2,Common approach student he tell its. Concern without so only you spring. Follow back live source pick.,11:39:43,IMPS
KXSC67285952600921,GB64WRNU86151136321109,1/28/2017,36105,100002,Y,Medicals,EDGE,MOBILE,Dr,12:15:45,15:14:17,9/23/2020,16417083,292.48,2,"Rich main draw participant as. Recent hard pay state wall particularly.
Without also remember operation. Attention new catch future I.",14:29:46,IMPS
KXSC67285952600921,GB64WRNU86151136321109,1/28/2017,36397.48,100002,N,Credited,FF,PC,Cr,21:53:09,24:58:17,9/23/2020,71607795,292.48,1,Every tonight new together too and identify. Hot key voice continue develop yeah. Share full improve western against deal south.,22:46:15,NEFT
KXSC67285952600921,GB64WRNU86151136321109,1/28/2017,36156.82,100002,Y,Transportation,OPERA,POS,Dr,10:42:22,15:35:39,10/2/2020,23497986,240.66,7,Least up significant present film choose. Look site store cut mouth where. Base practice degree information career.,12:04:06,DD
KXSC67285952600921,GB64WRNU86151136321109,1/28/2017,36397.48,100002,N,Credited,CHROME,POS,Cr,17:14:55,22:32:08,10/2/2020,89694756,240.66,7,Manager he blood speech left. Order marriage street why ready no performance.,18:33:15,DD
KXSC67285952600921,GB64WRNU86151136321109,1/28/2017,34624.72,100002,Y,Online Shopping,FF,PC,Dr,3:37:33,5:38:18,10/3/2020,18359343,1772.76,2,"Beautiful identify thought way.
Collection look home run teacher. Someone movie at wind player.
It determine between for material yourself. Memory system speak.",4:31:49,IMPS
KXSC67285952600921,GB64WRNU86151136321109,1/28/2017,32851.96,100002,Y,Entertainment,FF,PC,Dr,9:45:32,11:54:21,10/3/2020,84129109,1772.76,6,"Possible machine top another require design yeah big. Easy off rich throughout dog. Mean number door later.
Plan film once. End use forward. College response medical either kind process response.",10:39:02,CHEQUE
KXSC67285952600921,GB64WRNU86151136321109,1/28/2017,34624.72,100002,N,Credited,SAFARI,PC,Cr,14:12:54,16:56:46,10/3/2020,27535257,1772.76,7,Prepare age decide pull indeed. Become top generation nearly whole beat eat which. Bad wall some herself young name think organization.,15:38:11,DD
KXSC67285952600921,GB64WRNU86151136321109,1/28/2017,32851.96,100002,Y,Groceries,MI,POS,Dr,19:00:57,20:44:57,10/3/2020,5878512,1772.76,7,"Cover son professional everything scene.
Expert less painting well practice church. All second this. Clear common method method so position should.",19:45:50,DD
KXSC67285952600921,GB64WRNU86151136321109,1/28/2017,31079.2,100002,Y,Utilities,FF,PC,Dr,19:43:35,22:34:08,10/3/2020,28164395,1772.76,5,"Word sport great others. Miss scientist task month.
News court itself statement well reflect. Here accept share this outside woman almost.",20:39:47,CARDS
KXSC67285952600921,GB64WRNU86151136321109,1/28/2017,32861.35,100002,N,Credited,SAFARI,POS,Cr,4:06:41,6:29:57,10/5/2020,60272966,1782.15,5,"Value member along fall safe in we. Recently performance gas should thousand nor.
Man official between than recent north teach. Affect success become all Congress responsibility sort.",5:58:55,CARDS
KXSC67285952600921,GB64WRNU86151136321109,1/28/2017,31079.2,100002,Y,Entertainment,CHROME,POS,Dr,9:48:49,11:02:52,10/5/2020,28750796,1782.15,1,"Know structure must assume. Sometimes wrong cell behind also human.
Expert the outside idea catch. City blue care land would address.",10:21:13,NEFT
KXSC67285952600921,GB64WRNU86151136321109,1/28/2017,32861.35,100002,N,Credited,FF,POS,Cr,14:16:06,17:05:02,10/5/2020,2223032,1782.15,4,"Family parent democratic. Imagine candidate hold meet increase.
Alone once within. Figure establish interesting. Until create summer page again apply.",15:24:53,UPI
KXSC67285952600921,GB64WRNU86151136321109,1/28/2017,31079.2,100002,Y,Household Consumables,EDGE,PC,Dr,17:43:32,19:57:21,10/5/2020,5817788,1782.15,5,Modern daughter put face community news. Environment whether yet weight list safe.,18:53:54,CARDS
KXSC67285952600921,GB64WRNU86151136321109,1/28/2017,29297.05,100002,Y,Medicals,MI,MOBILE,Dr,20:33:10,22:20:14,10/5/2020,8214553,1782.15,2,Blue relate smile like while themselves. They strategy serve well write cultural ever tree. Treat might chair top color.,21:08:36,IMPS
KXSC67285952600921,GB64WRNU86151136321109,1/28/2017,30821.05,100002,N,Credited,FF,PC,Cr,9:29:01,16:52:22,10/14/2020,55871426,1524,2,"History writer unit provide show specific. Respond wide heavy church. Standard whose political civil event management prepare.
Couple book information that face Democrat relate. News ok growth.",13:41:38,IMPS
KXSC67285952600921,GB64WRNU86151136321109,1/28/2017,30759.55,100002,Y,Insurance,IE,PC,Dr,5:49:08,9:47:35,10/17/2020,55697583,61.5,6,Ok side surface. Appear consider because project. Approach never boy add participant wife.,8:57:01,CHEQUE
KXSC67285952600921,GB64WRNU86151136321109,1/28/2017,30821.05,100002,N,Credited,CHROME,MOBILE,Cr,15:21:43,18:09:54,10/17/2020,89079522,61.5,5,"Go check require minute.
Everyone series anything blood someone. Congress environmental simply article simple their.",16:10:34,CARDS
KXSC67285952600921,GB64WRNU86151136321109,1/28/2017,31592.65,100002,N,Credited,FF,MOBILE,Cr,5:58:09,10:01:49,11/1/2020,30516953,771.6,5,Best always improve already. Indeed letter building responsibility else popular high. Prepare street something again.,7:43:12,CARDS
KXSC67285952600921,GB64WRNU86151136321109,1/28/2017,30821.05,100002,Y,Transportation,CHROME,PC,Dr,15:27:47,17:23:20,11/1/2020,65674475,771.6,2,"Finally cut example long paper nature. Kind hot instead she future them group all.
Know blood especially who single. Population current firm sound. Support election gun the task drive own.",16:43:39,IMPS
KXSC67285952600921,GB64WRNU86151136321109,1/28/2017,31592.65,100002,N,Credited,CHROME,POS,Cr,17:14:29,20:13:29,11/1/2020,28981008,771.6,4,Glass woman politics put now. Know kind line consumer father and popular answer. Bar paper box challenge same.,18:59:39,UPI
KXSC67285952600921,GB64WRNU86151136321109,1/28/2017,32205.82,100002,N,Credited,EDGE,MOBILE,Cr,10:56:33,15:25:13,11/5/2020,49171068,613.17,5,"Father green best central lawyer miss assume. Technology financial culture near.
Job feeling wear property under. Single often result energy just.",13:39:32,CARDS
KXSC67285952600921,GB64WRNU86151136321109,1/28/2017,31592.65,100002,Y,Groceries,OPERA,POS,Dr,22:38:19,24:49:56,11/5/2020,34191057,613.17,3,Couple computer maintain concern. Personal experience third force make discussion leader. Work career a reality. Type other part class expect structure miss.,23:48:54,RTGS
KXSC67285952600921,GB64WRNU86151136321109,1/28/2017,30901.23,100002,Y,Dining,EDGE,POS,Dr,11:12:39,14:05:48,11/10/2020,78207288,691.42,2,Stand generation represent. Myself result thousand business image bring. Per success establish term position bed ball bar. Make deal pay full hear summer example.,13:07:54,IMPS
KXSC67285952600921,GB64WRNU86151136321109,1/28/2017,30209.81,100002,Y,Dining,SAFARI,PC,Dr,19:56:53,24:07:35,11/10/2020,58920534,691.42,5,"Describe before play trade yeah. Relationship bag population. Edge bit outside nation wonder suffer great.
Let choice next approach. Industry on change individual dinner much.",21:09:10,CARDS
KXSC67285952600921,GB64WRNU86151136321109,1/28/2017,28656.98,100002,Y,Online Shopping,EDGE,PC,Dr,12:35:54,18:53:09,11/12/2020,68081799,1552.83,2,"Store history consumer store suffer. Manager research heavy tell put rise do.
Feel great next news half happen sure. All already speak per open huge.",14:12:43,IMPS
KXSC67285952600921,GB64WRNU86151136321109,1/28/2017,30305.24,100002,N,Credited,OPERA,PC,Cr,11:31:50,16:29:42,11/14/2020,5640003,1648.26,4,Collection news general natural. Production natural side safe western suggest age. Evidence room mouth box develop.,14:02:46,UPI
KXSC67285952600921,GB64WRNU86151136321109,1/28/2017,28656.98,100002,Y,Insurance,FF,MOBILE,Dr,20:42:23,23:01:39,11/14/2020,83811128,1648.26,5,"Also lead increase as evening. Dream lawyer third actually. Course state agent he win these.
Card late industry. Raise into system brother whose case. White share indicate information economy pick.",21:39:40,CARDS
KXSC67285952600921,GB64WRNU86151136321109,1/28/2017,30064.1,100002,N,Credited,SAFARI,POS,Cr,5:18:18,7:12:15,11/21/2020,9975545,1407.12,3,"Compare building clear condition. Indicate to wonder citizen. Look music try relationship good cut.
Measure similar again it her. Carry interview American born study style.",6:46:25,RTGS
KXSC67285952600921,GB64WRNU86151136321109,1/28/2017,31471.22,100002,N,Credited,IE,PC,Cr,8:34:05,11:31:49,11/21/2020,85930568,1407.12,4,Research wait court effect foot. Approach community suggest painting.,10:22:43,UPI
KXSC67285952600921,GB64WRNU86151136321109,1/28/2017,30064.1,100002,Y,Dining,FF,PC,Dr,12:47:30,14:04:51,11/21/2020,91229601,1407.12,4,"Threat yourself require ago laugh or nor. Environmental ground form current reduce often concern we.
Race her of. Operation for fire color. Within but might send husband.",13:31:28,UPI
KXSC67285952600921,GB64WRNU86151136321109,1/28/2017,28656.98,100002,Y,Household Consumables,CHROME,POS,Dr,15:59:13,18:13:58,11/21/2020,36338917,1407.12,2,"Affect then ability yourself lawyer decide. Prepare though large team.
Page total hour quickly serve life. Process data may.",17:34:08,IMPS
KXSC67285952600921,GB64WRNU86151136321109,1/28/2017,27249.86,100002,Y,Rent,FF,PC,Dr,21:33:42,24:57:09,11/21/2020,83877230,1407.12,1,"Least test perhaps. Any possible chance response dinner suffer when teacher.
Shake evidence something fly. Skill concern travel drop social anyone answer.",23:14:13,NEFT
KXSC67285952600921,GB64WRNU86151136321109,1/28/2017,25350.41,100002,Y,Groceries,FF,POS,Dr,4:54:18,6:25:55,11/22/2020,74005529,1899.45,3,"Alone note something another guess heavy stop. Send fall I close. Little may especially possible hour.
Out wait thank case pass. Entire around politics.",5:30:12,RTGS
KXSC67285952600921,GB64WRNU86151136321109,1/28/2017,23450.96,100002,Y,Entertainment,MI,POS,Dr,9:20:31,10:54:14,11/22/2020,87102123,1899.45,1,"See along seek morning its final clearly.
Future relate despite little stand. Spring answer school system safe treatment start.
Voice save billion foot. Message me important least to.",10:18:47,NEFT
KXSC67285952600921,GB64WRNU86151136321109,1/28/2017,25350.41,100002,N,Credited,MI,POS,Cr,12:12:30,14:49:11,11/22/2020,49489620,1899.45,5,That talk responsibility. Method young whether brother. Possible similar investment far laugh project month.,14:06:24,CARDS
KXSC67285952600921,GB64WRNU86151136321109,1/28/2017,27249.86,100002,N,Credited,EDGE,PC,Cr,17:39:07,19:44:56,11/22/2020,21642364,1899.45,2,"Its politics enough soldier away relate. Cell clear subject.
Research training ability. Century health their could. Part sort ago little effort.
Southern writer since trouble produce.",19:01:08,IMPS
KXSC67285952600921,GB64WRNU86151136321109,1/28/2017,25350.41,100002,Y,Dining,MI,PC,Dr,21:51:14,25:06:38,11/22/2020,631334,1899.45,2,"Ahead market attention poor interest. Rise letter any democratic watch know national.
Author idea campaign team become approach add. Treat exist for place. Hundred former boy event however on fish.",23:20:00,IMPS
KXSC67285952600921,GB64WRNU86151136321109,1/28/2017,23964.25,100002,Y,Transportation,MI,PC,Dr,17:55:17,24:45:41,12/7/2020,72050729,1386.16,7,Hear end different cup sense analysis or eight. Because by stand treatment compare people.,21:09:01,DD
KXSC67285952600921,GB64WRNU86151136321109,1/28/2017,23095.17,100002,Y,Transportation,OPERA,PC,Dr,3:19:31,5:33:35,12/18/2020,6704797,869.08,6,"Skill well near opportunity maybe form. Impact answer card stuff agree somebody. Item marriage trial PM.
Inside small public. Ask small agent practice place dog particularly.",4:46:59,CHEQUE
KXSC67285952600921,GB64WRNU86151136321109,1/28/2017,23964.25,100002,N,Credited,SAFARI,POS,Cr,10:04:48,11:45:18,12/18/2020,77234247,869.08,6,Check win method around. Environmental age response more. Hold real little because think paper. Show order until exactly.,11:01:37,CHEQUE
KXSC67285952600921,GB64WRNU86151136321109,1/28/2017,24833.33,100002,N,Credited,FF,PC,Cr,13:32:02,16:13:01,12/18/2020,32694185,869.08,1,"Child mind east here ago. Cause attorney wall. Say seek seem he control.
Necessary vote win real care. Eat whom positive development member quickly physical.",14:51:15,NEFT
KXSC67285952600921,GB64WRNU86151136321109,1/28/2017,23964.25,100002,Y,Utilities,FF,MOBILE,Dr,16:49:19,18:09:01,12/18/2020,69652981,869.08,1,"South care support soon network. Authority officer sell three sister source discussion.
Together politics cause each their card. Challenge article tax rule.",17:37:56,NEFT
KXSC67285952600921,GB64WRNU86151136321109,1/28/2017,24833.33,100002,N,Credited,OPERA,MOBILE,Cr,19:03:28,21:29:13,12/18/2020,20041328,869.08,5,"Agent seek human mention thousand. Place prepare travel.
Nature another when choose. Door book build year it.",20:39:45,CARDS
KXSC67285952600921,GB64WRNU86151136321109,1/28/2017,26246.28,100002,N,Credited,IE,MOBILE,Cr,8:13:35,11:08:16,12/20/2020,16735958,1412.95,6,Recently adult day along. Everything real bad time feel short. Rich later crime money responsibility.,8:57:59,CHEQUE
KXSC67285952600921,GB64WRNU86151136321109,1/28/2017,24833.33,100002,Y,Online Shopping,MI,POS,Dr,9:20:02,12:12:07,12/20/2020,4715900,1412.95,2,"Above light quite technology. Physical rule upon sing government. Able research natural.
Science program future key. Experience check stuff former network ahead.",11:17:46,IMPS
KXSC67285952600921,GB64WRNU86151136321109,1/28/2017,23420.38,100002,Y,Online Shopping,EDGE,MOBILE,Dr,17:51:23,20:44:01,12/20/2020,61150737,1412.95,4,War few wonder view down model. Against our against perform yes meeting. Figure protect national occur. Country reduce seven customer sense perform its work.,18:30:03,UPI
KXSC67285952600921,GB64WRNU86151136321109,1/28/2017,24833.33,100002,N,Credited,FF,POS,Cr,21:28:28,25:16:17,12/20/2020,37133894,1412.95,7,"Safe prove direction statement memory seem. Product city even performance mind.
Across guy write hospital newspaper glass.
Spring charge for suddenly support style tough give.",23:40:32,DD
KXSC67285952600921,GB64WRNU86151136321109,1/28/2017,26566.75,100002,N,Credited,EDGE,MOBILE,Cr,12:39:50,18:35:15,12/22/2020,93099899,1733.42,3,"Room among land happy. View entire discover less grow recently. Close provide bill on figure.
Attorney both remain. Like run off mouth paper risk black culture. Successful majority never attention.",14:08:35,RTGS
KXSC67285952600921,GB64WRNU86151136321109,1/28/2017,26394.76,100002,Y,Entertainment,OPERA,PC,Dr,6:29:35,8:16:21,12/29/2020,22671400,171.99,4,"Space which building chair. Stage market series story.
Near trip defense dog tend science. Role structure conference keep ahead author image.
Computer table such defense. Size week last race.",7:25:23,UPI
KXSC67285952600921,GB64WRNU86151136321109,1/28/2017,26222.77,100002,Y,Transportation,FF,POS,Dr,12:10:30,14:56:29,12/29/2020,1377071,171.99,3,Very read be him big picture. Animal staff Democrat vote. Science animal far population hundred morning.,13:44:01,RTGS
KXSC67285952600921,GB64WRNU86151136321109,1/28/2017,26050.78,100002,Y,Household Consumables,OPERA,POS,Dr,16:32:56,19:41:03,12/29/2020,68145453,171.99,1,"Her way officer responsibility Republican. Wear adult one indicate light today.
Thousand measure bad force news. Great drop wind partner. Thing partner likely.",18:24:33,NEFT
KXSC67285952600921,GB64WRNU86151136321109,1/28/2017,26222.77,100002,N,Credited,OPERA,POS,Cr,22:49:31,25:28:46,12/29/2020,98637690,171.99,1,Commercial choose environmental part community film onto think. Environment address newspaper make time consumer exactly. Effect suggest item at prove.,23:40:18,NEFT
KXSC67285952600921,GB64WRNU86151136321109,1/28/2017,25799.14,100002,Y,Groceries,OPERA,POS,Dr,6:12:59,8:10:31,1/1/2021,9291744,423.63,4,"Talk one south. Near turn key loss.
Physical thus skill. Citizen student benefit kind treat.",7:06:24,UPI
KXSC67285952600921,GB64WRNU86151136321109,1/28/2017,25375.51,100002,Y,Utilities,MI,PC,Dr,10:20:43,12:04:20,1/1/2021,90590542,423.63,7,"Protect night speak study institution its dream. System movement charge him.
Item approach also kitchen woman.
Land try opportunity American help painting.",10:57:28,DD
KXSC67285952600921,GB64WRNU86151136321109,1/28/2017,25799.14,100002,N,Credited,OPERA,PC,Cr,13:42:53,15:50:37,1/1/2021,40603391,423.63,7,"Matter fall less least room PM.
New bar perhaps economy place mind personal. Rich team wish fish station whose.
Son right catch economic. Build apply family west order.",14:17:28,DD
KXSC67285952600921,GB64WRNU86151136321109,1/28/2017,25375.51,100002,Y,Entertainment,FF,PC,Dr,18:25:43,20:23:26,1/1/2021,83385445,423.63,6,"Style chair speak wish his someone dog. While add center them share increase safe.
Effort loss dinner clear. Increase training scene ability either sound. Feeling up compare least especially.",19:19:28,CHEQUE
KXSC67285952600921,GB64WRNU86151136321109,1/28/2017,25799.14,100002,N,Credited,IE,PC,Cr,19:04:30,21:17:15,1/1/2021,84413666,423.63,4,"Minute director certain quality deep almost along rich. Investment now college fund again same.
Their international happen American quickly inside.",20:31:08,UPI
KXSC67285952600921,GB64WRNU86151136321109,1/28/2017,24978.56,100002,Y,Groceries,IE,POS,Dr,12:39:01,21:16:34,1/4/2021,28371380,820.58,5,Reflect dinner former method bed majority choose. Start blue indeed usually off. Drive particularly he.,18:08:15,CARDS
KXSC67285952600921,GB64WRNU86151136321109,1/28/2017,26806.99,100002,N,Credited,SAFARI,PC,Cr,12:13:14,14:13:01,1/10/2021,4078333,1828.43,1,"Leader the something account Republican foot consider thus.
Reveal teach training there note. Live modern ever administration believe yeah long. Work fill think.",13:12:21,NEFT
KXSC67285952600921,GB64WRNU86151136321109,1/28/2017,28635.42,100002,N,Credited,CHROME,POS,Cr,16:50:40,23:40:19,1/10/2021,50608997,1828.43,5,"Allow generation join already prevent. Lead gas forget treat.
Threat notice teach next voice. Early image party environmental.
Yourself public star especially let.",19:47:33,CARDS
KXSC67285952600921,GB64WRNU86151136321109,1/28/2017,27449.09,100002,Y,Insurance,SAFARI,POS,Dr,5:47:48,13:06:14,1/11/2021,20460754,1186.33,7,"Board face building. Administration most people beyond.
Bit blood water true.
Current far that page real watch. Sport cover test style. Alone total her the my chance source.",9:31:43,DD
KXSC67285952600921,GB64WRNU86151136321109,1/28/2017,28635.42,100002,N,Credited,FF,POS,Cr,21:56:55,25:57:44,1/11/2021,97719045,1186.33,3,Scene military hear less early measure include. Attorney total central hair he. Image too them eat about. Fill left pretty between.,23:41:54,RTGS
KXSC67285952600921,GB64WRNU86151136321109,1/28/2017,29391.46,100002,N,Credited,CHROME,MOBILE,Cr,9:22:07,12:53:58,1/15/2021,25336702,756.04,1,"After better life forget end safe somebody understand. Join idea factor grow threat along generation party. Box look respond page four seat perform assume.
Go as society. Wind hold hundred each.",10:32:20,NEFT
KXSC67285952600921,GB64WRNU86151136321109,1/28/2017,28635.42,100002,Y,Medicals,OPERA,POS,Dr,12:03:21,14:32:10,1/15/2021,60018649,756.04,1,Account his voice recently almost. Treat fire chair without us catch total.,13:17:47,NEFT
KXSC67285952600921,GB64WRNU86151136321109,1/28/2017,27879.38,100002,Y,Rent,SAFARI,PC,Dr,21:47:08,24:49:05,1/15/2021,59510574,756.04,3,Interview edge north create threat management door. Represent change recently test.,22:55:27,RTGS
KXSC67285952600921,GB64WRNU86151136321109,1/28/2017,27356.84,100002,Y,Online Shopping,IE,MOBILE,Dr,20:29:50,27:28:25,1/28/2021,43213597,522.54,5,"Force try radio. Hour home which listen its southern laugh.
Name interesting make it question yourself. Effort mouth building word less up hot. Fish high west whom.",23:04:10,CARDS
KXSC67285952600921,GB64WRNU86151136321109,1/28/2017,27197.59,100002,Y,Transportation,OPERA,MOBILE,Dr,6:25:27,7:20:05,1/30/2021,30815209,159.25,3,President deep people total project individual. Dinner lay energy meeting loss town career me. Determine wait reality good.,6:53:09,RTGS
KXSC67285952600921,GB64WRNU86151136321109,1/28/2017,27356.84,100002,N,Credited,IE,POS,Cr,6:38:03,10:11:55,1/30/2021,10669709,159.25,3,"Event six itself until hard. Should population top maintain subject international.
Identify fight tax movement whether shake. Involve care population. Happen fact small or.",8:25:27,RTGS
KXSC67285952600921,GB64WRNU86151136321109,1/28/2017,27197.59,100002,Y,Groceries,FF,PC,Dr,13:40:00,15:15:38,1/30/2021,81931088,159.25,2,Example data rate once last. Plan high reduce perform mention issue for treat.,14:37:01,IMPS
KXSC67285952600921,GB64WRNU86151136321109,1/28/2017,27356.84,100002,N,Credited,MI,MOBILE,Cr,18:25:35,20:52:49,1/30/2021,82949938,159.25,5,"Financial issue economy policy service through throughout soldier. Type fund answer bill history school.
Camera left back group value clearly campaign. Only drop way add yeah.",19:33:06,CARDS
KXSC67285952600921,GB64WRNU86151136321109,1/28/2017,27197.59,100002,Y,Insurance,MI,POS,Dr,21:34:01,23:30:58,1/30/2021,43820382,159.25,4,Camera model dog treat. Especially threat until boy expert support. Big others hospital turn art thank grow.,22:28:53,UPI
KXSC67285952600921,GB64WRNU86151136321109,1/28/2017,28901.32,100002,N,Credited,EDGE,MOBILE,Cr,4:00:21,5:46:42,2/13/2021,89370827,1703.73,5,"Degree authority pressure paper. Here describe public spend knowledge enter author.
Music must expect great move rich. Offer skill clear within lot. Serious series size quickly form above color wife.",5:11:12,CARDS
KXSC67285952600921,GB64WRNU86151136321109,1/28/2017,27197.59,100002,Y,Household Consumables,IE,POS,Dr,7:47:43,10:27:51,2/13/2021,33628677,1703.73,4,"Trial the case add nation almost. Themselves woman stuff recent treat eight throughout capital. Agent vote significant piece.
Part next record. American large measure when.",9:13:55,UPI
KXSC67285952600921,GB64WRNU86151136321109,1/28/2017,28901.32,100002,N,Credited,MI,MOBILE,Cr,11:49:24,13:42:02,2/13/2021,62786461,1703.73,2,Seem charge soon when respond music door. Technology specific thus.,12:41:26,IMPS
KXSC67285952600921,GB64WRNU86151136321109,1/28/2017,27197.59,100002,Y,Personal Care,FF,PC,Dr,15:53:25,18:07:48,2/13/2021,94830064,1703.73,6,"Range customer push police nothing two. Visit address your different rate door. Seven cell lead fish over.
Ready risk anyone treatment necessary. Fall quickly young.",16:37:03,CHEQUE
KXSC67285952600921,GB64WRNU86151136321109,1/28/2017,25493.86,100002,Y,Transportation,CHROME,MOBILE,Dr,23:17:36,25:46:37,2/13/2021,86870610,1703.73,2,"Natural why conference skin each. Perform dark standard relate chair experience personal machine.
Own choice despite include right morning page. They every economic light run conference thank.",23:58:50,IMPS
KXSC67285952600921,GB64WRNU86151136321109,1/28/2017,26721.72,100002,N,Credited,FF,POS,Cr,11:21:05,15:31:49,2/25/2021,49049596,1227.86,6,"American whose hear the explain away first. Treatment vote collection let though.
Number product listen. Fund family performance culture shoulder follow already.",14:32:53,CHEQUE
KXSC67285952600921,GB64WRNU86151136321109,1/28/2017,25493.86,100002,Y,Personal Care,CHROME,PC,Dr,14:58:25,21:45:40,2/25/2021,77164926,1227.86,5,"Instead argue significant stuff firm majority thousand. Shoulder ten these scientist unit trouble carry.
Degree green onto play. Return ten skill add any school. Common boy ability similar.",17:47:51,CARDS
KXSC67285952600921,GB64WRNU86151136321109,1/28/2017,25585.59,100002,N,Credited,FF,POS,Cr,7:28:40,10:24:20,3/1/2021,50376353,91.73,1,High century film fish each know get. Very room worry of within activity couple. Relate never central lot. Near worker air attention a sell.,9:33:05,NEFT
KXSC67285952600921,GB64WRNU86151136321109,1/28/2017,25677.32,100002,N,Credited,FF,PC,Cr,7:45:37,12:10:10,3/1/2021,59455516,91.73,2,"Huge model well indeed bed identify fly. Often realize away line.
Safe bring individual only. Gas where off media read risk book million. Long kid manage first bag consumer author.",9:51:48,IMPS
KXSC67285952600921,GB64WRNU86151136321109,1/28/2017,25769.05,100002,N,Credited,IE,PC,Cr,12:31:07,15:07:52,3/1/2021,65720943,91.73,5,Above vote two ask buy. Employee choice number chance. Approach unit marriage easy.,14:35:51,CARDS
KXSC67285952600921,GB64WRNU86151136321109,1/28/2017,25677.32,100002,Y,Household Consumables,EDGE,POS,Dr,20:30:26,24:06:03,3/1/2021,19514079,91.73,5,"Region station certain activity vote sing. Single community himself third around quickly.
Pretty you throw Congress full sometimes. Simple fill tough rise defense music.",21:52:45,CARDS
KXSC67285952600921,GB64WRNU86151136321109,1/28/2017,26753.32,100002,N,Credited,OPERA,PC,Cr,4:29:34,8:25:18,3/6/2021,96293409,1076,1,"Fear vote own apply million although do. Hear important TV rock executive maybe.
Bag many coach PM stay affect travel. Drive theory there his. Push present doctor.",6:02:13,NEFT
KXSC67285952600921,GB64WRNU86151136321109,1/28/2017,27829.32,100002,N,Credited,FF,MOBILE,Cr,8:23:46,12:53:01,3/6/2021,39400253,1076,5,Even these direction buy join someone administration admit. Congress catch laugh let hundred or them above. Enjoy tree grow woman.,10:38:44,CARDS
KXSC67285952600921,GB64WRNU86151136321109,1/28/2017,28905.32,100002,N,Credited,CHROME,POS,Cr,17:49:29,19:59:04,3/6/2021,17035958,1076,2,"Beat project understand your cover likely trouble. Democratic card company yet.
Need hair sense service author travel employee. Reveal poor former more. Behind term yeah star.",19:00:35,IMPS
KXSC67285952600921,GB64WRNU86151136321109,1/28/2017,29981.32,100002,N,Credited,IE,PC,Cr,19:55:48,23:51:32,3/6/2021,34128572,1076,1,Attention structure true whole myself pass. Resource him lawyer police scene make.,21:37:15,NEFT
KXSC67285952600921,GB64WRNU86151136321109,1/28/2017,30183.69,100002,N,Credited,IE,POS,Cr,4:10:00,8:30:02,3/9/2021,52820434,202.37,2,"Cost section own arrive Mrs the often. Beautiful name night mouth.
Good western town pick. Home turn decade computer. House everything fish possible avoid. Others research standard skin purpose.",6:35:20,IMPS
KXSC67285952600921,GB64WRNU86151136321109,1/28/2017,30386.06,100002,N,Credited,MI,MOBILE,Cr,14:33:48,18:51:30,3/9/2021,62443135,202.37,7,"Address finally dinner world upon there world.
Follow future bit culture return. Manage late assume message. Civil produce experience teacher each exist much.",16:39:39,DD
KXSC67285952600921,GB64WRNU86151136321109,1/28/2017,30588.43,100002,N,Credited,CHROME,MOBILE,Cr,20:02:10,24:45:37,3/9/2021,36886951,202.37,3,"Partner have many development matter call most.
Team side successful entire information agency term. Nothing enough white wear me tree walk.",22:24:02,RTGS
KXSC67285952600921,GB64WRNU86151136321109,1/28/2017,31762.8,100002,N,Credited,IE,MOBILE,Cr,3:07:17,6:04:27,3/17/2021,95370071,1174.37,1,"Her sea religious. Air today town way entire piece consider heavy.
Leave above list career career general. Soon you fast single part I thing charge.",4:30:15,NEFT
KXSC67285952600921,GB64WRNU86151136321109,1/28/2017,32937.17,100002,N,Credited,MI,POS,Cr,11:21:40,13:42:28,3/17/2021,9579262,1174.37,3,"Field bank assume matter should relationship number. Miss president yourself. Scientist local player benefit war. Stuff radio star free.
Wind property firm wide quite. Media history pressure might.",11:46:43,RTGS
KXSC67285952600921,GB64WRNU86151136321109,1/28/2017,31762.8,100002,Y,Personal Care,EDGE,POS,Dr,10:33:29,13:42:36,3/17/2021,73342564,1174.37,1,"Development why at upon. No recent you around serious third. When clear per.
None difficult voice particularly out economy beyond not. Discover wear quickly mother force by no. Close present through.",12:11:04,NEFT
KXSC67285952600921,GB64WRNU86151136321109,1/28/2017,32937.17,100002,N,Credited,MI,MOBILE,Cr,17:51:17,21:29:09,3/17/2021,21576003,1174.37,2,Shake debate style station. Purpose down out federal expert positive. Trip yeah often ahead itself pressure tree.,19:37:10,IMPS
KXSC67285952600921,GB64WRNU86151136321109,1/28/2017,31762.8,100002,Y,Rent,EDGE,POS,Dr,22:37:12,24:53:40,3/17/2021,36842148,1174.37,2,Include evening despite than. Not ahead address court community military would. Low tough nice visit throw minute student. Star action final recently music trial build.,23:24:28,IMPS
KXSC67285952600921,GB64WRNU86151136321109,1/28/2017,30899.97,100002,Y,Groceries,FF,POS,Dr,14:52:28,20:16:22,3/24/2021,10009246,862.83,4,"Listen true cause evidence I recent. Rest always summer else each charge.
Mean until protect goal begin ability month stay. Dinner center free even.",18:49:39,UPI
KXSC67285952600921,GB64WRNU86151136321109,1/28/2017,32597.66,100002,N,Credited,FF,POS,Cr,17:48:12,25:25:24,4/5/2021,79065764,1697.69,6,"Have environmental step audience her why term event. Goal end front reduce.
Town agent picture tough speech. Report serve particularly chair defense minute point.",21:28:39,CHEQUE
KXSC67285952600921,GB64WRNU86151136321109,1/28/2017,32523.36,100002,Y,Dining,OPERA,PC,Dr,7:41:31,12:28:41,4/6/2021,23412873,74.3,2,"Hear result blood deep billion expect indeed.
Blood simple commercial. News front including positive. West live cause popular view half.",9:12:49,IMPS
KXSC67285952600921,GB64WRNU86151136321109,1/28/2017,32449.06,100002,Y,Transportation,EDGE,MOBILE,Dr,20:47:24,25:13:35,4/6/2021,94486933,74.3,4,"Force watch shake model.
Positive account decide television data develop. Onto when sure meeting.
Ok budget guy film. Meet each four under condition issue. Significant want doctor girl condition.",22:46:18,UPI
KXSC67285952600921,GB64WRNU86151136321109,1/28/2017,34078.18,100002,N,Credited,SAFARI,PC,Cr,7:23:08,12:20:37,4/12/2021,78950016,1629.12,1,"Plan success nature report nor hope. Recognize various practice represent. Popular about on national bill step.
Movement customer own perform. Quite marriage oil trip. Product operation ready stay.",9:06:09,NEFT
KXSC67285952600921,GB64WRNU86151136321109,1/28/2017,35707.3,100002,N,Credited,EDGE,MOBILE,Cr,14:34:14,19:10:07,4/12/2021,12249671,1629.12,6,"Defense seven citizen indicate stand. Drive table major lose over.
Carry government approach nothing place style wish. Mean case reflect.",16:38:02,CHEQUE
KXSC67285952600921,GB64WRNU86151136321109,1/28/2017,36514.26,100002,N,Credited,FF,MOBILE,Cr,11:55:36,16:29:07,4/13/2021,90369339,806.96,4,"Number tend carry popular political. Stage sit mouth wide buy. Dinner wish activity long training seat Mr.
Open meet national what important remain discuss. Finally feeling little event sea century.",14:25:05,UPI
KXSC67285952600921,GB64WRNU86151136321109,1/28/2017,37433.92,100002,N,Credited,EDGE,POS,Cr,4:02:00,6:51:17,4/22/2021,87513721,919.66,4,"Behind charge fight book one film computer. Place million business career value process seem work. Instead pretty charge top.
Create table commercial prepare.",5:15:26,UPI
KXSC67285952600921,GB64WRNU86151136321109,1/28/2017,38353.58,100002,N,Credited,OPERA,PC,Cr,9:53:23,12:25:23,4/22/2021,84124111,919.66,7,Million crime name ten common technology. Her standard ready also. Purpose summer actually once impact myself. Pattern order civil dinner.,11:40:33,DD
KXSC67285952600921,GB64WRNU86151136321109,1/28/2017,37433.92,100002,Y,Insurance,OPERA,POS,Dr,11:53:45,14:54:12,4/22/2021,6167844,919.66,6,"Democrat charge middle son condition. None seem federal. Choose technology season.
Good home win send social north. Trouble I property also. Just do together local agency quickly fish.",13:01:20,CHEQUE
KXSC67285952600921,GB64WRNU86151136321109,1/28/2017,36514.26,100002,Y,Dining,OPERA,POS,Dr,15:37:45,19:07:30,4/22/2021,45378003,919.66,7,"Share wonder American sense contain five would course. As available whom political former reduce.
Carry political effect you. Let rule industry money.",17:19:40,DD
KXSC67285952600921,GB64WRNU86151136321109,1/28/2017,37433.92,100002,N,Credited,SAFARI,PC,Cr,21:05:52,22:58:25,4/22/2021,73544746,919.66,7,"Man purpose management. Same member with bad. Member shake can feeling.
Change far campaign message argue story. This high enter seat main. Media begin research stay public impact field nature.",21:35:50,DD
KXSC67285952600921,GB64WRNU86151136321109,1/28/2017,38134.86,100002,N,Credited,SAFARI,MOBILE,Cr,6:26:38,9:19:35,4/23/2021,68169626,700.94,1,"Force respond she dinner draw form project cost. Role data plant return fill popular.
Growth a book even mission clear. Long wait street account toward whom Mr beautiful.",7:44:26,NEFT
KXSC67285952600921,GB64WRNU86151136321109,1/28/2017,38835.8,100002,N,Credited,OPERA,PC,Cr,7:19:58,8:53:29,4/23/2021,93474764,700.94,6,"Pm research score could amount. Ever message identify woman.
Run board lawyer lead figure family. Single radio each. Ability military like husband.",8:21:05,CHEQUE
KXSC67285952600921,GB64WRNU86151136321109,1/28/2017,38134.86,100002,Y,Entertainment,CHROME,PC,Dr,15:00:09,16:18:00,4/23/2021,44968199,700.94,2,"Seek bag hospital sea gas family ten should. Series worker anyone deep with. Wide country reflect her edge national.
Sister prove affect station. This discuss well people.",15:42:55,IMPS
KXSC67285952600921,GB64WRNU86151136321109,1/28/2017,38835.8,100002,N,Credited,SAFARI,PC,Cr,15:39:59,18:38:36,4/23/2021,36321629,700.94,4,"Use a level exactly including. Meet election material how condition window.
Happen coach pay new rate get us. Understand several pass learn difference.",17:07:31,UPI
KXSC67285952600921,GB64WRNU86151136321109,1/28/2017,39536.74,100002,N,Credited,FF,MOBILE,Cr,21:34:27,24:10:20,4/23/2021,68399986,700.94,5,Action father still sort happen crime executive fall. Pass lay stage hope so area seat radio. Son save between knowledge teach wish.,23:30:22,CARDS
KXSC67285952600921,GB64WRNU86151136321109,1/28/2017,40854.53,100002,N,Credited,MI,PC,Cr,7:19:26,12:44:13,4/29/2021,20252427,1317.79,5,"Pretty site shake central woman decision. Feeling space shake several. Above detail call not perform present family.
Address senior on. Day sit ok theory.",9:29:40,CARDS
KXSC67285952600921,GB64WRNU86151136321109,1/28/2017,39536.74,100002,Y,Insurance,IE,PC,Dr,15:49:43,20:38:37,4/29/2021,10571873,1317.79,6,"Vote contain morning development.
President boy any appear. Hour any close teacher quality.
Scientist myself beyond. Week table race full interest tough but.",17:31:00,CHEQUE
KXSC67285952600921,GB64WRNU86151136321109,1/28/2017,39506.69,100002,Y,Entertainment,MI,POS,Dr,10:43:17,17:46:52,5/4/2021,81309986,30.05,7,"Among mention leg decade reflect. Behavior degree simple employee third.
Thought pretty bring ever floor style. Reduce knowledge mind prove eat lot approach. Moment hard Mr them.",14:07:10,DD
KXSC67285952600921,GB64WRNU86151136321109,1/28/2017,39476.64,100002,Y,Personal Care,CHROME,MOBILE,Dr,18:14:57,20:26:16,5/4/2021,88990330,30.05,2,Travel someone product federal glass eat. Herself always not best build decade. Sign international newspaper so site degree fund cultural.,19:22:55,IMPS
KXSC67285952600921,GB64WRNU86151136321109,1/28/2017,39807.82,100002,N,Credited,EDGE,MOBILE,Cr,4:16:19,7:14:31,5/8/2021,59173977,331.18,4,"Leg card sit physical face indeed. Sort light place social seat. Miss amount water along.
Strategy conference like budget year money. Six budget use soldier no.",5:37:17,UPI
KXSC67285952600921,GB64WRNU86151136321109,1/28/2017,40139,100002,N,Credited,MI,POS,Cr,9:35:13,12:03:35,5/8/2021,7900907,331.18,6,"Hold process apply leg system. Paper standard guy vote cultural oil party foot. Participant race should score care.
Together safe type. Media cover matter to able shake.",10:15:40,CHEQUE
KXSC67285952600921,GB64WRNU86151136321109,1/28/2017,39807.82,100002,Y,Entertainment,OPERA,POS,Dr,13:55:05,16:34:33,5/8/2021,84062956,331.18,1,"Modern impact source word. Purpose brother night too.
Along national herself decide. North including budget stay central contain. Way figure writer chance.",15:09:45,NEFT
KXSC67285952600921,GB64WRNU86151136321109,1/28/2017,40139,100002,N,Credited,SAFARI,POS,Cr,16:50:40,19:01:02,5/8/2021,25774726,331.18,7,Remember health church skin world hundred ever. Box rate lay today north prevent fish. Political guess reduce work.,18:07:41,DD
KXSC67285952600921,GB64WRNU86151136321109,1/28/2017,40470.18,100002,N,Credited,CHROME,POS,Cr,19:45:11,21:29:17,5/8/2021,89918555,331.18,7,"Cause section opportunity kid. Entire answer American Congress. Increase realize also.
Magazine employee move reason technology perhaps. Police spring amount impact. Relate build heart.",20:28:21,DD
KXSC67285952600921,GB64WRNU86151136321109,1/28/2017,39339.62,100002,Y,Entertainment,SAFARI,POS,Dr,4:32:26,6:09:38,5/16/2021,1158021,1130.56,1,"Nor management follow worry. Sea guess admit star teach moment reach.
Resource significant employee well. Wear sort subject use medical front he.",4:58:22,NEFT
KXSC67285952600921,GB64WRNU86151136321109,1/28/2017,38209.06,100002,Y,Personal Care,CHROME,POS,Dr,6:55:43,9:27:38,5/16/2021,24310208,1130.56,4,"Hospital simple oil smile training ten. Group view range I build.
Debate together myself money paper lead. Their lot poor detail right improve reason.",8:43:55,UPI
KXSC67285952600921,GB64WRNU86151136321109,1/28/2017,37078.5,100002,Y,Utilities,FF,PC,Dr,11:30:47,13:11:51,5/16/2021,57480091,1130.56,6,Will open remain material soldier over friend major. Child check receive staff happy far. Seek seek father face mother college reason. Subject ground approach month.,12:38:38,CHEQUE
KXSC67285952600921,GB64WRNU86151136321109,1/28/2017,35947.94,100002,Y,Utilities,IE,MOBILE,Dr,16:17:48,19:30:32,5/16/2021,86621748,1130.56,7,"Heart camera article parent.
Operation these daughter process ok career. Always detail at edge maintain goal response write. Perform shoulder project party miss.",17:33:49,DD
KXSC67285952600921,GB64WRNU86151136321109,1/28/2017,37078.5,100002,N,Credited,MI,PC,Cr,19:59:18,22:30:28,5/16/2021,89941515,1130.56,6,Star travel deep station kitchen democratic over she. Chair one young must. Plan seek his common region what.,21:20:24,CHEQUE
KXSC67285952600921,GB64WRNU86151136321109,1/28/2017,36410.83,100002,Y,Medicals,OPERA,MOBILE,Dr,4:08:50,6:52:29,5/20/2021,95184364,667.67,1,"Degree short far. Year continue certain run after. Let sign several reduce tell.
Support wrong professor even building state. Believe since never place different never.",5:09:23,NEFT
KXSC67285952600921,GB64WRNU86151136321109,1/28/2017,35743.16,100002,Y,Dining,IE,MOBILE,Dr,10:22:55,11:17:37,5/20/2021,51132101,667.67,1,Often social just challenge bit. Writer PM oil field affect research another entire. Information marriage yeah phone relationship education easy rate.,10:53:23,NEFT
KXSC67285952600921,GB64WRNU86151136321109,1/28/2017,35075.49,100002,Y,Dining,IE,POS,Dr,11:30:57,13:41:05,5/20/2021,96296448,667.67,3,"Cover which pressure. Plan enjoy bill international back.
Trip everything year note which player. Assume thought event. Seven their picture air son their full.",12:30:56,RTGS
KXSC67285952600921,GB64WRNU86151136321109,1/28/2017,35743.16,100002,N,Credited,MI,PC,Cr,15:43:06,18:14:51,5/20/2021,91986580,667.67,7,Here wish check road. Place talk child include south standard.,17:12:31,DD
KXSC67285952600921,GB64WRNU86151136321109,1/28/2017,36410.83,100002,N,Credited,OPERA,PC,Cr,21:22:48,23:32:07,5/20/2021,11210474,667.67,2,Miss on purpose star. Trade southern central us while. Simple size heart middle unit consider.,23:00:54,IMPS
KXSC67285952600921,GB64WRNU86151136321109,1/28/2017,35952.5,100002,Y,Rent,SAFARI,MOBILE,Dr,4:52:03,7:13:20,5/27/2021,45361500,458.33,6,"Interview range join capital move. Fly or most benefit.
Big challenge again along. Itself involve often because yard program.",5:41:07,CHEQUE
KXSC67285952600921,GB64WRNU86151136321109,1/28/2017,35494.17,100002,Y,Transportation,MI,MOBILE,Dr,8:42:59,12:09:22,5/27/2021,61344747,458.33,6,Perform trade action memory economic time would resource. Card everybody stay. Law direction write history forget standard out.,10:29:51,CHEQUE
KXSC67285952600921,GB64WRNU86151136321109,1/28/2017,35035.84,100002,Y,Personal Care,EDGE,POS,Dr,13:55:31,16:04:02,5/27/2021,29187331,458.33,1,Full third interesting increase could authority. Oil finally air billion behind only. West money attention party here wait.,15:29:52,NEFT
KXSC67285952600921,GB64WRNU86151136321109,1/28/2017,34577.51,100002,Y,Insurance,MI,MOBILE,Dr,16:18:04,18:50:15,5/27/2021,84311146,458.33,2,The land brother able determine allow. Industry news win tax thank.,18:08:02,IMPS
KXSC67285952600921,GB64WRNU86151136321109,1/28/2017,35035.84,100002,N,Credited,FF,MOBILE,Cr,22:24:54,25:16:21,5/27/2021,96039021,458.33,4,Something sure walk high decade suggest. Special mention mind today environmental series. Perform whatever party on.,23:40:12,UPI
KXSC67285952600921,GB64WRNU86151136321109,1/28/2017,33782.83,100002,Y,Online Shopping,SAFARI,PC,Dr,4:36:18,7:11:19,5/29/2021,72208434,1253.01,7,Policy lawyer sing either skill serve. Kind go college policy already do respond.,5:34:41,DD
KXSC67285952600921,GB64WRNU86151136321109,1/28/2017,35035.84,100002,N,Credited,CHROME,PC,Cr,7:13:09,10:33:55,5/29/2021,92119475,1253.01,7,"Standard physical stuff whether work particularly first. Rule PM difference radio small successful group.
Loss herself chance receive answer always event.",8:57:08,DD
KXSC67285952600921,GB64WRNU86151136321109,1/28/2017,33782.83,100002,Y,Household Consumables,EDGE,POS,Dr,14:55:41,17:32:00,5/29/2021,89918005,1253.01,3,During audience general someone yet name three. So nature film down hand board million.,15:38:52,RTGS
KXSC67285952600921,GB64WRNU86151136321109,1/28/2017,32529.82,100002,Y,Groceries,IE,PC,Dr,14:17:14,17:38:31,5/29/2021,63019735,1253.01,6,Property window however require fight agree garden. Name record several seat city similar. Positive seat just central rest just order international.,16:04:05,CHEQUE
KXSC67285952600921,GB64WRNU86151136321109,1/28/2017,33782.83,100002,N,Credited,OPERA,MOBILE,Cr,21:56:06,24:59:42,5/29/2021,30885776,1253.01,3,"Field including specific region scene site face. Democratic power here create although Mrs time office.
Trouble rate follow wind short anything. Strong care west summer article.",23:18:53,RTGS
KXSC67285952600921,GB64WRNU86151136321109,1/28/2017,35060.89,100002,N,Credited,SAFARI,PC,Cr,2:29:24,4:57:51,6/4/2021,47210936,1278.06,5,Outside community those father particular pattern. Area time first account wall dog while. Experience perhaps organization onto.,4:11:18,CARDS
KXSC67285952600921,GB64WRNU86151136321109,1/28/2017,33782.83,100002,Y,Rent,IE,PC,Dr,9:21:34,11:42:05,6/4/2021,98286980,1278.06,1,"Impact hope baby center radio mission. Provide when lead hotel top already charge. Office approach heavy possible Republican.
Sign go leg. Carry call market fire fight pressure.",10:52:55,NEFT
KXSC67285952600921,GB64WRNU86151136321109,1/28/2017,35060.89,100002,N,Credited,FF,PC,Cr,11:59:36,15:23:44,6/4/2021,39297297,1278.06,4,Stand cup high. Success court less none research personal like. Condition wonder at method subject.,13:23:51,UPI
KXSC67285952600921,GB64WRNU86151136321109,1/28/2017,36338.95,100002,N,Credited,MI,MOBILE,Cr,17:26:42,20:26:55,6/4/2021,2374024,1278.06,7,"Leader choose itself human. Those charge along follow street last that position. Experience toward chair PM morning.
With why ahead mean see serve tough. Wall old often west interesting.",19:13:01,DD
KXSC67285952600921,GB64WRNU86151136321109,1/28/2017,37617.01,100002,N,Credited,EDGE,PC,Cr,19:19:37,22:27:53,6/4/2021,57131283,1278.06,5,"Top way project. Fight positive may game next. Significant eat see point factor really agreement stay.
Decision indicate public expect current. Various recognize writer.",20:45:37,CARDS
KXSC67285952600921,GB64WRNU86151136321109,1/28/2017,38759.7,100002,N,Credited,OPERA,MOBILE,Cr,5:12:40,9:24:05,6/10/2021,24485715,1142.69,5,"Big plant network several. Cultural front program me.
However they accept must real. Eye few trade large body.",8:08:25,CARDS
KXSC67285952600921,GB64WRNU86151136321109,1/28/2017,39902.39,100002,N,Credited,EDGE,PC,Cr,17:43:18,23:11:01,6/10/2021,11245995,1142.69,7,"Season boy first level guy doctor with director.
Ago morning trouble room town fire simple according. Director individual financial kid eat reflect. Economy face minute material attorney car friend.",19:32:53,DD
KXSC67285952600921,GB64WRNU86151136321109,1/28/2017,41682.91,100002,N,Credited,IE,PC,Cr,4:31:02,8:28:34,6/11/2021,79763493,1780.52,5,"Forget two ahead close effect watch billion. Finish challenge capital light. Choice most identify bit.
Tree sign cell opportunity information. Relationship organization such pretty star.",6:07:25,CARDS
KXSC67285952600921,GB64WRNU86151136321109,1/28/2017,43463.43,100002,N,Credited,CHROME,PC,Cr,11:51:57,13:47:48,6/11/2021,83606847,1780.52,3,"Act produce gun and attack. Various teacher industry box individual.
Mean opportunity white. Raise during especially central coach case.",12:51:12,RTGS
KXSC67285952600921,GB64WRNU86151136321109,1/28/2017,41682.91,100002,Y,Transportation,SAFARI,POS,Dr,14:31:22,17:42:16,6/11/2021,51844851,1780.52,7,"Question style activity begin defense whether. Amount director common think. And base and ten impact detail remain.
Money do simple use. Rather blood environment also food protect turn.",16:25:03,DD
KXSC67285952600921,GB64WRNU86151136321109,1/28/2017,39902.39,100002,Y,Rent,CHROME,POS,Dr,21:03:28,23:35:14,6/11/2021,484541,1780.52,6,"Style vote risk though. Together under most wonder special since. Too law voice edge letter.
Without method consider record. Ability thank Republican million wear.",22:26:10,CHEQUE
KXSC67285952600921,GB64WRNU86151136321109,1/28/2017,38200.27,100002,Y,Utilities,IE,POS,Dr,8:15:34,17:40:57,6/17/2021,57847795,1702.12,3,Establish little check tax around office. Deal growth fact agent foreign learn girl risk. Spend red kind model. Road movie girl join remain prove.,12:28:16,RTGS
KXSC67285952600921,GB64WRNU86151136321109,1/28/2017,38576.05,100002,N,Credited,FF,POS,Cr,5:39:16,7:58:50,7/3/2021,77303066,375.78,2,"Hospital network civil game still conference. Race clearly dog health draw. Name lead full imagine power.
Federal return standard leg today she. Send current show position nice film.",6:50:42,IMPS
KXSC67285952600921,GB64WRNU86151136321109,1/28/2017,38200.27,100002,Y,Dining,MI,POS,Dr,10:05:23,12:30:36,7/3/2021,75596149,375.78,7,By almost forget baby audience in skin. Social someone around only hold out may.,11:43:57,DD
KXSC67285952600921,GB64WRNU86151136321109,1/28/2017,37824.49,100002,Y,Groceries,MI,POS,Dr,13:16:44,15:35:18,7/3/2021,55184953,375.78,4,"Whole ready them radio.
Operation similar everything not customer behavior next. Success financial reality road bill system.",14:35:15,UPI
KXSC67285952600921,GB64WRNU86151136321109,1/28/2017,38200.27,100002,N,Credited,CHROME,PC,Cr,17:53:58,20:43:41,7/3/2021,61581074,375.78,2,"Night make soon south visit project. Attention according drug over.
Week picture girl treat fund by exactly. Listen everybody size consumer amount door. Act live natural market attorney.",18:46:44,IMPS
KXSC67285952600921,GB64WRNU86151136321109,1/28/2017,38576.05,100002,N,Credited,CHROME,POS,Cr,18:55:50,21:45:09,7/3/2021,14629983,375.78,4,"Quickly century try card professor table little whom. Central director purpose about game.
Difficult leg service account. Man enter gas professor. Sure day region role listen point institution.",20:30:37,UPI
KXSC67285952600921,GB64WRNU86151136321109,1/28/2017,38372.42,100002,Y,Household Consumables,CHROME,PC,Dr,3:45:12,6:11:08,7/4/2021,67772476,203.63,4,"East pattern our act hair.
Another method control rich attorney likely. Federal close floor accept kitchen ago according thing. Note tell maintain music truth.
Fear other where book system great.",4:21:55,UPI
KXSC67285952600921,GB64WRNU86151136321109,1/28/2017,38576.05,100002,N,Credited,SAFARI,MOBILE,Cr,9:30:02,11:58:09,7/4/2021,44194239,203.63,3,"Maintain improve budget building wrong include baby. Once edge color throughout our. Congress old stand whom upon.
Out wrong food wait level director. Ground song west size administration.",10:08:42,RTGS
KXSC67285952600921,GB64WRNU86151136321109,1/28/2017,38779.68,100002,N,Credited,IE,MOBILE,Cr,12:54:46,15:24:31,7/4/2021,63797794,203.63,7,See matter ever card green none material investment. Party by set federal.,13:39:03,DD
KXSC67285952600921,GB64WRNU86151136321109,1/28/2017,38983.31,100002,N,Credited,FF,PC,Cr,18:15:54,21:30:15,7/4/2021,4324829,203.63,1,Anyone door late case. Start animal pass away week. Person power budget too realize. Institution few bed note.,19:32:32,NEFT
KXSC67285952600921,GB64WRNU86151136321109,1/28/2017,38779.68,100002,Y,Personal Care,EDGE,PC,Dr,19:30:06,22:58:41,7/4/2021,22682666,203.63,1,"Police teacher day way. Before public exist camera mind cover.
Anything step agree. Suffer security base. Focus action audience send future. It enter section must everyone.",21:24:34,NEFT
KXSC67285952600921,GB64WRNU86151136321109,1/28/2017,37649.1,100002,Y,Rent,CHROME,MOBILE,Dr,17:43:53,24:05:09,7/5/2021,26912189,1130.58,2,"Away middle already religious student speech.
Result garden bank despite since key. Sense wife seven cause will join attorney.",21:02:53,IMPS
KXSC67285952600921,GB64WRNU86151136321109,1/28/2017,38538.38,100002,N,Credited,SAFARI,POS,Cr,13:04:37,16:28:43,7/7/2021,99639556,889.28,6,Why how cell brother laugh. Traditional structure strategy resource not generation why. Mouth notice significant boy explain hotel scene buy.,14:24:09,CHEQUE
KXSC67285952600921,GB64WRNU86151136321109,1/28/2017,36909.41,100002,Y,Dining,IE,POS,Dr,7:46:27,10:40:21,7/10/2021,99656270,1628.97,7,"Cost more statement behavior western. Could enter daughter turn door reveal cover.
Speech season left ever. Write up partner. Action billion door account find stay.",9:55:21,DD
KXSC67285952600921,GB64WRNU86151136321109,1/28/2017,35280.44,100002,Y,Dining,EDGE,MOBILE,Dr,11:47:46,15:02:34,7/10/2021,29423354,1628.97,6,"Herself cup human role attack identify. Manager under study brother eat movie lead.
Question agent rather name important society. Yet animal production plan. Ability anyone simply issue hope.",13:33:20,CHEQUE
KXSC67285952600921,GB64WRNU86151136321109,1/28/2017,33651.47,100002,Y,Transportation,EDGE,MOBILE,Dr,21:17:50,24:39:48,7/10/2021,11038030,1628.97,3,"Approach stop own movement place by. Agent yourself several manager.
Traditional close more. Quality recently traditional that hear talk include. Book week speech this send.",22:29:05,RTGS
KXSC67285952600921,GB64WRNU86151136321109,1/28/2017,33270.84,100002,Y,Household Consumables,EDGE,POS,Dr,5:15:10,8:22:59,7/26/2021,59243724,380.63,5,"Writer training no would suddenly large care. Perform list threat will. Stock science over evidence.
Give southern attention research for gas.",6:40:16,CARDS
KXSC67285952600921,GB64WRNU86151136321109,1/28/2017,33651.47,100002,N,Credited,SAFARI,MOBILE,Cr,9:18:42,11:30:33,7/26/2021,34500255,380.63,3,Seat want card rest sort safe ok. Use side left fast early public. Husband character eight.,10:23:55,RTGS
KXSC67285952600921,GB64WRNU86151136321109,1/28/2017,34032.1,100002,N,Credited,CHROME,MOBILE,Cr,18:06:05,20:55:14,7/26/2021,51353483,380.63,4,Class claim push letter be age family. Thus rise study newspaper. Itself data write evidence more life.,18:39:09,UPI
KXSC67285952600921,GB64WRNU86151136321109,1/28/2017,34412.73,100002,N,Credited,IE,PC,Cr,19:17:51,23:32:59,7/26/2021,73913306,380.63,2,"Recent authority once bank happen. Watch point significant. Good itself community.
Anything much might inside whole report finally. Environmental than cover middle year attention finally.",21:37:45,IMPS
KXSC67285952600921,GB64WRNU86151136321109,1/28/2017,35397.3,100002,N,Credited,EDGE,MOBILE,Cr,6:45:17,9:18:58,7/27/2021,95982892,984.57,1,Interesting stay paper thought on. Decade foot just investment number dream. System bad bag top member exactly. Hundred American as which.,7:50:26,NEFT
KXSC67285952600921,GB64WRNU86151136321109,1/28/2017,34412.73,100002,Y,Online Shopping,FF,POS,Dr,10:48:03,12:16:11,7/27/2021,72266854,984.57,4,"President plan knowledge page. Anyone two democratic news include itself second PM. Fast issue condition most.
Beat design collection sea. Recognize view particularly total mean three remain.",11:34:04,UPI
KXSC67285952600921,GB64WRNU86151136321109,1/28/2017,33428.16,100002,Y,Groceries,OPERA,PC,Dr,15:23:46,19:03:03,7/27/2021,76410741,984.57,5,Happen apply tell nor discussion alone point. Spend medical attention. Civil system bring financial. Base serve dream occur worker opportunity move.,17:07:44,CARDS
KXSC67285952600921,GB64WRNU86151136321109,1/28/2017,34412.73,100002,N,Credited,IE,PC,Cr,18:58:59,23:02:12,7/27/2021,32173055,984.57,7,Just option first much next choice. With far camera sell executive past. Specific put interesting recent full fast.,20:57:29,DD
KXSC67285952600921,GB64WRNU86151136321109,1/28/2017,36251.69,100002,N,Credited,SAFARI,PC,Cr,6:33:19,9:45:26,8/2/2021,33940373,1838.96,2,"Wonder parent no simple. Small data sign.
Parent foreign third president anything report. Structure pressure rate on environmental. Put song my heart mother security.",8:20:21,IMPS
KXSC67285952600921,GB64WRNU86151136321109,1/28/2017,38090.65,100002,N,Credited,EDGE,MOBILE,Cr,13:40:33,17:03:03,8/2/2021,70240504,1838.96,3,"Cup military model north million. Serve wait music teacher.
Lawyer let summer defense kitchen. Education bill contain teacher action plant.",15:44:42,RTGS
KXSC67285952600921,GB64WRNU86151136321109,1/28/2017,39929.61,100002,N,Credited,CHROME,MOBILE,Cr,20:29:50,23:21:19,8/2/2021,8119940,1838.96,2,Conference program wide teach history and can. Opportunity five out themselves. Entire difference dream.,21:35:23,IMPS
KXSC67285952600921,GB64WRNU86151136321109,1/28/2017,41213.26,100002,N,Credited,EDGE,MOBILE,Cr,17:24:11,26:37:06,8/17/2021,11048947,1283.65,7,"Among network environment strategy. Station east budget week professor newspaper.
At rock usually some.",21:06:21,DD
KXSC67285952600921,GB64WRNU86151136321109,1/28/2017,42152.17,100002,N,Credited,EDGE,POS,Cr,5:19:49,8:02:38,8/21/2021,79922609,938.91,4,"Recognize sense technology someone admit six plant. Tend protect voice put itself carry focus. Professor usually of must child.
When camera resource might recently.",7:02:08,UPI
KXSC67285952600921,GB64WRNU86151136321109,1/28/2017,41213.26,100002,Y,Dining,IE,POS,Dr,11:02:04,14:06:34,8/21/2021,55618243,938.91,1,"Member early specific miss card human. Defense floor mind face between clear moment. Agreement decade matter paper operation example.
Key true need. Behind nor chance while kitchen car reason.",12:50:30,NEFT
KXSC67285952600921,GB64WRNU86151136321109,1/28/2017,42152.17,100002,N,Credited,MI,POS,Cr,15:09:42,17:31:05,8/21/2021,66319344,938.91,5,"Body program subject same get major management. Site training this. Instead war do trial.
Beat exist beat capital shoulder successful half. Fight prove garden movement reason successful.",16:11:33,CARDS
KXSC67285952600921,GB64WRNU86151136321109,1/28/2017,43091.08,100002,N,Credited,EDGE,POS,Cr,22:09:30,24:34:59,8/21/2021,69639074,938.91,1,Business ago first behavior skill go. Leader section size firm continue. Writer hot sing answer enjoy loss simply local.,23:57:17,NEFT
KXSC67285952600921,GB64WRNU86151136321109,1/28/2017,44523.32,100002,N,Credited,FF,POS,Cr,5:04:55,9:00:08,8/22/2021,97402725,1432.24,3,"Process man financial dark under gun.
Certain former little close.
Lawyer individual trial difficult. Popular defense by share agent manager.",7:13:17,RTGS
KXSC67285952600921,GB64WRNU86151136321109,1/28/2017,43091.08,100002,Y,Dining,CHROME,MOBILE,Dr,12:55:23,15:50:22,8/22/2021,1910124,1432.24,7,Face else four adult develop effort. Majority year yard how miss media. Need cover sort some treat matter.,14:51:45,DD
KXSC67285952600921,GB64WRNU86151136321109,1/28/2017,41658.84,100002,Y,Online Shopping,EDGE,MOBILE,Dr,20:22:01,25:26:20,8/22/2021,28682424,1432.24,4,Direction somebody adult artist yard through increase. Letter listen share fill home home. Manage cause policy city away responsibility hard population. Certain way she design just.,22:29:22,UPI
KXSC67285952600921,GB64WRNU86151136321109,1/28/2017,40780.72,100002,Y,Groceries,FF,POS,Dr,18:22:02,22:50:06,9/3/2021,70314922,878.12,3,"Machine any performance miss positive program. Maybe assume opportunity loss son ago take out.
Physical without high style fire.",19:49:05,RTGS
KXSC67285952600921,GB64WRNU86151136321109,1/28/2017,42600.73,100002,N,Credited,MI,PC,Cr,8:55:13,15:28:25,9/7/2021,30862906,1820.01,1,Cup part wonder child doctor notice. Throw church so. Technology color price officer. Bag traditional here can authority development media.,12:47:47,NEFT
KXSC67285952600921,GB64WRNU86151136321109,1/28/2017,44420.74,100002,N,Credited,SAFARI,PC,Cr,15:27:07,19:48:56,9/7/2021,8530554,1820.01,6,"Approach share day thus. Eight accept author write hotel. Night of forget heart research leave.
Resource thing form agent. Machine worker tough movement catch party.
Phone pay stock power.",16:49:29,CHEQUE
KXSC67285952600921,GB64WRNU86151136321109,1/28/2017,46086.95,100002,N,Credited,MI,POS,Cr,4:01:09,9:06:44,9/12/2021,16400955,1666.21,5,Still student support care. All discover subject expect put very interview. Carry high enter attention. Learn idea agent travel society event.,6:38:08,CARDS
KXSC67285952600921,GB64WRNU86151136321109,1/28/2017,44420.74,100002,Y,Insurance,CHROME,MOBILE,Dr,12:01:50,16:52:40,9/12/2021,50851560,1666.21,1,And family artist trial subject wish read. West school suffer news. Any life Republican. Shake perhaps reason bit per could.,14:56:23,NEFT
KXSC67285952600921,GB64WRNU86151136321109,1/28/2017,42754.53,100002,Y,Household Consumables,MI,MOBILE,Dr,19:02:04,24:18:45,9/12/2021,16103177,1666.21,1,Affect together one white many. Continue person ready what discuss here Democrat. No life clearly away especially window total. High treatment young federal whom smile clearly race.,21:32:05,NEFT
KXSC67285952600921,GB64WRNU86151136321109,1/28/2017,44475.02,100002,N,Credited,OPERA,PC,Cr,9:16:36,13:16:16,9/21/2021,43258598,1720.49,5,"Pay partner interesting too action do discover. Coach positive consumer skill agree stuff.
Pay pressure like great avoid responsibility. Campaign together offer.",11:35:35,CARDS
KXSC67285952600921,GB64WRNU86151136321109,1/28/2017,42754.53,100002,Y,Entertainment,IE,PC,Dr,16:14:52,17:59:26,9/21/2021,12845859,1720.49,2,"Series agreement team fill open share edge.
Animal place deep strategy audience. We finally their.
Teach scene yourself of condition. He firm happen positive.",17:20:25,IMPS
KXSC67285952600921,GB64WRNU86151136321109,1/28/2017,44475.02,100002,N,Credited,SAFARI,PC,Cr,19:55:32,23:47:00,9/21/2021,86049603,1720.49,4,"Prepare fall later according wife fly. Nearly send page newspaper add senior dark.
Great might between attorney. Social image today treatment might our let.",22:50:29,UPI
KXSC67285952600921,GB64WRNU86151136321109,1/28/2017,44462.71,100002,Y,Entertainment,IE,POS,Dr,7:55:59,18:50:52,9/24/2021,70770759,12.31,2,Beat movie enjoy outside detail. Sit democratic while three above. Must language nation nothing eye maintain century. Yourself upon there street economic race maybe.,13:53:07,IMPS
KXSC67285952600921,GB64WRNU86151136321109,1/28/2017,43965.65,100002,Y,Dining,CHROME,POS,Dr,8:30:35,10:41:02,9/26/2021,47798403,497.06,7,"Down work hospital. President half reality raise read ok. Commercial student our past.
We cost top American identify clear rise. Which stop with compare know.",9:21:19,DD
KXSC67285952600921,GB64WRNU86151136321109,1/28/2017,44462.71,100002,N,Credited,SAFARI,PC,Cr,9:40:07,12:21:44,9/26/2021,11989363,497.06,7,"Provide defense nearly hot inside. Begin party marriage camera raise idea.
Spend view lawyer machine community town difficult.",11:38:51,DD
KXSC67285952600921,GB64WRNU86151136321109,1/28/2017,44959.77,100002,N,Credited,CHROME,POS,Cr,15:50:26,17:57:43,9/26/2021,55096409,497.06,6,"Page protect as fact start. Long three yourself military.
Method only more country. Place most eat identify.
Use door little century our star today. Watch often family past total.",16:25:11,CHEQUE
KXSC67285952600921,GB64WRNU86151136321109,1/28/2017,45456.83,100002,N,Credited,IE,POS,Cr,19:33:51,20:54:52,9/26/2021,95046334,497.06,2,Into memory sign fire also hand senior young. Operation wait growth good senior raise far.,20:25:59,IMPS
KXSC67285952600921,GB64WRNU86151136321109,1/28/2017,45898.34,100002,N,Credited,CHROME,POS,Cr,4:51:04,7:35:11,9/27/2021,95440088,441.51,7,Child talk month wrong production window point. Administration that allow modern. Rise performance fast support pay every less rich.,6:26:31,DD
KXSC67285952600921,GB64WRNU86151136321109,1/28/2017,46339.85,100002,N,Credited,SAFARI,MOBILE,Cr,6:44:36,10:02:14,9/27/2021,21683886,441.51,4,"Will admit always. College age my bit. Stop claim some stand production.
Most memory no food civil attorney. Involve guess television probably position. Movement ability many day take month turn.",8:31:17,UPI
KXSC67285952600921,GB64WRNU86151136321109,1/28/2017,45898.34,100002,Y,Medicals,EDGE,POS,Dr,13:39:42,15:26:36,9/27/2021,32148879,441.51,5,Generation hear mother well establish cup research. Experience certain any institution here. Believe else find page. Hand successful ok lot much.,14:32:59,CARDS
KXSC67285952600921,GB64WRNU86151136321109,1/28/2017,45456.83,100002,Y,Online Shopping,IE,POS,Dr,14:45:47,17:00:38,9/27/2021,30861282,441.51,6,Attorney year serious material option wrong how various. Class east himself professor push song city. Child whether role many song where.,16:26:10,CHEQUE
KXSC67285952600921,GB64WRNU86151136321109,1/28/2017,45898.34,100002,N,Credited,CHROME,POS,Cr,22:37:29,25:01:37,9/27/2021,67824014,441.51,1,"Carry around only senior expert heart how. Education pick we leader it.
Project rule common end appear. Just high mention build. Partner focus yourself however.",23:38:04,NEFT
KXSC67285952600921,GB64WRNU86151136321109,1/28/2017,45179.01,100002,Y,Rent,FF,PC,Dr,3:37:06,5:40:41,9/30/2021,28504580,719.33,2,"Official effect others reveal authority feeling. Positive half newspaper.
Soldier manage fact during material.",4:23:22,IMPS
KXSC67285952600921,GB64WRNU86151136321109,1/28/2017,44459.68,100002,Y,Dining,CHROME,POS,Dr,10:07:34,12:26:02,9/30/2021,19762784,719.33,2,"Bar stage this meeting rich performance to bit. Itself modern three reveal always population.
Open heavy mean outside another notice kitchen. Star media air concern director.",11:40:07,IMPS
KXSC67285952600921,GB64WRNU86151136321109,1/28/2017,45179.01,100002,N,Credited,OPERA,POS,Cr,12:07:06,15:02:49,9/30/2021,21955006,719.33,4,"Down I after service wide. Company different age local.
Reveal realize song turn mention.
Financial quickly leg enter time only item. International artist bring pass.",13:36:05,UPI
KXSC67285952600921,GB64WRNU86151136321109,1/28/2017,45898.34,100002,N,Credited,FF,MOBILE,Cr,17:44:28,20:42:22,9/30/2021,42446521,719.33,7,Expert air book may candidate indeed with you. Development after lay memory upon machine cell.,19:06:39,DD
KXSC67285952600921,GB64WRNU86151136321109,1/28/2017,46617.67,100002,N,Credited,SAFARI,PC,Cr,18:28:05,20:39:08,9/30/2021,99782047,719.33,6,Right approach development hand land. Police tax through really wife myself.,20:00:22,CHEQUE
KXSC67285952600921,GB64WRNU86151136321109,1/28/2017,46968.75,100002,N,Credited,OPERA,PC,Cr,5:11:18,9:06:02,10/3/2021,99574475,351.08,7,"Use picture throw begin. Drop part west TV direction.
Wish before child recent building.
Coach admit loss always. Writer day learn natural in keep involve every. Lead do size talk production.",6:47:23,DD
KXSC67285952600921,GB64WRNU86151136321109,1/28/2017,47319.83,100002,N,Credited,IE,POS,Cr,7:20:21,10:31:37,10/3/2021,42491460,351.08,3,Style factor prevent meeting daughter. Game way attorney hit become. Chance issue evidence that.,9:44:11,RTGS
KXSC67285952600921,GB64WRNU86151136321109,1/28/2017,46968.75,100002,Y,Online Shopping,FF,PC,Dr,16:36:40,18:36:31,10/3/2021,63395013,351.08,5,Kind to turn yet play close thought. What marriage teach. Hand under well blood season. Suffer task who world word some agent.,17:27:13,CARDS
KXSC67285952600921,GB64WRNU86151136321109,1/28/2017,46617.67,100002,Y,Insurance,CHROME,POS,Dr,20:04:42,22:54:17,10/3/2021,19035352,351.08,2,"Wait another arrive life develop watch so. Without worker subject gas do.
Same soon grow medical doctor. Great chance provide message Democrat expect.",22:11:58,IMPS
CXFY99245025482787,GB97FHKC16607677923892,11/26/2015,5163.51,100002,N,Credited,IE,MOBILE,Cr,6:10:20,8:24:55,1/2/2016,3245859,645.83,3,"Expert visit film wear my radio situation. Environmental camera total policy peace.
You hotel option happen. Meet start leg.",6:52:59,RTGS
CXFY99245025482787,GB97FHKC16607677923892,11/26/2015,4517.68,100002,Y,Insurance,IE,PC,Dr,12:10:25,15:01:03,1/2/2016,49736380,645.83,3,Law right race month almost leave. Hour television table. Watch be you oil.,13:50:59,RTGS
CXFY99245025482787,GB97FHKC16607677923892,11/26/2015,3871.85,100002,Y,Rent,CHROME,MOBILE,Dr,16:22:06,18:56:31,1/2/2016,58963951,645.83,6,"Hit note speech young game hospital. Dark available respond often address behind.
Data present clearly teach. Her talk although heavy. Management north least talk.",18:21:10,CHEQUE
CXFY99245025482787,GB97FHKC16607677923892,11/26/2015,4517.68,100002,N,Credited,MI,MOBILE,Cr,18:41:01,20:16:22,1/2/2016,77925077,645.83,2,"Result hit father. Modern everyone seat believe improve.
Nation second them usually son technology activity.",19:26:21,IMPS
CXFY99245025482787,GB97FHKC16607677923892,11/26/2015,5553.69,100002,N,Credited,SAFARI,PC,Cr,4:08:26,6:33:10,1/5/2016,41937280,1036.01,1,Both analysis race boy. Western read police increase church. Answer paper follow word behavior.,5:35:41,NEFT
CXFY99245025482787,GB97FHKC16607677923892,11/26/2015,6589.7,100002,N,Credited,OPERA,MOBILE,Cr,12:11:11,15:31:38,1/5/2016,9866713,1036.01,2,"Evening that yard send. Investment community example deal doctor build their. So sign carry goal fund.
Agency young court raise smile wish coach. Ask finish if night response.",14:18:53,IMPS
CXFY99245025482787,GB97FHKC16607677923892,11/26/2015,5553.69,100002,Y,Household Consumables,FF,MOBILE,Dr,15:47:47,17:39:09,1/5/2016,58803011,1036.01,6,Animal represent benefit total because. Choice each bar later always.,16:34:11,CHEQUE
CXFY99245025482787,GB97FHKC16607677923892,11/26/2015,6589.7,100002,N,Credited,MI,POS,Cr,20:23:30,23:21:17,1/5/2016,53666062,1036.01,3,Study dark exist sort day film. Idea middle imagine drop. Last produce him middle back.,21:44:00,RTGS
CXFY99245025482787,GB97FHKC16607677923892,11/26/2015,4749.5,100002,Y,Household Consumables,FF,MOBILE,Dr,9:37:12,18:04:42,1/20/2016,65395035,1840.2,6,"Wall your role by civil catch. Nice article western be.
Pay soldier pressure almost. Standard business believe age rate charge. Article go off reality finish.",13:08:40,CHEQUE
CXFY99245025482787,GB97FHKC16607677923892,11/26/2015,3420.28,100002,Y,Online Shopping,FF,POS,Dr,10:23:58,17:57:11,1/26/2016,92523517,1329.22,4,"Staff federal different civil American. Support beautiful four picture. Live doctor great laugh describe upon north.
Suffer between from among fire performance. Include up responsibility.",14:01:38,UPI
CXFY99245025482787,GB97FHKC16607677923892,11/26/2015,4749.5,100002,N,Credited,MI,POS,Cr,18:40:43,21:56:19,1/26/2016,39166791,1329.22,7,"Majority still people hair including side. Month pass fact kid meet. Discover tax black.
Assume remain today energy culture her black. Allow various way pretty.",20:14:07,DD
CXFY99245025482787,GB97FHKC16607677923892,11/26/2015,5148.71,100002,N,Credited,OPERA,POS,Cr,8:41:40,13:02:49,1/27/2016,91952042,399.21,4,"Beyond range while wall nation cold edge. Official attorney become heavy sing hold.
Treat child then stage probably career actually. Occur production business blood.",10:13:21,UPI
CXFY99245025482787,GB97FHKC16607677923892,11/26/2015,5547.92,100002,N,Credited,EDGE,POS,Cr,15:48:10,19:36:21,1/27/2016,17448796,399.21,7,Western only modern especially son city hope local. Leg wind inside amount authority human.,17:29:23,DD
CXFY99245025482787,GB97FHKC16607677923892,11/26/2015,5947.13,100002,N,Credited,CHROME,POS,Cr,19:25:05,22:02:28,1/27/2016,10664223,399.21,5,"Hit through recognize out parent.
Technology after hotel himself others gun. Partner course relationship. Behavior customer certainly total throw of fund.",20:34:01,CARDS
CXFY99245025482787,GB97FHKC16607677923892,11/26/2015,6924.27,100002,N,Credited,IE,POS,Cr,8:32:56,16:21:43,1/28/2016,50194650,977.14,7,"While show response look fund. Make since society. Memory edge home black bag. Hospital land face provide.
Attention standard themselves deep. Kid star service standard current.",14:27:18,DD
CXFY99245025482787,GB97FHKC16607677923892,11/26/2015,6954.58,100002,N,Credited,EDGE,MOBILE,Cr,8:51:52,11:40:56,1/29/2016,47214613,30.31,3,Sign system ability long finally land civil. Wife nothing population money already. Oil serious degree everybody machine. Plant always visit democratic truth never.,10:15:17,RTGS
CXFY99245025482787,GB97FHKC16607677923892,11/26/2015,6984.89,100002,N,Credited,SAFARI,MOBILE,Cr,13:28:51,17:00:02,1/29/2016,6762209,30.31,2,"Stand team capital high moment only alone cultural. Meeting simple foot community.
Big travel page range that. Four sure movie join read future stop entire.",16:15:21,IMPS
CXFY99245025482787,GB97FHKC16607677923892,11/26/2015,7015.2,100002,N,Credited,EDGE,MOBILE,Cr,19:45:39,23:56:08,1/29/2016,75870331,30.31,6,High ago cut line property provide. Agency effect other official.,21:20:37,CHEQUE
CXFY99245025482787,GB97FHKC16607677923892,11/26/2015,5033.11,100002,Y,Dining,EDGE,POS,Dr,14:18:39,21:10:45,2/5/2016,32661637,1982.09,2,"Computer character moment happy statement network kid. Clear effort if interest line.
Ready state game.",15:56:16,IMPS
CXFY99245025482787,GB97FHKC16607677923892,11/26/2015,6689.73,100002,N,Credited,OPERA,MOBILE,Cr,4:20:22,5:59:19,2/13/2016,89515082,1656.62,6,"Whole appear between enjoy sometimes. Different what size many time season.
Because between about art a audience stop half.",5:27:33,CHEQUE
CXFY99245025482787,GB97FHKC16607677923892,11/26/2015,8346.35,100002,N,Credited,OPERA,POS,Cr,7:13:36,9:57:16,2/13/2016,92059887,1656.62,6,Level star various maybe southern product head believe. Almost man fact player always show gas. Total notice bit imagine result sport section.,8:15:15,CHEQUE
CXFY99245025482787,GB97FHKC16607677923892,11/26/2015,6689.73,100002,Y,Utilities,OPERA,PC,Dr,12:35:14,16:08:21,2/13/2016,88140247,1656.62,3,"Front happy off training other film.
Dinner safe either young until bill third. Relationship Mrs kind again.",14:11:05,RTGS
CXFY99245025482787,GB97FHKC16607677923892,11/26/2015,5033.11,100002,Y,Transportation,EDGE,POS,Dr,18:42:09,21:17:16,2/13/2016,32796377,1656.62,7,Firm food mind fine bank point general. Until any improve.,19:35:44,DD
CXFY99245025482787,GB97FHKC16607677923892,11/26/2015,6689.73,100002,N,Credited,EDGE,PC,Cr,22:08:40,24:30:18,2/13/2016,36913244,1656.62,3,Through quite eight hair production interview forward. Gun course door visit character. Tough make save teach property issue. Art woman real join opportunity.,23:46:05,RTGS
CXFY99245025482787,GB97FHKC16607677923892,11/26/2015,5530.74,100002,Y,Utilities,IE,MOBILE,Dr,8:51:25,13:35:19,2/14/2016,7249822,1158.99,1,"Left north front trade. Education win two story even. Direction provide small stay.
Beyond next continue laugh. Recognize medical lose military day down.",10:28:21,NEFT
CXFY99245025482787,GB97FHKC16607677923892,11/26/2015,6689.73,100002,N,Credited,FF,PC,Cr,18:00:10,22:53:21,2/14/2016,28257,1158.99,6,"Line as court history. Several capital red well history realize investment.
Contain could state may individual center listen. Son suddenly because.",20:56:49,CHEQUE
CXFY99245025482787,GB97FHKC16607677923892,11/26/2015,6251.66,100002,Y,Rent,EDGE,POS,Dr,6:25:10,8:54:21,2/19/2016,15918994,438.07,6,Far raise rule line perform hold. Without several throughout if. Management purpose season.,7:40:32,CHEQUE
CXFY99245025482787,GB97FHKC16607677923892,11/26/2015,5813.59,100002,Y,Dining,IE,MOBILE,Dr,9:24:09,12:44:36,2/19/2016,35577553,438.07,4,"Art experience market. Task which music back suffer win to language. Age service ground investment myself star.
Music send gun. Speech throughout necessary room. Money bar boy site.",10:51:52,UPI
CXFY99245025482787,GB97FHKC16607677923892,11/26/2015,6251.66,100002,N,Credited,EDGE,PC,Cr,12:36:28,15:01:10,2/19/2016,66331568,438.07,3,"Television few indicate nearly similar imagine issue.
Sense against responsibility. Past treatment throughout up place action begin plan. Defense old huge feel.",13:16:52,RTGS
CXFY99245025482787,GB97FHKC16607677923892,11/26/2015,5813.59,100002,Y,Utilities,CHROME,PC,Dr,16:11:47,18:16:30,2/19/2016,53831637,438.07,1,Public continue budget thing PM past. Notice drive improve morning get. Option war answer memory office.,17:30:31,NEFT
CXFY99245025482787,GB97FHKC16607677923892,11/26/2015,5375.52,100002,Y,Dining,FF,MOBILE,Dr,18:30:12,21:24:25,2/19/2016,61302150,438.07,6,"Per career truth design although agency church.
Short issue throw before president. Piece trouble employee eight environmental station.",20:11:37,CHEQUE
CXFY99245025482787,GB97FHKC16607677923892,11/26/2015,4967.92,100002,Y,Transportation,MI,POS,Dr,4:16:17,6:56:39,2/25/2016,88585420,407.6,3,"Ten may actually form see choose. Themselves ground walk their.
Enter mind allow drug plant woman tell. Reflect small world maintain huge difference. Sister smile realize point include answer.",6:19:40,RTGS
CXFY99245025482787,GB97FHKC16607677923892,11/26/2015,4560.32,100002,Y,Online Shopping,IE,MOBILE,Dr,12:19:10,14:51:04,2/25/2016,87187816,407.6,3,"Check manager skin. Across move charge suddenly.
Art ground animal former within store. Give employee second player gas memory still exactly.",13:25:43,RTGS
CXFY99245025482787,GB97FHKC16607677923892,11/26/2015,4967.92,100002,N,Credited,SAFARI,PC,Cr,18:48:13,22:25:54,2/25/2016,96610978,407.6,3,"Short decade organization impact answer argue next music. Meet pressure minute million note. Recent western through top arm development today.
Agency ability every give. Figure little history level.",20:53:33,RTGS
CXFY99245025482787,GB97FHKC16607677923892,11/26/2015,5444.75,100002,N,Credited,IE,PC,Cr,5:56:08,11:07:47,2/26/2016,16128859,476.83,2,Where challenge suggest wrong head little human improve.,8:53:24,IMPS
CXFY99245025482787,GB97FHKC16607677923892,11/26/2015,5921.58,100002,N,Credited,MI,MOBILE,Cr,15:30:33,19:47:05,2/26/2016,98741755,476.83,4,"Air system produce morning anyone state. Ten couple a material.
Score from majority general again. Husband after here middle. Realize country focus.",17:39:02,UPI
CXFY99245025482787,GB97FHKC16607677923892,11/26/2015,5529.98,100002,Y,Entertainment,FF,PC,Dr,5:45:20,9:22:48,3/1/2016,49074178,391.6,1,Choose land suddenly still difference visit. Those yet thank question onto knowledge even affect. Hundred picture even there side future change.,7:09:22,NEFT
CXFY99245025482787,GB97FHKC16607677923892,11/26/2015,5921.58,100002,N,Credited,MI,PC,Cr,11:20:53,14:23:32,3/1/2016,37022327,391.6,5,"Choose and join. Include so man letter pattern information son.
Law public also need can. Current cause number yeah information make miss. Begin instead cost magazine.",12:00:50,CARDS
CXFY99245025482787,GB97FHKC16607677923892,11/26/2015,5529.98,100002,Y,Dining,OPERA,MOBILE,Dr,17:52:53,19:33:02,3/1/2016,38954658,391.6,6,Idea base degree individual rock strategy hotel growth. Center treatment answer mission plan. Activity third research we save successful.,18:58:51,CHEQUE
CXFY99245025482787,GB97FHKC16607677923892,11/26/2015,5138.38,100002,Y,Groceries,IE,MOBILE,Dr,19:59:43,22:30:50,3/1/2016,83087080,391.6,5,"Fight environmental mother.
Capital those man. People score sound feeling thought.
Allow direction would better. Book class decision nothing into strong. Off everyone start best person but.",21:14:48,CARDS
CXFY99245025482787,GB97FHKC16607677923892,11/26/2015,4045.2,100002,Y,Rent,FF,MOBILE,Dr,5:35:44,8:20:00,3/4/2016,90554155,1093.18,5,"Center front price down get pick citizen. Factor culture challenge case.
Already civil hour have ready mean himself. Program hope born its including. Account very condition few once.",7:41:56,CARDS
CXFY99245025482787,GB97FHKC16607677923892,11/26/2015,5138.38,100002,N,Credited,MI,MOBILE,Cr,10:25:57,13:03:53,3/4/2016,18779912,1093.18,7,"Also serious present rule recognize voice church meet. For consumer glass audience reduce.
Space position meet budget. Let project personal but newspaper. Wait everybody customer own long.",12:24:27,DD
CXFY99245025482787,GB97FHKC16607677923892,11/26/2015,4045.2,100002,Y,Online Shopping,IE,POS,Dr,17:31:00,19:52:18,3/4/2016,53577023,1093.18,6,Run camera impact around let movie director. Model agency wall next record human high.,18:14:08,CHEQUE
CXFY99245025482787,GB97FHKC16607677923892,11/26/2015,2952.02,100002,Y,Utilities,SAFARI,POS,Dr,18:01:44,21:43:43,3/4/2016,5291571,1093.18,2,Early never senior a push sea. Sense you remain. Recognize investment notice act.,20:11:39,IMPS
CXFY99245025482787,GB97FHKC16607677923892,11/26/2015,2699.84,100002,Y,Online Shopping,MI,PC,Dr,8:57:27,11:49:01,3/13/2016,16946774,252.18,7,"Return born enjoy together important notice. Military explain nothing personal study.
Form stuff together six. Rule thousand a southern. Technology something general he finally during medical.",10:47:04,DD
CXFY99245025482787,GB97FHKC16607677923892,11/26/2015,2447.66,100002,Y,Rent,FF,PC,Dr,12:35:11,16:30:44,3/13/2016,88931067,252.18,6,"By as here course. Gas then develop return.
Impact school decade certainly third.
Affect its left eat. Get form question animal relationship.",15:32:10,CHEQUE
CXFY99245025482787,GB97FHKC16607677923892,11/26/2015,2195.48,100002,Y,Rent,EDGE,POS,Dr,17:13:07,21:22:41,3/13/2016,67722594,252.18,3,"Magazine party environment very more. Cut by seat too item.
But experience like few painting instead. Social respond other point forward significant. Safe fast million reality.",18:53:50,RTGS
CXFY99245025482787,GB97FHKC16607677923892,11/26/2015,3888.6,100002,N,Credited,IE,MOBILE,Cr,3:19:35,6:04:24,3/19/2016,91187123,1693.12,3,"Since exist certain music involve current court.
Ago thus positive decide among whose show. Common card improve. When available clearly.",4:43:53,RTGS
CXFY99245025482787,GB97FHKC16607677923892,11/26/2015,2195.48,100002,Y,Online Shopping,EDGE,PC,Dr,10:00:36,11:54:26,3/19/2016,62597104,1693.12,5,"Value final beat case there mission. Assume well animal account then forward account admit.
Within million second treat case. Detail may record relationship worker fact lose.",10:48:28,CARDS
CXFY99245025482787,GB97FHKC16607677923892,11/26/2015,3888.6,100002,N,Credited,OPERA,POS,Cr,10:36:20,13:15:37,3/19/2016,32357851,1693.12,5,Buy middle political. Speech analysis office wear type. Natural skin reason finish bit part specific. New involve feeling central these environment.,12:16:20,CARDS
CXFY99245025482787,GB97FHKC16607677923892,11/26/2015,2195.48,100002,Y,Utilities,MI,PC,Dr,18:24:42,21:15:05,3/19/2016,1593259,1693.12,7,Eye read around prepare adult effect. Feeling financial however sit toward there letter. Whether compare game very not.,19:58:27,DD
CXFY99245025482787,GB97FHKC16607677923892,11/26/2015,3888.6,100002,N,Credited,FF,POS,Cr,19:56:08,22:14:16,3/19/2016,61357457,1693.12,5,"Event table sit structure travel. Large anyone above firm modern now agree. Pull operation her need between enter.
Everybody onto manager red help size they. Case far everything receive.",21:25:59,CARDS
CXFY99245025482787,GB97FHKC16607677923892,11/26/2015,4246.59,100002,N,Credited,MI,MOBILE,Cr,6:28:29,7:56:11,3/23/2016,5327355,357.99,4,"Thing here rise so. Goal up program enter during. Ask current song less inside Congress focus.
Focus will central clear type officer west. Agent imagine phone election spend.",7:17:26,UPI
CXFY99245025482787,GB97FHKC16607677923892,11/26/2015,3888.6,100002,Y,Insurance,FF,PC,Dr,6:53:33,9:41:50,3/23/2016,88105352,357.99,2,"Bank skin together area whatever. Phone operation shake the will hope.
Play several to thank. Staff recently crime gas above field. Example once either hit four author although.",8:41:43,IMPS
CXFY99245025482787,GB97FHKC16607677923892,11/26/2015,4246.59,100002,N,Credited,FF,POS,Cr,11:31:06,14:06:07,3/23/2016,58146385,357.99,5,Popular attention game idea responsibility north technology herself. Conference challenge recently put. Once room kid employee piece.,12:20:50,CARDS
CXFY99245025482787,GB97FHKC16607677923892,11/26/2015,4604.58,100002,N,Credited,EDGE,MOBILE,Cr,18:38:02,21:23:48,3/23/2016,49743791,357.99,3,"Require look me per. In major head up. Tv if summer resource remain book.
Add daughter series leave central door think. Control hard item sort inside.",19:49:30,RTGS
CXFY99245025482787,GB97FHKC16607677923892,11/26/2015,4962.57,100002,N,Credited,SAFARI,PC,Cr,19:25:14,22:48:42,3/23/2016,61645301,357.99,3,Ten community air wrong player. Camera build again name around participant. Bill tell industry audience as set.,21:21:35,RTGS
CXFY99245025482787,GB97FHKC16607677923892,11/26/2015,5023.82,100002,N,Credited,EDGE,PC,Cr,10:22:49,19:00:45,3/26/2016,18376548,61.25,7,"Party nature social increase. Run city everybody course.
Government add factor one gas begin. Who support according.
Month ago final.",13:37:41,DD
CXFY99245025482787,GB97FHKC16607677923892,11/26/2015,5693.69,100002,N,Credited,CHROME,POS,Cr,6:44:35,11:29:56,3/29/2016,52768934,669.87,5,"Garden home require table against. Opportunity series nice.
Pay room head series edge land book. Discussion place avoid once test central interest.",10:26:23,CARDS
CXFY99245025482787,GB97FHKC16607677923892,11/26/2015,5023.82,100002,Y,Medicals,SAFARI,MOBILE,Dr,20:22:39,24:57:48,3/29/2016,89657669,669.87,1,"Worry almost alone.
Candidate forget produce realize after able person nice. Drive improve financial arm under.
Issue Democrat nor seat. Paper cost thus story hard remain.",22:08:34,NEFT
CXFY99245025482787,GB97FHKC16607677923892,11/26/2015,3330.12,100002,Y,Entertainment,FF,PC,Dr,7:19:43,10:44:15,4/11/2016,42075226,1693.7,6,"Score even fly research.
Third lawyer how sister impact offer available. Risk central would clear election see.
Soldier agent city argue. Radio expert organization wish one spend thousand firm.",9:30:45,CHEQUE
CXFY99245025482787,GB97FHKC16607677923892,11/26/2015,1636.42,100002,Y,Dining,SAFARI,PC,Dr,10:35:02,14:29:52,4/11/2016,20829797,1693.7,2,"Itself necessary child half market these. Long future rise happen ability.
Large at institution relate yet real store wonder. Region when style mission list source.",13:33:23,IMPS
CXFY99245025482787,GB97FHKC16607677923892,11/26/2015,3330.12,100002,N,Credited,MI,PC,Cr,18:05:35,21:54:06,4/11/2016,90683053,1693.7,6,Staff color reveal. Use state computer simply prove on add history. Throughout during thought crime lose boy success.,20:25:08,CHEQUE
CXFY99245025482787,GB97FHKC16607677923892,11/26/2015,5210.44,100002,N,Credited,CHROME,PC,Cr,5:56:58,9:02:04,4/21/2016,60443588,1880.32,3,Mention nor detail against analysis activity explain ball. Low security test service. Describe side general woman treat professor land ground.,7:23:36,RTGS
CXFY99245025482787,GB97FHKC16607677923892,11/26/2015,7090.76,100002,N,Credited,IE,POS,Cr,9:05:49,11:48:03,4/21/2016,26585543,1880.32,3,"Street truth last now. Behind never environment increase ahead. Local two way picture.
Thing company short list call anyone provide. Mention physical current side film.",10:10:22,RTGS
CXFY99245025482787,GB97FHKC16607677923892,11/26/2015,8971.08,100002,N,Credited,EDGE,MOBILE,Cr,12:16:33,15:06:11,4/21/2016,49968507,1880.32,7,Clearly ground however nation discuss that agreement. Budget analysis seem economy student majority huge. Road already section recognize enough page especially. Determine up before affect.,14:02:47,DD
CXFY99245025482787,GB97FHKC16607677923892,11/26/2015,10851.4,100002,N,Credited,OPERA,POS,Cr,18:30:45,21:56:01,4/21/2016,41693834,1880.32,3,"Agreement plan raise worker raise certainly. Ball class health PM heart.
Tax name follow including board expert reach. They and allow chance. Person painting father recognize car table news.",19:57:30,RTGS
CXFY99245025482787,GB97FHKC16607677923892,11/26/2015,12731.72,100002,N,Credited,EDGE,POS,Cr,20:24:09,22:43:46,4/21/2016,52188732,1880.32,3,"Chair drive throughout science rest. Remain attention industry draw. Wind market task.
Good authority market foot charge citizen remain. Commercial bring article sound just various.",21:05:59,RTGS
CXFY99245025482787,GB97FHKC16607677923892,11/26/2015,11434.06,100002,Y,Household Consumables,SAFARI,PC,Dr,4:12:51,7:41:58,5/4/2016,8969521,1297.66,7,"Born open woman person strategy eye wear news. Together street choice past.
Once each base soon. Most field growth entire.",5:24:38,DD
CXFY99245025482787,GB97FHKC16607677923892,11/26/2015,10136.4,100002,Y,Insurance,OPERA,POS,Dr,8:36:06,11:38:24,5/4/2016,53455116,1297.66,3,"Let gas raise in. Social pick under method trip. Box green fund note.
Purpose certain course poor. Cause view boy group.",10:00:14,RTGS
CXFY99245025482787,GB97FHKC16607677923892,11/26/2015,8838.74,100002,Y,Household Consumables,OPERA,POS,Dr,13:02:00,16:29:09,5/4/2016,49293265,1297.66,4,"Place raise benefit expect stage range. Blood direction baby year set region pass.
Capital professor building. Beat assume huge. Civil cover security study.",14:44:08,UPI
CXFY99245025482787,GB97FHKC16607677923892,11/26/2015,10136.4,100002,N,Credited,IE,POS,Cr,18:36:54,21:36:01,5/4/2016,77700896,1297.66,5,"Hot agent someone age play scene. Mr huge professor.
Build difference officer.
Law task operation kind character opportunity.",19:12:43,CARDS
CXFY99245025482787,GB97FHKC16607677923892,11/26/2015,9069.32,100002,Y,Entertainment,CHROME,PC,Dr,21:49:05,28:40:04,5/17/2016,68573799,1067.08,1,"Resource them image police create. Response believe into arrive east true. Discussion thank view evidence.
Free argue several view often evening. Partner spring charge standard whose daughter.",23:03:40,NEFT
CXFY99245025482787,GB97FHKC16607677923892,11/26/2015,9226.26,100002,N,Credited,IE,PC,Cr,5:18:30,7:55:03,5/26/2016,57520643,156.94,5,"Edge so or far.
Line miss yourself election someone. Whole action arrive base admit describe.",6:33:22,CARDS
CXFY99245025482787,GB97FHKC16607677923892,11/26/2015,9069.32,100002,Y,Groceries,OPERA,PC,Dr,8:41:04,11:11:39,5/26/2016,90999376,156.94,2,Level real change exactly hospital small him. Seat collection property serious those go. White above leave spring professor its show.,10:06:51,IMPS
CXFY99245025482787,GB97FHKC16607677923892,11/26/2015,9226.26,100002,N,Credited,SAFARI,MOBILE,Cr,14:06:42,17:39:22,5/26/2016,83089695,156.94,3,"Number trouble five agree establish heart training.
Never green prevent too morning. Lawyer fast play amount change eight author.
With chance must rock student. Government attack way.",15:50:34,RTGS
CXFY99245025482787,GB97FHKC16607677923892,11/26/2015,9069.32,100002,Y,Rent,SAFARI,PC,Dr,15:10:14,17:14:27,5/26/2016,74410392,156.94,3,"Set record information wait offer know. Best trouble court might enter ok.
Ever Mrs thousand no look child. Eat recent growth size perform.",16:32:32,RTGS
CXFY99245025482787,GB97FHKC16607677923892,11/26/2015,8912.38,100002,Y,Entertainment,IE,MOBILE,Dr,22:07:04,23:40:31,5/26/2016,92456419,156.94,2,"Go same play study again thought six. Assume film care stand.
Quickly pressure television interview race provide meeting. Name any face north.",23:15:57,IMPS
CXFY99245025482787,GB97FHKC16607677923892,11/26/2015,6940.45,100002,Y,Utilities,IE,POS,Dr,7:36:27,9:42:35,5/29/2016,1467499,1971.93,6,Actually cell personal center marriage marriage. Lot majority tree friend. Heavy image single rate human firm level family.,9:03:28,CHEQUE
CXFY99245025482787,GB97FHKC16607677923892,11/26/2015,4968.52,100002,Y,Online Shopping,EDGE,MOBILE,Dr,15:05:37,18:23:34,5/29/2016,64997650,1971.93,2,"Practice any season former chair bring everyone.
List ok return make free town. Program score turn thank cell little fill. Approach few two performance be another provide brother.",15:46:16,IMPS
CXFY99245025482787,GB97FHKC16607677923892,11/26/2015,6940.45,100002,N,Credited,MI,POS,Cr,17:57:56,19:41:55,5/29/2016,60239853,1971.93,3,"President color sometimes about place Republican. Fire debate short. For talk second fear.
Hundred sure able mind since line. Thus customer oil whose outside growth yet there.",18:37:32,RTGS
CXFY99245025482787,GB97FHKC16607677923892,11/26/2015,8321.28,100002,N,Credited,FF,POS,Cr,7:40:44,10:51:45,6/3/2016,49008302,1380.83,5,Environment seem standard evening report term. Coach final change race.,9:29:06,CARDS
CXFY99245025482787,GB97FHKC16607677923892,11/26/2015,9702.11,100002,N,Credited,CHROME,PC,Cr,9:23:15,11:08:33,6/3/2016,76850868,1380.83,3,"Green see century radio. Experience two dark.
Drop once executive may reality. Hit debate usually art study require allow. Pick star item front final.",10:19:57,RTGS
CXFY99245025482787,GB97FHKC16607677923892,11/26/2015,11082.94,100002,N,Credited,MI,PC,Cr,16:12:28,20:21:46,6/3/2016,97900702,1380.83,4,"Others figure great. Hour movie board. Pick best physical to.
Nothing politics wind dog message thus them field. Again goal per involve.",17:58:24,UPI
CXFY99245025482787,GB97FHKC16607677923892,11/26/2015,12463.77,100002,N,Credited,CHROME,PC,Cr,22:18:24,24:36:31,6/3/2016,68551957,1380.83,1,"Law social candidate name. Dinner coach artist mention former political. Floor then can start blue.
Meet drive week girl market produce. Small challenge group worry pretty degree play near.",22:58:43,NEFT
CXFY99245025482787,GB97FHKC16607677923892,11/26/2015,12821.99,100002,N,Credited,OPERA,POS,Cr,9:40:28,13:43:03,6/15/2016,22177117,358.22,4,"Anything newspaper son outside mouth staff visit. Suddenly positive assume turn leave culture economy.
Foot create design data star however bed. Million way training or American since.",11:48:53,UPI
CXFY99245025482787,GB97FHKC16607677923892,11/26/2015,12463.77,100002,Y,Groceries,MI,POS,Dr,13:28:12,18:09:02,6/15/2016,26887029,358.22,6,Have ok top realize its. Participant reflect bank hand.,15:45:31,CHEQUE
CXFY99245025482787,GB97FHKC16607677923892,11/26/2015,12821.99,100002,N,Credited,FF,POS,Cr,20:18:12,22:54:48,6/15/2016,19524375,358.22,2,"Few become glass relate newspaper mean many. Standard opportunity address up late situation instead.
Development now establish officer street. Collection term put any different down Republican.",21:18:32,IMPS
CXFY99245025482787,GB97FHKC16607677923892,11/26/2015,11338.04,100002,Y,Transportation,IE,POS,Dr,17:51:16,26:37:27,6/21/2016,46603173,1483.95,3,"Marriage research kid clear senior a modern. Whole father here process senior side always.
Reason local yourself door. Research ask him assume for account.",21:27:45,RTGS
CXFY99245025482787,GB97FHKC16607677923892,11/26/2015,11840.33,100002,N,Credited,IE,POS,Cr,4:53:05,7:38:27,7/4/2016,718578,502.29,1,"Answer bed sing step right scene. Career from drop sound.
Already measure they see your. Land beat whether claim town.",5:51:07,NEFT
CXFY99245025482787,GB97FHKC16607677923892,11/26/2015,11338.04,100002,Y,Entertainment,CHROME,POS,Dr,8:08:34,10:26:42,7/4/2016,50697731,502.29,2,"Home quite with check contain than production. Network not model camera development.
Country those bill how perform.",8:38:45,IMPS
CXFY99245025482787,GB97FHKC16607677923892,11/26/2015,11840.33,100002,N,Credited,FF,POS,Cr,13:33:14,15:34:27,7/4/2016,27544716,502.29,6,"Oil full share run. Professor stock father challenge loss. Officer son accept talk cultural.
Practice own involve own firm doctor seven. When sure clearly series represent rich.",14:31:11,CHEQUE
CXFY99245025482787,GB97FHKC16607677923892,11/26/2015,12342.62,100002,N,Credited,MI,POS,Cr,18:01:52,20:11:29,7/4/2016,33630281,502.29,7,Kid direction treatment upon attention civil field. Save if never write risk. Real some effort range.,18:29:39,DD
CXFY99245025482787,GB97FHKC16607677923892,11/26/2015,11840.33,100002,Y,Groceries,EDGE,POS,Dr,19:40:46,22:48:55,7/4/2016,60434562,502.29,5,Human clear nation war blue. Leader try wind argue which often still. Choice conference hair.,20:58:20,CARDS
CXFY99245025482787,GB97FHKC16607677923892,11/26/2015,12292.86,100002,N,Credited,MI,POS,Cr,14:34:31,23:04:12,7/14/2016,6751456,452.53,3,When indeed white reason sense. Fund stage service rather check article. Treatment wait down on wait have.,17:32:34,RTGS
CXFY99245025482787,GB97FHKC16607677923892,11/26/2015,11086.62,100002,Y,Online Shopping,FF,POS,Dr,8:14:00,13:13:44,8/6/2016,55196666,1206.24,5,"Doctor through when fish feeling Mr baby television. Subject company wide glass film structure.
Middle ok west. Pressure appear art age.",12:00:38,CARDS
CXFY99245025482787,GB97FHKC16607677923892,11/26/2015,12768.48,100002,N,Credited,MI,POS,Cr,5:00:53,7:41:38,8/13/2016,12896141,1681.86,4,Best newspaper key at more any close. News enjoy course truth study key. Project dark wait rather career opportunity.,6:05:08,UPI
CXFY99245025482787,GB97FHKC16607677923892,11/26/2015,14450.34,100002,N,Credited,IE,POS,Cr,8:46:20,11:13:11,8/13/2016,91649942,1681.86,3,Movie would feel key ability exist answer. Collection suddenly act program only.,9:17:12,RTGS
CXFY99245025482787,GB97FHKC16607677923892,11/26/2015,12768.48,100002,Y,Medicals,FF,POS,Dr,13:47:28,16:03:38,8/13/2016,55574075,1681.86,3,"Chair method value impact serious believe quite. Design leave whom success. Tax less hair meet. Congress get somebody air buy.
Shoulder method or new. Station resource want tree beyond but.",14:44:04,RTGS
CXFY99245025482787,GB97FHKC16607677923892,11/26/2015,14450.34,100002,N,Credited,FF,MOBILE,Cr,15:00:37,16:39:16,8/13/2016,44409708,1681.86,7,Understand believe run authority challenge I gun. Town carry yet woman know campaign.,16:00:53,DD
CXFY99245025482787,GB97FHKC16607677923892,11/26/2015,16132.2,100002,N,Credited,MI,PC,Cr,20:18:51,21:50:49,8/13/2016,33468839,1681.86,7,Rule low increase dog term worry chance. Bag seat impact whose big management show. Office hand degree from the stop film.,21:18:30,DD
CXFY99245025482787,GB97FHKC16607677923892,11/26/2015,16890.52,100002,N,Credited,OPERA,POS,Cr,7:25:35,15:14:59,8/19/2016,5434671,758.32,3,"Realize doctor let research able fall tend. Her way increase clear. Class increase my control.
Leg team leave eat where. Age mind push guess family fact support.",12:24:45,RTGS
CXFY99245025482787,GB97FHKC16607677923892,11/26/2015,17310.55,100002,N,Credited,CHROME,POS,Cr,10:00:39,12:59:08,8/20/2016,3675144,420.03,2,Themselves statement along. Chair home fill lot international yes between. Trip land model share fire study imagine side. But window city gun save well.,11:34:12,IMPS
CXFY99245025482787,GB97FHKC16607677923892,11/26/2015,17730.58,100002,N,Credited,CHROME,PC,Cr,10:17:45,14:06:43,8/20/2016,50091195,420.03,4,"Sing prepare loss make either training suggest. Total once simply.
Rest foot authority. Music by final loss piece I lose.
Arrive best return generation road. Hour who fast pretty.",12:56:05,UPI
CXFY99245025482787,GB97FHKC16607677923892,11/26/2015,17310.55,100002,Y,Online Shopping,EDGE,POS,Dr,16:42:40,21:02:02,8/20/2016,35081104,420.03,6,"Vote military politics occur rise.
Job reduce church new explain anything phone responsibility. Second high marriage. Product happy trial left. Produce attention occur economic.",18:53:41,CHEQUE
CXFY99245025482787,GB97FHKC16607677923892,11/26/2015,15775.66,100002,Y,Dining,EDGE,POS,Dr,9:24:36,14:45:04,8/21/2016,67543335,1534.89,2,"Upon ask memory enjoy claim value. Hot night whole. Loss happy air seek.
Often him quickly fly wonder fill. Husband best with three receive magazine specific.",11:25:43,IMPS
CXFY99245025482787,GB97FHKC16607677923892,11/26/2015,17310.55,100002,N,Credited,CHROME,POS,Cr,13:10:52,19:54:34,8/21/2016,19900353,1534.89,6,Democrat week message cold including successful check. Arm side surface billion happy book herself apply. Significant grow try look everybody let.,16:28:35,CHEQUE
CXFY99245025482787,GB97FHKC16607677923892,11/26/2015,15849.11,100002,Y,Rent,CHROME,MOBILE,Dr,8:36:19,11:42:33,9/14/2016,17331005,1461.44,2,Measure fact activity near get grow. Try enter hair rest whole. Order after that cut charge economy.,9:38:15,IMPS
CXFY99245025482787,GB97FHKC16607677923892,11/26/2015,14387.67,100002,Y,Groceries,FF,POS,Dr,14:26:20,15:49:08,9/14/2016,12272570,1461.44,4,"Deal bar reality century least so office. Gas still training attack society treat try central.
Stay important method several.
Field floor culture high along. Attorney send enter computer old.",15:06:44,UPI
CXFY99245025482787,GB97FHKC16607677923892,11/26/2015,12926.23,100002,Y,Transportation,IE,POS,Dr,21:35:41,24:57:49,9/14/2016,79174213,1461.44,3,Song face plant check task. Anyone source table more. Town stage adult art yeah none order.,22:49:37,RTGS
CXFY99245025482787,GB97FHKC16607677923892,11/26/2015,14006.41,100002,N,Credited,MI,PC,Cr,6:00:10,8:34:47,9/15/2016,96584668,1080.18,6,Support call build why. Rate full we mean recognize particular level. Indeed her machine too instead benefit head. Term smile when or.,7:23:21,CHEQUE
CXFY99245025482787,GB97FHKC16607677923892,11/26/2015,15086.59,100002,N,Credited,OPERA,PC,Cr,8:41:59,10:52:47,9/15/2016,6611750,1080.18,7,Many trade after or law fine challenge. Activity read force situation machine drive course. Structure including issue computer force trial probably.,9:34:01,DD
CXFY99245025482787,GB97FHKC16607677923892,11/26/2015,14006.41,100002,Y,Medicals,SAFARI,POS,Dr,14:20:42,17:26:02,9/15/2016,274814,1080.18,7,Building stage fish form tell public red. Hope dinner along material human recognize.,15:46:05,DD
CXFY99245025482787,GB97FHKC16607677923892,11/26/2015,12926.23,100002,Y,Online Shopping,FF,POS,Dr,17:35:47,20:32:33,9/15/2016,39118257,1080.18,3,Very say power first join challenge. Range affect always someone. Both already mission style million car.,18:59:51,RTGS
CXFY99245025482787,GB97FHKC16607677923892,11/26/2015,11846.05,100002,Y,Rent,CHROME,MOBILE,Dr,21:02:13,24:14:52,9/15/2016,7928413,1080.18,6,Over pick rule. Newspaper yard young decision participant performance able. Shake under among matter almost speech.,23:01:53,CHEQUE
CXFY99245025482787,GB97FHKC16607677923892,11/26/2015,13096.16,100002,N,Credited,EDGE,MOBILE,Cr,16:02:52,23:23:01,9/16/2016,1441239,1250.11,3,Ability bill whom painting decade quickly raise president. Method pull do situation. School hot fly use ahead.,18:15:39,RTGS
CXFY99245025482787,GB97FHKC16607677923892,11/26/2015,13788.51,100002,N,Credited,SAFARI,MOBILE,Cr,17:14:28,21:29:51,9/17/2016,56754438,692.35,5,"Cause paper challenge many establish late easy. Effort exist tend customer provide series. Life station close wall stock guess enjoy rate.
Quickly court likely interview pay. Receive prepare machine.",19:35:54,CARDS
CXFY99245025482787,GB97FHKC16607677923892,11/26/2015,15742.42,100002,N,Credited,SAFARI,MOBILE,Cr,13:47:11,20:58:26,9/18/2016,19434803,1953.91,2,Democrat once effort fire chair score child. Page want effort camera strong law across. Environmental husband single.,17:34:17,IMPS
CXFY99245025482787,GB97FHKC16607677923892,11/26/2015,13813.67,100002,Y,Rent,IE,PC,Dr,7:18:29,10:02:38,9/22/2016,81368020,1928.75,7,"Him trip social hear foreign present. Rest right newspaper leader officer.
Thousand section student easy. Seem suddenly big board little. Cultural situation meeting meeting.",7:52:36,DD
CXFY99245025482787,GB97FHKC16607677923892,11/26/2015,11884.92,100002,Y,Medicals,SAFARI,POS,Dr,9:04:01,12:05:49,9/22/2016,74579969,1928.75,7,If million skin southern western have. Computer newspaper part culture. History floor up.,11:21:22,DD
CXFY99245025482787,GB97FHKC16607677923892,11/26/2015,13813.67,100002,N,Credited,FF,PC,Cr,17:26:12,20:20:19,9/22/2016,92382954,1928.75,5,Offer ready people painting color seven moment. Hit particular with but. Week window none cover response.,18:36:00,CARDS
CXFY99245025482787,GB97FHKC16607677923892,11/26/2015,11884.92,100002,Y,Dining,IE,PC,Dr,17:56:48,20:45:49,9/22/2016,52060465,1928.75,2,"True suffer century else movie. Production way hard make.
Time cold while opportunity box pattern. Key father each several expert. Long point bag suggest especially tell.",19:25:55,IMPS
CXFY99245025482787,GB97FHKC16607677923892,11/26/2015,12371.14,100002,N,Credited,FF,MOBILE,Cr,5:31:49,8:43:36,9/28/2016,97176138,486.22,6,Mention family herself including computer firm cultural billion. Billion woman because truth concern. Wind southern fight out guy catch where.,7:24:09,CHEQUE
CXFY99245025482787,GB97FHKC16607677923892,11/26/2015,12857.36,100002,N,Credited,CHROME,POS,Cr,9:29:32,12:05:07,9/28/2016,77406675,486.22,5,"Talk factor everybody result hotel. Manage manager understand send including time.
Discuss music involve learn citizen heavy myself like. Class wife say money.",10:16:02,CARDS
CXFY99245025482787,GB97FHKC16607677923892,11/26/2015,12371.14,100002,Y,Insurance,EDGE,PC,Dr,14:28:00,17:05:40,9/28/2016,36156092,486.22,6,Whether college there majority hotel see economy.,15:35:06,CHEQUE
CXFY99245025482787,GB97FHKC16607677923892,11/26/2015,12857.36,100002,N,Credited,CHROME,PC,Cr,17:42:36,20:21:07,9/28/2016,77493989,486.22,5,Stop important type return. Technology each call draw contain.,18:35:29,CARDS
CXFY99245025482787,GB97FHKC16607677923892,11/26/2015,12371.14,100002,Y,Insurance,EDGE,POS,Dr,22:22:20,24:19:14,9/28/2016,55832922,486.22,5,Next different throughout less teacher. Yard save generation foreign current add administration. Share fact language machine light. Training central smile two ten as court office.,23:44:29,CARDS
CXFY99245025482787,GB97FHKC16607677923892,11/26/2015,12486.36,100002,N,Credited,MI,POS,Cr,4:35:13,6:53:41,10/6/2016,6233600,115.22,3,"Represent minute soon year yet one receive. Call day inside could mind.
Yeah win item character. Former sense leader process security such ago.",6:00:24,RTGS
CXFY99245025482787,GB97FHKC16607677923892,11/26/2015,12371.14,100002,Y,Utilities,IE,PC,Dr,7:56:51,10:50:50,10/6/2016,73220664,115.22,5,House set north event always court street. Claim guess doctor world. Upon whom some picture last clear scientist before.,9:00:53,CARDS
CXFY99245025482787,GB97FHKC16607677923892,11/26/2015,12255.92,100002,Y,Medicals,SAFARI,MOBILE,Dr,11:04:33,13:17:10,10/6/2016,50696888,115.22,7,"Billion grow key decade. Even election over oil computer generation. Grow since fund.
Effect politics whether. Lay citizen forget pattern attorney. Sport language continue.",12:50:42,DD
CXFY99245025482787,GB97FHKC16607677923892,11/26/2015,12371.14,100002,N,Credited,CHROME,POS,Cr,16:06:04,18:54:38,10/6/2016,9219977,115.22,7,"Receive tax with for store doctor line. Body production nature law than.
Point century process doctor. Conference kitchen modern break Congress.",17:04:55,DD
CXFY99245025482787,GB97FHKC16607677923892,11/26/2015,12255.92,100002,Y,Household Consumables,MI,MOBILE,Dr,21:17:48,23:57:36,10/6/2016,73577577,115.22,6,Lay discuss open seem Republican hit pick. None answer position should back let various.,22:50:29,CHEQUE
CXFY99245025482787,GB97FHKC16607677923892,11/26/2015,14151.53,100002,N,Credited,EDGE,POS,Cr,8:14:16,14:11:15,10/29/2016,81911622,1895.61,2,"Imagine reach decide risk lawyer force ball. Project full agent indicate.
Several onto question. Respond special process building design bad.",11:05:10,IMPS
CXFY99245025482787,GB97FHKC16607677923892,11/26/2015,16047.14,100002,N,Credited,IE,PC,Cr,16:11:40,21:19:22,10/29/2016,27991961,1895.61,1,"School section maybe chance believe trial represent. Such each market. Without whether situation base daughter.
Every sing side section five make let. Nothing wide early current newspaper attorney.",20:01:34,NEFT
CXFY99245025482787,GB97FHKC16607677923892,11/26/2015,15222.65,100002,Y,Utilities,FF,POS,Dr,7:51:15,9:41:14,11/3/2016,34020593,824.49,5,Situation spring training particularly radio everything. Establish thought line him drop college certain. Budget more herself former.,8:50:20,CARDS
CXFY99245025482787,GB97FHKC16607677923892,11/26/2015,14398.16,100002,Y,Online Shopping,EDGE,PC,Dr,9:16:15,12:17:42,11/3/2016,41371626,824.49,6,"Without pattern yet suddenly him.
Light institution character local begin test. Evening group church else. Around everyone him she.",11:16:26,CHEQUE
CXFY99245025482787,GB97FHKC16607677923892,11/26/2015,13573.67,100002,Y,Groceries,CHROME,MOBILE,Dr,14:49:06,17:29:32,11/3/2016,29583409,824.49,5,"Key line purpose wish per.
Model seem national direction trip your. Movie Republican allow shake marriage. Improve defense through laugh. Behind fly nature.",16:29:08,CARDS
CXFY99245025482787,GB97FHKC16607677923892,11/26/2015,12749.18,100002,Y,Medicals,FF,PC,Dr,20:37:03,25:01:20,11/3/2016,81621767,824.49,6,"Support part player plant. Say question sell friend cut school tax establish.
Word now especially performance. Task care financial course. Try themselves here bill record long.",22:54:29,CHEQUE
CXFY99245025482787,GB97FHKC16607677923892,11/26/2015,13147.25,100002,N,Credited,SAFARI,MOBILE,Cr,3:51:24,6:34:26,11/12/2016,34113905,398.07,7,"Congress phone wide practice. Would drive city never. Miss task begin choice help.
Well least determine glass specific crime far citizen. Miss baby attack.",4:58:52,DD
CXFY99245025482787,GB97FHKC16607677923892,11/26/2015,12749.18,100002,Y,Utilities,OPERA,POS,Dr,12:24:13,16:05:29,11/12/2016,70584080,398.07,2,"Off per able shoulder appear.
Four or commercial. Other stock voice door receive forward real. Catch use decide only pressure out power. Win other continue window mind.",13:42:51,IMPS
CXFY99245025482787,GB97FHKC16607677923892,11/26/2015,13147.25,100002,N,Credited,MI,PC,Cr,17:29:55,19:05:29,11/12/2016,44145859,398.07,1,Religious stuff peace research customer day design. News must cold some why you tend ready. Beat somebody line strong. Anyone learn size hold institution tax risk.,18:33:16,NEFT
CXFY99245025482787,GB97FHKC16607677923892,11/26/2015,12749.18,100002,Y,Insurance,CHROME,POS,Dr,20:21:41,23:20:35,11/12/2016,70368680,398.07,5,Town live couple. Down start take police blue administration threat. Whether our professional section discussion similar direction government. Table perhaps chair around result relate quickly live.,21:06:13,CARDS
CXFY99245025482787,GB97FHKC16607677923892,11/26/2015,14693.33,100002,N,Credited,SAFARI,MOBILE,Cr,9:22:09,10:43:58,11/15/2016,27407059,1944.15,6,Inside section computer whose. Low able easy explain interview high capital. Now car lay experience.,9:59:48,CHEQUE
CXFY99245025482787,GB97FHKC16607677923892,11/26/2015,16637.48,100002,N,Credited,FF,MOBILE,Cr,11:53:33,17:09:05,11/15/2016,70950885,1944.15,4,Bad everybody last pull leave feel. Defense important forward product find teacher. Field bad concern take.,14:17:08,UPI
CXFY99245025482787,GB97FHKC16607677923892,11/26/2015,14693.33,100002,Y,Dining,MI,MOBILE,Dr,22:00:07,24:23:22,11/15/2016,31840545,1944.15,6,"Scientist ahead off against suddenly common off.
Open after material lose enjoy whatever.
Though way already outside offer.",22:47:50,CHEQUE
CXFY99245025482787,GB97FHKC16607677923892,11/26/2015,15455.61,100002,N,Credited,SAFARI,MOBILE,Cr,5:11:58,7:01:31,11/18/2016,92090613,762.28,3,"Stand thank east safe glass light catch. Bring yet far product. Glass approach personal reach hospital.
Along during interesting my. Catch produce peace health head keep perform.",5:48:46,RTGS
CXFY99245025482787,GB97FHKC16607677923892,11/26/2015,14693.33,100002,Y,Groceries,MI,PC,Dr,10:10:36,12:07:33,11/18/2016,60997791,762.28,2,"They address edge. Explain land organization since.
She whole marriage behavior of continue. Rock page stand simple couple resource front.",10:38:59,IMPS
CXFY99245025482787,GB97FHKC16607677923892,11/26/2015,13931.05,100002,Y,Insurance,FF,PC,Dr,12:21:32,15:14:26,11/18/2016,3335185,762.28,6,"Improve born couple federal. The single station situation probably. Deep deal very four nor.
Mission thing its traditional always yes why girl. Fire authority real project affect theory easy.",13:19:43,CHEQUE
CXFY99245025482787,GB97FHKC16607677923892,11/26/2015,13168.77,100002,Y,Entertainment,SAFARI,MOBILE,Dr,15:30:17,18:24:04,11/18/2016,57244426,762.28,3,Hour crime music note partner job too. Century next at may be later energy. Exactly he ten recent. Production this eat what travel become dinner run.,17:01:19,RTGS
CXFY99245025482787,GB97FHKC16607677923892,11/26/2015,13931.05,100002,N,Credited,EDGE,PC,Cr,21:54:02,24:09:06,11/18/2016,88010687,762.28,2,"Economy table amount tough. Determine study TV fish management medical especially.
Or hear move think report. Human action thought. Or would old fill. Information company three health day senior.",23:23:44,IMPS
CXFY99245025482787,GB97FHKC16607677923892,11/26/2015,13952.14,100002,N,Credited,OPERA,POS,Cr,10:18:22,13:20:38,11/23/2016,30668386,21.09,4,"Prove concern analysis. Administration same term for wonder ten then high. Apply though season.
Visit here for song. Old information return be stock pretty. Wall his face type eye enter.",11:33:21,UPI
CXFY99245025482787,GB97FHKC16607677923892,11/26/2015,13973.23,100002,N,Credited,EDGE,MOBILE,Cr,13:31:12,17:17:44,11/23/2016,50203611,21.09,1,Home wish too word tax. Laugh paper tell boy behavior design. Suffer season without control position.,15:03:05,NEFT
CXFY99245025482787,GB97FHKC16607677923892,11/26/2015,13994.32,100002,N,Credited,EDGE,PC,Cr,19:00:40,23:37:53,11/23/2016,34176733,21.09,4,"While day happy recently ten top. These send that bit ability. Maybe partner recent someone.
Leader room view hope. Congress consider rate new see space air.",21:21:01,UPI
CXFY99245025482787,GB97FHKC16607677923892,11/26/2015,14836.32,100002,N,Credited,OPERA,POS,Cr,4:11:09,6:57:42,11/24/2016,11310945,842,7,"People painting single record. Police pressure here young.
Traditional foreign next consumer. Radio government perform rest organization environment enough.",5:42:34,DD
CXFY99245025482787,GB97FHKC16607677923892,11/26/2015,15678.32,100002,N,Credited,FF,PC,Cr,8:58:30,12:17:53,11/24/2016,27561218,842,2,"Follow friend think ball wish response city. Manager important account too quality strong.
Feel thought beautiful meeting here energy lose. Take institution large join together color.",10:53:17,IMPS
CXFY99245025482787,GB97FHKC16607677923892,11/26/2015,14836.32,100002,Y,Medicals,IE,PC,Dr,14:44:29,15:57:06,11/24/2016,69149009,842,4,Authority student bed myself within. Nation hundred firm rise for sport social. Prevent store member foot political. Thus action value we court.,15:26:47,UPI
CXFY99245025482787,GB97FHKC16607677923892,11/26/2015,13994.32,100002,Y,Rent,CHROME,MOBILE,Dr,15:07:55,17:16:31,11/24/2016,33857473,842,4,Training put animal town among. Operation shake another.,16:34:48,UPI
CXFY99245025482787,GB97FHKC16607677923892,11/26/2015,14836.32,100002,N,Credited,IE,POS,Cr,22:29:32,23:58:30,11/24/2016,76240973,842,3,Per both program fund. Game grow collection foreign.,22:58:59,RTGS
CXFY99245025482787,GB97FHKC16607677923892,11/26/2015,15450.6,100002,N,Credited,FF,PC,Cr,7:05:10,10:40:54,11/26/2016,8804075,614.28,5,"Be ago message foot before. Environment check recognize focus short.
Positive artist woman member. Hear bring market after.
Thought yes fast former. Land forget home new.",8:38:06,CARDS
CXFY99245025482787,GB97FHKC16607677923892,11/26/2015,16064.88,100002,N,Credited,MI,POS,Cr,8:13:31,10:52:02,11/26/2016,55855860,614.28,1,"Attack message let may. Color south production follow probably power.
Life garden factor TV threat discover. Moment image evidence yeah use happy.",10:12:30,NEFT
CXFY99245025482787,GB97FHKC16607677923892,11/26/2015,15450.6,100002,Y,Personal Care,FF,POS,Dr,12:51:29,16:38:44,11/26/2016,90469480,614.28,5,Concern easy party better hot every argue. Term table you. Include Republican side fire social contain law much.,14:39:26,CARDS
CXFY99245025482787,GB97FHKC16607677923892,11/26/2015,14836.32,100002,Y,Medicals,CHROME,MOBILE,Dr,22:49:29,24:31:28,11/26/2016,26417721,614.28,6,Maybe sea see direction culture check. Guess list oil serve medical.,23:48:19,CHEQUE
CXFY99245025482787,GB97FHKC16607677923892,11/26/2015,15772.76,100002,N,Credited,EDGE,PC,Cr,2:52:36,6:29:58,11/29/2016,66386704,936.44,5,"Dog discuss particularly. Institution himself line but base. What thousand upon over hard.
Lot young she doctor. Tough blood great history. Condition compare paper modern exactly.",4:38:27,CARDS
CXFY99245025482787,GB97FHKC16607677923892,11/26/2015,14836.32,100002,Y,Groceries,IE,POS,Dr,10:05:53,13:04:31,11/29/2016,951364,936.44,5,"South learn record record now. Force history before include.
Four difficult wear woman region measure give. Speak realize future ready. Mind any out education key.",11:05:38,CARDS
CXFY99245025482787,GB97FHKC16607677923892,11/26/2015,15772.76,100002,N,Credited,MI,POS,Cr,11:16:58,14:52:22,11/29/2016,31111720,936.44,7,"Film beyond her line. Everything so ever wall. Town issue true political determine once.
Entire party matter garden affect. Step how style experience.",13:01:43,DD
CXFY99245025482787,GB97FHKC16607677923892,11/26/2015,14836.32,100002,Y,Online Shopping,CHROME,MOBILE,Dr,16:28:14,18:18:35,11/29/2016,44015626,936.44,6,"World high huge however. Specific tonight technology everyone away magazine which.
It pattern social despite reduce nor. Military adult land fish.",17:44:47,CHEQUE
CXFY99245025482787,GB97FHKC16607677923892,11/26/2015,13899.88,100002,Y,Rent,MI,POS,Dr,21:53:50,23:38:05,11/29/2016,92725980,936.44,5,Drive against step particularly black. Environment loss off rather side act. Knowledge career play act traditional available put.,22:24:31,CARDS
CXFY99245025482787,GB97FHKC16607677923892,11/26/2015,12100.95,100002,Y,Rent,EDGE,MOBILE,Dr,9:35:48,15:38:19,12/1/2016,64344232,1798.93,2,"Door eight top production military education until. Carry important each both board social hundred magazine.
Or argue through friend site help law commercial. Operation while form full after nothing.",12:22:07,IMPS
CXFY99245025482787,GB97FHKC16607677923892,11/26/2015,13899.88,100002,N,Credited,OPERA,PC,Cr,19:32:53,24:46:09,12/1/2016,68550516,1798.93,1,"Fear great late indeed work movie population. Listen style area word design life. Reflect wrong family employee fish where.
Bill open affect card. Fact develop speak table believe.",21:19:26,NEFT
CXFY99245025482787,GB97FHKC16607677923892,11/26/2015,14337.51,100002,N,Credited,OPERA,POS,Cr,10:02:56,14:18:04,12/11/2016,14514081,437.63,6,"Relate material official hair wall. Same space arrive kind. Throughout major every evidence movement peace place fund.
Begin enjoy executive send three on.
Nice over federal agent.",12:46:10,CHEQUE
CXFY99245025482787,GB97FHKC16607677923892,11/26/2015,14775.14,100002,N,Credited,CHROME,POS,Cr,15:57:23,18:33:31,12/11/2016,26923260,437.63,4,"Human have I firm same. Social for human.
Table dog she political watch set small. Company try reach provide energy.",17:11:28,UPI
CXFY99245025482787,GB97FHKC16607677923892,11/26/2015,14429.35,100002,Y,Personal Care,MI,PC,Dr,8:01:46,12:05:38,12/12/2016,93844598,345.79,1,"Simple stuff teacher across detail well reveal high. Less between cost it.
Store once big. Past subject if tell ago wonder.
Section card occur style marriage. Chance staff I only window hour.",11:11:07,NEFT
CXFY99245025482787,GB97FHKC16607677923892,11/26/2015,14083.56,100002,Y,Groceries,FF,PC,Dr,15:18:43,19:00:21,12/12/2016,49139969,345.79,2,"Total attorney environmental she black miss. Money low voice. Plant probably create have any take order.
Others line appear give case. Church culture reason. Well east present land industry.",16:32:48,IMPS
CXFY99245025482787,GB97FHKC16607677923892,11/26/2015,12981.9,100002,Y,Entertainment,IE,POS,Dr,12:01:05,16:19:49,12/17/2016,31883191,1101.66,4,International next window example town recent ball. Inside people tend happy indeed. Establish personal sport his minute fear action.,13:50:48,UPI
CXFY99245025482787,GB97FHKC16607677923892,11/26/2015,14083.56,100002,N,Credited,IE,PC,Cr,16:33:59,21:28:36,12/17/2016,5378470,1101.66,7,"Five player program under off. Second data eight central size perform. Economy give now smile only deep during must.
Lead local candidate happen. Wide grow admit other across describe determine.",20:20:41,DD
CXFY99245025482787,GB97FHKC16607677923892,11/26/2015,15946.7,100002,N,Credited,FF,PC,Cr,10:30:00,21:50:49,12/19/2016,51033552,1863.14,6,"Investment child child work official. Country improve claim down alone. Seven never idea huge leader.
Speak statement southern design. Drive strong serious event model remain.",16:27:45,CHEQUE
CXFY99245025482787,GB97FHKC16607677923892,11/26/2015,16706.13,100002,N,Credited,FF,PC,Cr,9:45:24,14:47:52,12/26/2016,75104382,759.43,5,"Budget catch student break concern. Part weight question if rich.
Lead pass stuff. Ten campaign wish of practice yeah political security.",12:55:04,CARDS
CXFY99245025482787,GB97FHKC16607677923892,11/26/2015,17496.19,100002,N,Credited,EDGE,MOBILE,Cr,6:14:02,8:44:26,12/29/2016,85220744,790.06,3,"Fill culture yourself nor school. Around purpose information everybody buy in. Appear agreement shoulder computer want.
Control full seven road building. Subject because catch anything candidate.",6:54:19,RTGS
CXFY99245025482787,GB97FHKC16607677923892,11/26/2015,18286.25,100002,N,Credited,OPERA,MOBILE,Cr,11:49:44,14:42:19,12/29/2016,94197952,790.06,2,"Then positive accept full move activity different. College seem small window oil after. Add none mission common door detail wife.
Statement here direction accept yes. Nearly side tell those after.",12:58:53,IMPS
CXFY99245025482787,GB97FHKC16607677923892,11/26/2015,17496.19,100002,Y,Transportation,OPERA,POS,Dr,16:45:24,19:35:40,12/29/2016,80918820,790.06,5,"Young wrong according growth door produce perhaps. Music plant mind recent professor rest town apply. House read hold music receive.
Enter toward voice while close trouble.",18:19:39,CARDS
CXFY99245025482787,GB97FHKC16607677923892,11/26/2015,16706.13,100002,Y,Insurance,SAFARI,MOBILE,Dr,22:31:46,24:47:24,12/29/2016,63993608,790.06,2,"Approach worry determine tax gas ability. Population box remain speak structure east goal.
Hard consider specific teach. Guy protect practice stuff blood drug.",23:17:33,IMPS
CXFY99245025482787,GB97FHKC16607677923892,11/26/2015,15735.27,100002,Y,Medicals,MI,MOBILE,Dr,7:19:08,9:49:34,1/4/2017,1728873,970.86,7,Include amount become apply theory short after. Quality color entire return. Perhaps onto who entire thing bag question test. Senior smile condition at thing.,9:12:31,DD
CXFY99245025482787,GB97FHKC16607677923892,11/26/2015,16706.13,100002,N,Credited,FF,MOBILE,Cr,10:00:45,12:08:43,1/4/2017,29401369,970.86,6,"Box remain pick official western. Should that then college. Take argue finally military.
Though home newspaper Republican. Statement American begin race however find color.",10:58:15,CHEQUE
CXFY99245025482787,GB97FHKC16607677923892,11/26/2015,15735.27,100002,Y,Transportation,EDGE,MOBILE,Dr,16:13:41,19:38:53,1/4/2017,86018692,970.86,6,Very box difficult range phone population seek nice. Network foot degree center material world order eight. White own since this compare organization strategy white.,17:24:38,CHEQUE
CXFY99245025482787,GB97FHKC16607677923892,11/26/2015,14764.41,100002,Y,Household Consumables,EDGE,MOBILE,Dr,20:24:12,22:40:07,1/4/2017,71423029,970.86,4,Modern hundred ok sometimes. Expert fine can cup yeah learn. Everything student card amount.,21:02:07,UPI
CXFY99245025482787,GB97FHKC16607677923892,11/26/2015,16509.21,100002,N,Credited,CHROME,MOBILE,Cr,12:59:32,16:56:25,1/8/2017,28858874,1744.8,1,"Model kid good summer. Near but discover never on whatever. Authority of likely.
Culture result network may. Statement next certain appear. Suddenly though against impact.",14:57:40,NEFT
CXFY99245025482787,GB97FHKC16607677923892,11/26/2015,18254.01,100002,N,Credited,IE,POS,Cr,14:26:44,17:17:34,1/8/2017,87439762,1744.8,7,"Degree authority different speech police occur. Since form factor option book south dream.
Property stand fact design wish night represent. Four special popular yes order.",16:01:39,DD
CXFY99245025482787,GB97FHKC16607677923892,11/26/2015,16918.15,100002,Y,Transportation,SAFARI,POS,Dr,4:35:04,8:05:43,1/11/2017,81704903,1335.86,5,"Upon during any message professional fear. Project true new yard along wear office. Crime environment across.
Production religious myself. Realize cold chair high enjoy.",6:49:02,CARDS
CXFY99245025482787,GB97FHKC16607677923892,11/26/2015,18254.01,100002,N,Credited,CHROME,PC,Cr,14:02:21,18:16:02,1/11/2017,44113513,1335.86,1,"Assume market peace movie this front. Concern place this allow pull site become.
Specific federal industry agent kid security wish. Fine sister involve total either table shake.",15:16:45,NEFT
CXFY99245025482787,GB97FHKC16607677923892,11/26/2015,16918.15,100002,Y,Medicals,CHROME,MOBILE,Dr,18:27:04,20:12:11,1/11/2017,28064367,1335.86,2,Throughout white present not dream soon person. Those cultural response majority. Question establish brother sign throw.,19:23:32,IMPS
CXFY99245025482787,GB97FHKC16607677923892,11/26/2015,15965.9,100002,Y,Online Shopping,FF,MOBILE,Dr,7:18:37,11:00:31,1/16/2017,47192171,952.25,1,"Else another president wonder budget. Find white speech through ahead. Final him growth inside really mouth anything teach.
Almost film responsibility believe view look. Enter other voice.",9:10:22,NEFT
CXFY99245025482787,GB97FHKC16607677923892,11/26/2015,16918.15,100002,N,Credited,CHROME,PC,Cr,11:00:33,13:11:16,1/16/2017,68340612,952.25,1,Accept manage could company. Woman grow into top film let suddenly. Far memory ball much.,12:03:24,NEFT
CXFY99245025482787,GB97FHKC16607677923892,11/26/2015,15965.9,100002,Y,Rent,OPERA,MOBILE,Dr,19:38:21,23:01:23,1/16/2017,76731112,952.25,2,"Fear gas team couple high window picture. Speech affect city arrive pattern respond rule.
Knowledge blue include agreement. Each network statement raise character fund.
Seem one brother produce than.",20:31:59,IMPS
CXFY99245025482787,GB97FHKC16607677923892,11/26/2015,14897.55,100002,Y,Personal Care,EDGE,POS,Dr,14:10:05,18:00:32,1/18/2017,6598310,1068.35,2,"Win dog participant idea piece meeting. Third read real state enough. Discover only economy foreign art affect already.
Than throw police must walk back. Left own third else. Between street pull.",15:54:42,IMPS
CXFY99245025482787,GB97FHKC16607677923892,11/26/2015,13829.2,100002,Y,Personal Care,FF,POS,Dr,16:21:22,21:24:55,1/18/2017,70089714,1068.35,1,"Anything end interest conference can.
Enjoy meet exist land question none everything. Responsibility expect box guy claim.",17:49:01,NEFT
CXFY99245025482787,GB97FHKC16607677923892,11/26/2015,12157.26,100002,Y,Household Consumables,SAFARI,MOBILE,Dr,7:21:09,10:34:37,1/19/2017,43771004,1671.94,6,"History skin prove. Million research tonight.
Color require consumer whose detail no wrong. Watch expert international fire thus continue.",9:15:17,CHEQUE
CXFY99245025482787,GB97FHKC16607677923892,11/26/2015,13829.2,100002,N,Credited,EDGE,MOBILE,Cr,13:18:51,16:49:55,1/19/2017,31055284,1671.94,1,Serve population all organization expect good. Cup civil stay ground choose team suddenly.,15:29:05,NEFT
CXFY99245025482787,GB97FHKC16607677923892,11/26/2015,12157.26,100002,Y,Online Shopping,EDGE,POS,Dr,16:08:00,20:57:00,1/19/2017,82235321,1671.94,1,"Personal vote them political. Baby conference all consumer clearly.
Know option walk case current. Own town accept size charge question.",18:41:01,NEFT
CXFY99245025482787,GB97FHKC16607677923892,11/26/2015,10728.33,100002,Y,Online Shopping,IE,MOBILE,Dr,4:59:58,8:42:59,2/4/2017,87767728,1428.93,7,"International student like land find factor. See stop method fine business investment.
Our strategy effort spring. Cultural reach light red.",6:58:44,DD
CXFY99245025482787,GB97FHKC16607677923892,11/26/2015,12157.26,100002,N,Credited,FF,MOBILE,Cr,9:46:13,12:26:46,2/4/2017,36741809,1428.93,5,Over receive live consumer. Present benefit describe piece form experience around short.,11:00:13,CARDS
CXFY99245025482787,GB97FHKC16607677923892,11/26/2015,10728.33,100002,Y,Transportation,OPERA,POS,Dr,14:19:37,16:49:28,2/4/2017,74334605,1428.93,1,"Drop dog imagine child son success. Firm heavy two pull doctor dark.
Power water town night account value indicate into.",15:36:06,NEFT
CXFY99245025482787,GB97FHKC16607677923892,11/26/2015,12157.26,100002,N,Credited,EDGE,PC,Cr,16:29:49,20:13:01,2/4/2017,17923835,1428.93,4,"Drug which serve brother listen effect these. Issue seat also federal church new almost as.
Improve game explain behind my start build. Property growth hit article. Memory every others friend.",18:14:04,UPI
CXFY99245025482787,GB97FHKC16607677923892,11/26/2015,10728.33,100002,Y,Entertainment,OPERA,MOBILE,Dr,19:14:20,22:01:33,2/4/2017,35486350,1428.93,5,Wrong president order well clear indicate. Class item serve color house.,20:09:40,CARDS
CXFY99245025482787,GB97FHKC16607677923892,11/26/2015,10997.88,100002,N,Credited,SAFARI,POS,Cr,10:25:45,13:40:02,2/7/2017,7028205,269.55,1,Bank once concern man shake. Interest health hair discuss. No sit stand program right.,11:33:48,NEFT
CXFY99245025482787,GB97FHKC16607677923892,11/26/2015,11267.43,100002,N,Credited,MI,PC,Cr,14:56:34,16:56:28,2/7/2017,71784243,269.55,6,"Child yes rather treatment. Ever cost heart husband send. Both forget forward in political common.
Turn travel buy whom still this three. Store all front look. Health fall campaign.",16:05:30,CHEQUE
CXFY99245025482787,GB97FHKC16607677923892,11/26/2015,10997.88,100002,Y,Utilities,SAFARI,MOBILE,Dr,17:53:32,20:04:15,2/7/2017,4827108,269.55,4,Century short laugh. Structure bag once strong tough involve. Mr treat note event international imagine ago. Forget what hold box study decade.,19:10:20,UPI
CXFY99245025482787,GB97FHKC16607677923892,11/26/2015,10279.82,100002,Y,Entertainment,SAFARI,POS,Dr,11:01:04,22:09:18,2/11/2017,89276679,718.06,4,"See central represent save beautiful career. Response space interest look vote operation. None only to manager market.
Operation area enter adult. Who nearly possible lead suggest key suffer do.",16:27:18,UPI
CXFY99245025482787,GB97FHKC16607677923892,11/26/2015,10814.1,100002,N,Credited,CHROME,MOBILE,Cr,8:39:19,11:18:11,2/20/2017,93786973,534.28,4,"President the across. Require open soldier.
Power throughout network parent five. Heavy list send knowledge store history. None move young.",10:07:30,UPI
CXFY99245025482787,GB97FHKC16607677923892,11/26/2015,10279.82,100002,Y,Personal Care,IE,PC,Dr,12:32:30,17:03:31,2/20/2017,83177521,534.28,1,Nor everyone their field lot. Herself yes require leader. Environmental anything bill wish by age family occur.,15:15:47,NEFT
CXFY99245025482787,GB97FHKC16607677923892,11/26/2015,10814.1,100002,N,Credited,IE,POS,Cr,19:59:50,24:39:23,2/20/2017,68648671,534.28,3,"Knowledge lawyer clear. Police large new discover.
Adult follow seat find force reduce. Road catch answer factor talk into.
Everyone for character operation. Consumer despite age blue know.",22:17:31,RTGS
CXFY99245025482787,GB97FHKC16607677923892,11/26/2015,11264.57,100002,N,Credited,FF,PC,Cr,8:50:01,14:36:00,3/1/2017,85222861,450.47,1,Coach development son dark measure common executive. Most nearly would agree leave reason. Language concern try throughout case part possible.,10:43:06,NEFT
CXFY99245025482787,GB97FHKC16607677923892,11/26/2015,11715.04,100002,N,Credited,CHROME,PC,Cr,21:48:19,26:31:31,3/1/2017,45143625,450.47,6,On single single example. Small material executive specific. Fine history series available move call top.,22:49:39,CHEQUE
CXFY99245025482787,GB97FHKC16607677923892,11/26/2015,13529.21,100002,N,Credited,CHROME,MOBILE,Cr,6:48:57,10:42:27,3/11/2017,70857672,1814.17,2,"Common raise single remember light woman off. Involve exist that.
Argue cost sort performance.",8:23:58,IMPS
CXFY99245025482787,GB97FHKC16607677923892,11/26/2015,11715.04,100002,Y,Entertainment,SAFARI,PC,Dr,8:23:01,12:34:14,3/11/2017,24495882,1814.17,1,"Republican million make.
Kitchen knowledge stay. By machine opportunity their every theory. Shoulder total born government Mr and couple us. East more skill next situation church.",10:46:28,NEFT
CXFY99245025482787,GB97FHKC16607677923892,11/26/2015,13529.21,100002,N,Credited,OPERA,MOBILE,Cr,15:47:34,17:48:44,3/11/2017,16484092,1814.17,7,Poor everyone true plant until include. Rich window material point play concern message. System with soon mouth lot class.,17:06:15,DD
CXFY99245025482787,GB97FHKC16607677923892,11/26/2015,11715.04,100002,Y,Entertainment,MI,PC,Dr,20:24:30,23:13:26,3/11/2017,92641068,1814.17,2,"Response will any alone order president.
Phone by contain reduce number assume money. Sound pull as work form save leg. Someone company very. Occur at card reach movie two.",22:34:16,IMPS
CXFY99245025482787,GB97FHKC16607677923892,11/26/2015,11705.08,100002,Y,Dining,EDGE,PC,Dr,3:34:09,6:39:44,3/12/2017,21041266,9.96,6,Model specific line decision read. Write pull ok something marriage region number. Country quite spring hold.,5:31:49,CHEQUE
CXFY99245025482787,GB97FHKC16607677923892,11/26/2015,11715.04,100002,N,Credited,IE,MOBILE,Cr,12:52:23,15:25:01,3/12/2017,69273216,9.96,1,Since interesting task three reality director. Trouble different somebody often lose add. Hotel decide provide discuss art high.,13:39:02,NEFT
CXFY99245025482787,GB97FHKC16607677923892,11/26/2015,11725,100002,N,Credited,EDGE,PC,Cr,14:11:53,17:20:57,3/12/2017,24443401,9.96,4,Federal respond up computer. Win floor worry thing.,15:29:33,UPI
CXFY99245025482787,GB97FHKC16607677923892,11/26/2015,11715.04,100002,Y,Personal Care,FF,POS,Dr,19:52:37,22:00:14,3/12/2017,37006686,9.96,7,"Account though process face. Big few improve.
Account security over past. Eat activity run program child college more hold. Center traditional them represent money deep.",21:01:05,DD
CXFY99245025482787,GB97FHKC16607677923892,11/26/2015,10818.89,100002,Y,Online Shopping,CHROME,POS,Dr,2:51:50,6:14:36,3/15/2017,72079317,896.15,2,"Each place second hour student specific final. Soon high table feel offer.
Spend health system really military. Class political else high media nature present.",5:01:57,IMPS
CXFY99245025482787,GB97FHKC16607677923892,11/26/2015,11715.04,100002,N,Credited,CHROME,PC,Cr,11:24:04,14:09:24,3/15/2017,36926022,896.15,3,"Score stuff pay music spring chance accept. Clear follow sense PM sure. Cultural technology thousand business both last.
Stop realize cut game remember itself.",13:36:13,RTGS
CXFY99245025482787,GB97FHKC16607677923892,11/26/2015,12611.19,100002,N,Credited,MI,PC,Cr,16:29:57,19:40:17,3/15/2017,93017756,896.15,3,"Kind ground college trip by. List most open room professor.
Bad likely for computer plan claim than. Each unit miss. Partner prepare job personal fly.
Customer enter get. Sort politics process.",18:28:20,RTGS
CXFY99245025482787,GB97FHKC16607677923892,11/26/2015,11715.04,100002,Y,Online Shopping,EDGE,POS,Dr,18:55:32,21:02:38,3/15/2017,65429471,896.15,6,"Rate group start position lawyer station think. Task strategy firm crime compare back radio money.
Study arm financial audience to. Public usually some possible senior current.",19:48:35,CHEQUE
CXFY99245025482787,GB97FHKC16607677923892,11/26/2015,13491.04,100002,N,Credited,FF,POS,Cr,8:54:40,13:10:38,3/16/2017,73842415,1776,4,Third watch second painting. People would development none apply cup white.,12:05:04,UPI
CXFY99245025482787,GB97FHKC16607677923892,11/26/2015,15267.04,100002,N,Credited,IE,PC,Cr,20:54:18,26:32:07,3/16/2017,64278179,1776,5,Glass wall think mother business attorney. Quite we wife early share. Billion responsibility expert skill possible hour same.,23:13:38,CARDS
CXFY99245025482787,GB97FHKC16607677923892,11/26/2015,16870.85,100002,N,Credited,FF,MOBILE,Cr,5:25:02,9:09:27,3/19/2017,3156506,1603.81,7,Training affect southern difference son business. Perhaps dark state community direction economic moment.,6:18:00,DD
CXFY99245025482787,GB97FHKC16607677923892,11/26/2015,15267.04,100002,Y,Dining,OPERA,MOBILE,Dr,11:06:39,15:57:58,3/19/2017,56273366,1603.81,6,"Me work go fire how five. Drug important but their fill sit clearly.
Picture growth poor. Research fish heart attorney.
Body travel if meeting exist successful. Officer red occur president TV drop.",13:40:29,CHEQUE
CXFY99245025482787,GB97FHKC16607677923892,11/26/2015,16870.85,100002,N,Credited,FF,POS,Cr,17:51:16,22:40:38,3/19/2017,84690852,1603.81,5,"Try present station food stay. Then stand civil financial career recently.
Call leader child. Include such able tell not sense again.",19:43:51,CARDS
CXFY99245025482787,GB97FHKC16607677923892,11/26/2015,16649.73,100002,Y,Medicals,CHROME,MOBILE,Dr,9:12:09,11:45:43,3/20/2017,87028904,221.12,2,"Drug police single partner everyone window. Enter court read.
Entire blood say. Message voice table change. Past threat expert crime support need worker.",10:47:15,IMPS
CXFY99245025482787,GB97FHKC16607677923892,11/26/2015,16870.85,100002,N,Credited,EDGE,MOBILE,Cr,16:42:58,22:48:16,3/20/2017,92383609,221.12,1,Office message today own analysis. Once return must carry behavior lawyer. Home use bring project less recognize degree. Create walk meet look glass state.,19:07:11,NEFT
CXFY99245025482787,GB97FHKC16607677923892,11/26/2015,16882,100002,N,Credited,FF,MOBILE,Cr,8:40:47,13:32:55,3/29/2017,37157906,11.15,1,Term develop who American firm today. Business get voice teach himself right manage charge. Stage within whom research science in apply. Suddenly commercial animal base professor down many.,10:58:30,NEFT
CXFY99245025482787,GB97FHKC16607677923892,11/26/2015,16870.85,100002,Y,Entertainment,CHROME,MOBILE,Dr,14:45:44,18:51:23,3/29/2017,88906959,11.15,3,"Better wrong quite. Politics without fear news argue identify.
Read assume live family always foot. Foreign best their bad interest write follow image.",17:29:28,RTGS
CXFY99245025482787,GB97FHKC16607677923892,11/26/2015,16882,100002,N,Credited,IE,PC,Cr,16:30:43,19:31:08,3/29/2017,38167133,11.15,1,Event with born participant night bill. Authority between loss relationship parent grow wind. Identify college ahead think ball. Seem dog couple attorney issue school.,18:30:51,NEFT
CXFY99245025482787,GB97FHKC16607677923892,11/26/2015,17743.66,100002,N,Credited,CHROME,PC,Cr,5:44:22,9:09:33,4/2/2017,37245740,861.66,3,"Imagine want certain live more black. Opportunity week fear wife move doctor issue.
Environment allow serve onto be. Medical onto wind citizen.
Some record point adult to rise.",7:23:08,RTGS
CXFY99245025482787,GB97FHKC16607677923892,11/26/2015,18605.32,100002,N,Credited,IE,PC,Cr,7:13:51,9:27:13,4/2/2017,87227437,861.66,7,"Happen become involve whose big. Campaign mention glass size oil very.
Campaign right bad nature arm heart. Once year social eat. Social opportunity hospital culture.",8:51:17,DD
CXFY99245025482787,GB97FHKC16607677923892,11/26/2015,17743.66,100002,Y,Utilities,EDGE,MOBILE,Dr,14:12:12,16:16:00,4/2/2017,59412045,861.66,3,"Author student become find certain yeah.
Could tree realize never provide really. Still six image writer. Information sister walk into attorney rate management its.",15:33:52,RTGS
CXFY99245025482787,GB97FHKC16607677923892,11/26/2015,16882,100002,Y,Medicals,OPERA,MOBILE,Dr,16:34:58,19:32:36,4/2/2017,14171215,861.66,6,"Maybe be seem outside buy represent before check. Woman really word be of material create shake.
Attack act stand him. Another church involve car.",17:44:25,CHEQUE
CXFY99245025482787,GB97FHKC16607677923892,11/26/2015,17743.66,100002,N,Credited,SAFARI,PC,Cr,20:54:17,24:04:36,4/2/2017,93627054,861.66,3,"Sometimes now onto necessary. With door prove return. Happen picture Mrs indicate take bar push. Information talk direction chair a.
These off create condition reality hour hair network.",22:49:23,RTGS
CXFY99245025482787,GB97FHKC16607677923892,11/26/2015,17735.33,100002,Y,Entertainment,IE,POS,Dr,9:04:50,19:51:49,4/3/2017,93955546,8.33,6,Tell arm air manage matter catch. Similar join education memory international age process draw.,15:01:07,CHEQUE
CXFY99245025482787,GB97FHKC16607677923892,11/26/2015,17051.6,100002,Y,Online Shopping,FF,POS,Dr,7:31:20,10:44:45,4/14/2017,1922431,683.73,7,"It day result six care mission administration child. Federal today somebody.
Show special number thus form. Manager person toward cause animal.",8:52:21,DD
CXFY99245025482787,GB97FHKC16607677923892,11/26/2015,16367.87,100002,Y,Medicals,OPERA,MOBILE,Dr,10:26:40,12:40:56,4/14/2017,33875316,683.73,5,"Consumer need knowledge most happen. Side citizen that pretty spend nature send.
She particular majority so brother commercial. Approach million sort reveal often second.",12:09:10,CARDS
CXFY99245025482787,GB97FHKC16607677923892,11/26/2015,17051.6,100002,N,Credited,OPERA,PC,Cr,13:43:26,15:53:43,4/14/2017,48241014,683.73,7,Perhaps candidate song education throughout shake several billion. Feeling business outside source of already.,14:26:55,DD
CXFY99245025482787,GB97FHKC16607677923892,11/26/2015,17735.33,100002,N,Credited,SAFARI,MOBILE,Cr,19:54:30,23:17:40,4/14/2017,86528337,683.73,2,"Son force culture offer future relate arm. Money discover health similar star pretty.
Perhaps operation model model growth. Customer affect bed weight difference.",21:29:12,IMPS
CXFY99245025482787,GB97FHKC16607677923892,11/26/2015,17344.4,100002,Y,Transportation,FF,MOBILE,Dr,4:43:59,9:40:46,4/15/2017,12251247,390.93,1,"Continue memory success star white traditional name. None hit think heavy.
Magazine debate learn continue trouble fly. Work image next line either might.",7:42:40,NEFT
CXFY99245025482787,GB97FHKC16607677923892,11/26/2015,16953.47,100002,Y,Rent,FF,PC,Dr,13:55:21,16:58:57,4/15/2017,59414728,390.93,4,Ask behavior third or ok. Early close there key throw lot table. Prepare spend executive specific research hour throughout.,15:33:21,UPI
CXFY99245025482787,GB97FHKC16607677923892,11/26/2015,17344.4,100002,N,Credited,CHROME,PC,Cr,21:39:33,24:30:00,4/15/2017,62999229,390.93,6,"Answer miss turn including back the until different. Late material vote business activity.
Including high clearly machine. Husband business until require page could.",22:32:37,CHEQUE
CXFY99245025482787,GB97FHKC16607677923892,11/26/2015,17059.31,100002,Y,Utilities,EDGE,PC,Dr,7:07:55,11:34:53,4/16/2017,53531933,285.09,6,"Can major pattern close agree decision position. Director authority sell bag factor yeah try.
Between step enough. Low industry blue new.",10:04:38,CHEQUE
CXFY99245025482787,GB97FHKC16607677923892,11/26/2015,17344.4,100002,N,Credited,SAFARI,PC,Cr,20:39:57,25:22:06,4/16/2017,99904043,285.09,3,Soldier room popular girl. Quickly top meet different figure lawyer. Whose first sit oil region grow three.,22:58:48,RTGS
CXFY99245025482787,GB97FHKC16607677923892,11/26/2015,17877.79,100002,N,Credited,OPERA,POS,Cr,7:51:19,8:52:25,4/24/2017,29181476,533.39,2,"Others receive probably environmental wide. Light level join space. Where hair age then. Also structure will hospital language lead.
Blood force back. Mr open cell.",8:21:17,IMPS
CXFY99245025482787,GB97FHKC16607677923892,11/26/2015,17344.4,100002,Y,Dining,CHROME,POS,Dr,9:47:21,12:43:17,4/24/2017,83802614,533.39,5,"Western yes simple player effort.
Outside between purpose matter top ground company. Participant box do edge maybe much ten.",12:09:01,CARDS
CXFY99245025482787,GB97FHKC16607677923892,11/26/2015,17877.79,100002,N,Credited,MI,MOBILE,Cr,17:12:54,20:04:28,4/24/2017,66591337,533.39,2,Plant industry difficult thought whose instead far. As author quality plant within least. Already range course cultural two as easy open.,19:09:25,IMPS
CXFY99245025482787,GB97FHKC16607677923892,11/26/2015,18411.18,100002,N,Credited,FF,PC,Cr,19:57:47,21:17:31,4/24/2017,28922292,533.39,7,"Measure instead view break simple enjoy. Scene next yard now. Get happy trouble member. Recently parent century do.
Week main money before source suddenly maybe attack.",20:39:06,DD
CXFY99245025482787,GB97FHKC16607677923892,11/26/2015,17234.01,100002,Y,Household Consumables,IE,MOBILE,Dr,5:14:48,9:54:26,5/14/2017,51601904,1177.17,6,Important understand within me himself or. Stock light future remember remain natural so.,7:56:02,CHEQUE
CXFY99245025482787,GB97FHKC16607677923892,11/26/2015,16056.84,100002,Y,Groceries,SAFARI,POS,Dr,12:39:05,16:11:28,5/14/2017,65289891,1177.17,4,"Easy service nearly voice whom them event. Picture for chair such break anyone develop.
It so wall sort. Fall democratic drop you religious.",14:22:28,UPI
CXFY99245025482787,GB97FHKC16607677923892,11/26/2015,14879.67,100002,Y,Personal Care,IE,MOBILE,Dr,18:50:10,21:25:08,5/14/2017,88920177,1177.17,6,"Fire baby respond me course mother. Research mission book size expert.
Hot type arrive civil huge. Together central fast. Personal field against water read or.",19:56:19,CHEQUE
CXFY99245025482787,GB97FHKC16607677923892,11/26/2015,15431,100002,N,Credited,FF,POS,Cr,13:35:54,17:33:31,5/16/2017,65269008,551.33,6,"Medical level prove national. After beat rest because push.
Career although leg use different. Artist everyone various.
Moment west investment ever human. Only last maintain cause foreign.",14:52:47,CHEQUE
CXFY99245025482787,GB97FHKC16607677923892,11/26/2015,15982.33,100002,N,Credited,FF,PC,Cr,22:30:15,24:58:18,5/16/2017,52882883,551.33,2,"Lose range yeah know be feel. Think dream country education look determine.
American art outside physical. Theory first along industry.
Safe same hard senior.",23:18:37,IMPS
CXFY99245025482787,GB97FHKC16607677923892,11/26/2015,16918.17,100002,N,Credited,EDGE,MOBILE,Cr,17:17:59,20:20:18,5/19/2017,34490402,935.84,3,"Morning improve game simply another. Media phone letter very per represent. Sell main my just sport chair traditional.
Mouth statement good wrong.",18:39:20,RTGS
CXFY99245025482787,GB97FHKC16607677923892,11/26/2015,15627.25,100002,Y,Personal Care,EDGE,PC,Dr,6:17:01,8:37:51,6/1/2017,78733350,1290.92,7,"One ok surface walk court today rate fund. Focus ask detail several important couple.
Raise program keep accept. Task share successful ten reality. Seat week figure. Effect she personal fact.",7:34:51,DD
CXFY99245025482787,GB97FHKC16607677923892,11/26/2015,14336.33,100002,Y,Dining,MI,POS,Dr,12:35:09,15:48:26,6/1/2017,68398934,1290.92,7,Upon especially policy none gun recognize. Knowledge technology page defense behind thank start. Foot development since edge product manage.,13:59:01,DD
CXFY99245025482787,GB97FHKC16607677923892,11/26/2015,13045.41,100002,Y,Personal Care,IE,PC,Dr,22:25:40,26:38:03,6/1/2017,30277410,1290.92,5,"Also road team be. Loss now tree close country they may.
Begin identify big hand task stage. Data eye avoid nice stage.",23:49:40,CARDS
CXFY99245025482787,GB97FHKC16607677923892,11/26/2015,13880.9,100002,N,Credited,OPERA,POS,Cr,5:24:17,8:08:10,6/5/2017,31631846,835.49,3,City performance rather player pick me condition. Heavy lot television talk run cultural live with.,7:20:37,RTGS
CXFY99245025482787,GB97FHKC16607677923892,11/26/2015,13045.41,100002,Y,Transportation,SAFARI,POS,Dr,6:39:33,9:54:09,6/5/2017,55632447,835.49,3,Civil center administration finish article hundred. Stage its record open machine stay maybe peace.,8:12:15,RTGS
CXFY99245025482787,GB97FHKC16607677923892,11/26/2015,12209.92,100002,Y,Groceries,IE,MOBILE,Dr,12:00:37,15:13:13,6/5/2017,48597043,835.49,1,Forget we author. Occur small finally each. Art movie increase there serve finally quality. Than same cut magazine.,13:35:27,NEFT
CXFY99245025482787,GB97FHKC16607677923892,11/26/2015,13045.41,100002,N,Credited,FF,MOBILE,Cr,15:52:51,17:26:47,6/5/2017,25925777,835.49,3,"Her near board child small series role. Find charge which seek hand. Beat list despite we.
Despite rate argue. Much whatever sort always couple. Wall affect factor claim third degree institution.",16:48:18,RTGS
CXFY99245025482787,GB97FHKC16607677923892,11/26/2015,12209.92,100002,Y,Household Consumables,IE,POS,Dr,21:59:56,25:14:25,6/5/2017,82793111,835.49,5,"Former professional drug house debate develop between. About inside thousand enough. Situation consider friend population fast age.
Life address day stand. Throw require nature bar.",23:17:40,CARDS
CXFY99245025482787,GB97FHKC16607677923892,11/26/2015,11163.89,100002,Y,Medicals,OPERA,POS,Dr,8:11:38,11:51:09,6/12/2017,24155441,1046.03,1,"Level technology pull guy grow why. Second a focus her interview all under. Computer mouth need order rise hit.
Stock direction no place customer home. Pull pressure ever top line national.",10:02:31,NEFT
CXFY99245025482787,GB97FHKC16607677923892,11/26/2015,10117.86,100002,Y,Transportation,CHROME,MOBILE,Dr,13:46:59,17:41:27,6/12/2017,53604927,1046.03,6,"Evening pay arrive like. Other manage you senior on cut.
Anything recently anything consider operation man far television. Ball our type cover.",16:43:51,CHEQUE
CXFY99245025482787,GB97FHKC16607677923892,11/26/2015,11163.89,100002,N,Credited,EDGE,POS,Cr,20:46:20,24:18:22,6/12/2017,27089989,1046.03,7,Enjoy five particularly player minute trial civil outside. Pull low spring so significant phone against police. Whose energy federal still top risk management.,23:21:46,DD
CXFY99245025482787,GB97FHKC16607677923892,11/26/2015,12759.04,100002,N,Credited,IE,MOBILE,Cr,2:41:31,5:43:04,6/21/2017,1318357,1595.15,3,Institution create trial discussion meeting. Measure a late war million throw least. Party pull alone inside life attorney.,4:48:24,RTGS
CXFY99245025482787,GB97FHKC16607677923892,11/26/2015,11163.89,100002,Y,Transportation,IE,POS,Dr,12:52:34,15:46:51,6/21/2017,66428596,1595.15,2,"Message although scene part magazine mention assume. Simple sometimes treatment wall old seat down.
Later state set effort reveal. Authority film have serious two.",14:11:09,IMPS
CXFY99245025482787,GB97FHKC16607677923892,11/26/2015,9568.74,100002,Y,Utilities,FF,PC,Dr,13:42:50,17:19:10,6/21/2017,47327368,1595.15,3,"Seem nor player star mother visit responsibility. Seek wish no ground reduce according safe. Phone if stage training.
Fine house speech safe foreign leg. Discussion sea bag.",14:59:18,RTGS
CXFY99245025482787,GB97FHKC16607677923892,11/26/2015,11163.89,100002,N,Credited,EDGE,POS,Cr,20:14:40,23:00:34,6/21/2017,73152439,1595.15,6,No according cold international term professional benefit. Drive long fly policy service. Avoid force for thought.,21:36:53,CHEQUE
CXFY99245025482787,GB97FHKC16607677923892,11/26/2015,11106.66,100002,Y,Insurance,CHROME,PC,Dr,4:04:17,6:59:03,6/25/2017,7418860,57.23,1,Most play option drive to room wish. Spring rise still science people appear past. Try commercial right. Explain only stage personal affect tell west.,6:00:40,NEFT
CXFY99245025482787,GB97FHKC16607677923892,11/26/2015,11163.89,100002,N,Credited,MI,POS,Cr,11:53:28,14:53:02,6/25/2017,47089884,57.23,6,"Hold defense kitchen point present walk month.
Red almost staff court voice little. Some church sit politics remember.",13:27:00,CHEQUE
CXFY99245025482787,GB97FHKC16607677923892,11/26/2015,11106.66,100002,Y,Personal Care,EDGE,POS,Dr,16:47:50,19:57:52,6/25/2017,36614394,57.23,3,"Total near surface soldier appear your treat. Somebody everything whom why.
Pull modern three agency drop. Perform whether performance special wish with.
Leg cost their cause.",17:41:09,RTGS
CXFY99245025482787,GB97FHKC16607677923892,11/26/2015,11049.43,100002,Y,Personal Care,SAFARI,POS,Dr,18:38:07,22:22:23,6/25/2017,5316809,57.23,5,Congress public either every. Shake material next generation their party seem. Machine collection former return where. Member hospital meeting feel discover account five.,20:59:12,CARDS
CXFY99245025482787,GB97FHKC16607677923892,11/26/2015,11463.11,100002,N,Credited,SAFARI,PC,Cr,10:45:42,22:38:03,7/1/2017,11909057,413.68,3,"Simple vote safe arm fight at. Watch top price term truth develop.
Month baby entire book. Son or play goal city country think. Environmental dream before eye machine look station.",16:45:05,RTGS
CXFY99245025482787,GB97FHKC16607677923892,11/26/2015,10529.46,100002,Y,Groceries,OPERA,POS,Dr,8:38:28,10:10:54,7/5/2017,49152906,933.65,1,Far research pull cold. Finally tonight nature hair. Single every billion sister writer walk what wait. Available fund guy miss maintain current.,9:30:29,NEFT
CXFY99245025482787,GB97FHKC16607677923892,11/26/2015,11463.11,100002,N,Credited,OPERA,PC,Cr,13:16:19,15:59:09,7/5/2017,81026258,933.65,7,"Section whose answer of consumer. Use source price. Will cut young these language.
Special actually amount event. Middle economic safe example spring. Per trouble section light all.",13:57:42,DD
CXFY99245025482787,GB97FHKC16607677923892,11/26/2015,10529.46,100002,Y,Groceries,FF,POS,Dr,17:47:52,20:54:44,7/5/2017,53848215,933.65,7,Policy prevent woman box window people opportunity. Between reach gun her region. Add interest health.,19:03:51,DD
CXFY99245025482787,GB97FHKC16607677923892,11/26/2015,11463.11,100002,N,Credited,FF,PC,Cr,17:33:38,20:25:14,7/5/2017,83480195,933.65,4,"System should nor present feeling compare buy. Than my national close them. Pm bit year follow what.
Sing end group later staff perform. Bit practice suggest up include soldier mouth.",19:32:04,UPI
CXFY99245025482787,GB97FHKC16607677923892,11/26/2015,12166.2,100002,N,Credited,OPERA,MOBILE,Cr,5:10:19,8:11:19,7/10/2017,93876728,703.09,6,Leg this edge police seek last major they. Road short half capital especially available.,6:34:19,CHEQUE
CXFY99245025482787,GB97FHKC16607677923892,11/26/2015,11463.11,100002,Y,Rent,CHROME,PC,Dr,13:41:28,18:28:14,7/10/2017,20345785,703.09,1,"Science shake note laugh important realize. Kitchen affect mission should water she difficult seven.
Low himself society degree. Daughter information surface vote stop.",16:09:35,NEFT
CXFY99245025482787,GB97FHKC16607677923892,11/26/2015,10760.02,100002,Y,Personal Care,CHROME,MOBILE,Dr,16:32:47,21:39:24,7/10/2017,60178855,703.09,5,"On sea find provide woman yeah. Mouth discussion space standard fire. South human nothing enjoy light discussion.
Ground president truth commercial forward. Art boy others region final experience.",18:57:33,CARDS
CXFY99245025482787,GB97FHKC16607677923892,11/26/2015,9779.31,100002,Y,Groceries,MI,PC,Dr,5:07:19,8:07:22,7/19/2017,89321539,980.71,5,"Side sign who campaign administration whether. Store experience nature control win.
Well debate kind. However any service spring stop land.
Individual talk continue nature.",6:36:30,CARDS
CXFY99245025482787,GB97FHKC16607677923892,11/26/2015,10760.02,100002,N,Credited,SAFARI,PC,Cr,10:04:43,11:09:19,7/19/2017,6661205,980.71,6,Fish every staff soldier participant. Relationship shake yourself prevent eat those break.,10:43:03,CHEQUE
CXFY99245025482787,GB97FHKC16607677923892,11/26/2015,9779.31,100002,Y,Online Shopping,FF,PC,Dr,11:14:47,12:50:27,7/19/2017,96020227,980.71,4,"Hear wide few thousand director.
Design standard prepare establish at rock color every.
Change such throw plan sometimes prepare. Garden information in firm make work almost language.",12:04:49,UPI
CXFY99245025482787,GB97FHKC16607677923892,11/26/2015,8798.6,100002,Y,Transportation,IE,POS,Dr,18:27:59,20:23:24,7/19/2017,26859132,980.71,2,"Help perhaps along hit. Drug political board after knowledge within.
Court name else. Better water out friend. Follow lead any personal yeah us.",19:07:35,IMPS
CXFY99245025482787,GB97FHKC16607677923892,11/26/2015,7817.89,100002,Y,Insurance,EDGE,PC,Dr,21:00:32,23:17:33,7/19/2017,27980071,980.71,5,Report paper consumer to expert. General look street story spend defense born. Minute activity speech true enjoy.,22:21:47,CARDS
CXFY99245025482787,GB97FHKC16607677923892,11/26/2015,7296.61,100002,Y,Utilities,CHROME,PC,Dr,4:23:45,6:53:23,7/22/2017,41221068,521.28,2,Stop never rate peace blue century laugh reveal. Water accept table example understand rule and control. Her difference stop part serious.,5:04:19,IMPS
CXFY99245025482787,GB97FHKC16607677923892,11/26/2015,6775.33,100002,Y,Household Consumables,EDGE,PC,Dr,10:58:08,13:13:49,7/22/2017,81405763,521.28,1,"Bar Democrat conference born couple financial most five. Whole perhaps arm reason partner.
Miss campaign deal campaign lawyer blood. Without almost social real. May kitchen ball talk manager.",11:22:43,NEFT
CXFY99245025482787,GB97FHKC16607677923892,11/26/2015,7296.61,100002,N,Credited,FF,POS,Cr,13:27:16,15:46:28,7/22/2017,21951589,521.28,5,"Even pretty modern trade north style. Any fast trade explain yeah Republican week.
Television sport no worry. Artist agree pressure accept task. Law hotel piece defense experience forget.",14:33:09,CARDS
CXFY99245025482787,GB97FHKC16607677923892,11/26/2015,6775.33,100002,Y,Personal Care,OPERA,PC,Dr,16:03:16,19:00:46,7/22/2017,67169962,521.28,5,Trade light affect wonder. Decision place group town behind. Put always more much report lead list.,17:22:45,CARDS
CXFY99245025482787,GB97FHKC16607677923892,11/26/2015,7296.61,100002,N,Credited,SAFARI,MOBILE,Cr,19:00:38,21:32:39,7/22/2017,59189619,521.28,2,Attention everything effect real year however produce. Page read true decade. Size enter whether prepare with technology.,20:54:38,IMPS
CXFY99245025482787,GB97FHKC16607677923892,11/26/2015,7306.38,100002,N,Credited,SAFARI,POS,Cr,6:16:41,8:41:34,7/31/2017,82723675,9.77,7,"Son wrong serve.
Black deep issue whatever foreign interesting. Accept child claim choose lawyer week present staff. Player piece while bill loss federal add.",6:53:19,DD
CXFY99245025482787,GB97FHKC16607677923892,11/26/2015,7316.15,100002,N,Credited,EDGE,PC,Cr,14:08:46,19:08:57,7/31/2017,54599758,9.77,6,Cause page moment former back huge. Garden hospital skill decision. Hard however table.,17:00:55,CHEQUE
CXFY99245025482787,GB97FHKC16607677923892,11/26/2015,7306.38,100002,Y,Online Shopping,FF,POS,Dr,18:29:40,23:49:41,7/31/2017,72500675,9.77,3,Wind avoid garden. Recent decision produce maybe line couple. Wall beautiful reach film top political beyond.,21:15:41,RTGS
CXFY99245025482787,GB97FHKC16607677923892,11/26/2015,7475.45,100002,N,Credited,SAFARI,POS,Cr,5:51:42,8:05:20,8/3/2017,92402478,169.07,5,"Card attorney serious total. Wind others fight Democrat bed author audience rise.
Movie so size chair memory visit exist central. Five major your of provide. Which study cut economic three.",7:35:51,CARDS
CXFY99245025482787,GB97FHKC16607677923892,11/26/2015,7644.52,100002,N,Credited,FF,POS,Cr,7:36:25,10:19:01,8/3/2017,9512917,169.07,6,"Send house eight hot. Fund specific six again. Republican almost yourself important process degree base.
Space matter could say. Network center all begin. Rock tend indeed last.",9:01:47,CHEQUE
CXFY99245025482787,GB97FHKC16607677923892,11/26/2015,7813.59,100002,N,Credited,MI,MOBILE,Cr,14:28:09,16:45:48,8/3/2017,79662765,169.07,2,Many look gun drug goal call personal. Particular on yet enough adult image according.,15:16:28,IMPS
CXFY99245025482787,GB97FHKC16607677923892,11/26/2015,7644.52,100002,Y,Rent,CHROME,PC,Dr,14:12:20,17:10:21,8/3/2017,30151826,169.07,7,Way card car commercial five new chair. Bill example far appear ability. Particularly response partner charge store.,16:03:22,DD
CXFY99245025482787,GB97FHKC16607677923892,11/26/2015,7813.59,100002,N,Credited,SAFARI,MOBILE,Cr,19:16:03,22:20:27,8/3/2017,85192430,169.07,5,"Almost role stop into moment ahead. Into else your physical also each science. Interest value benefit most run oil option.
By last expert hospital cost.",20:24:48,CARDS
CXFY99245025482787,GB97FHKC16607677923892,11/26/2015,9469.42,100002,N,Credited,CHROME,MOBILE,Cr,11:37:34,18:18:33,8/4/2017,600873,1655.83,5,"Force past watch only until dark. Base tree deal weight number break.
Expect produce huge adult. Do those organization.",16:03:18,CARDS
CXFY99245025482787,GB97FHKC16607677923892,11/26/2015,8261.38,100002,Y,Personal Care,FF,MOBILE,Dr,6:13:18,10:54:41,8/5/2017,52682636,1208.04,4,"Party defense street important. Prevent at miss audience religious six.
Example name win. Whatever fill however example reveal get support question.",8:03:40,UPI
CXFY99245025482787,GB97FHKC16607677923892,11/26/2015,9469.42,100002,N,Credited,IE,PC,Cr,11:39:28,14:42:12,8/5/2017,49990621,1208.04,3,"Live Mrs outside again somebody.
Natural too low art their view news. Will three factor affect well site. I citizen question cultural firm tonight number.",12:55:15,RTGS
CXFY99245025482787,GB97FHKC16607677923892,11/26/2015,8261.38,100002,Y,Groceries,IE,PC,Dr,19:25:59,22:16:18,8/5/2017,15709219,1208.04,7,"Effort behavior listen everyone cell. Interesting will director. Good agent score truth interesting so effect.
Mrs lay available way.",20:16:22,DD
CXFY99245025482787,GB97FHKC16607677923892,11/26/2015,7810.27,100002,Y,Groceries,SAFARI,MOBILE,Dr,11:28:07,18:33:11,8/10/2017,89123195,451.11,3,"Thousand former realize relationship actually worry let. New end debate yourself.
Specific left father sister west. Popular computer church. Common industry only business same.",14:43:41,RTGS
CXFY99245025482787,GB97FHKC16607677923892,11/26/2015,7910.17,100002,N,Credited,FF,PC,Cr,7:40:08,11:01:28,8/11/2017,53763143,99.9,3,Purpose reveal trip model international water. Into message move democratic language idea bag for. Concern minute it my house their. Turn color enter stock even.,8:41:38,RTGS
CXFY99245025482787,GB97FHKC16607677923892,11/26/2015,7810.27,100002,Y,Insurance,SAFARI,POS,Dr,8:28:42,10:49:42,8/11/2017,65459669,99.9,7,"It because class put energy cost least.
Standard age marriage avoid I whom development. Important series husband with its sell.",10:15:40,DD
CXFY99245025482787,GB97FHKC16607677923892,11/26/2015,7710.37,100002,Y,Transportation,FF,POS,Dr,12:21:00,16:11:59,8/11/2017,68574888,99.9,1,"Especially peace color Mr. Research five from training. Make force part remember religious.
Up idea major involve song. Pass end speak pressure. Turn ground trip cultural.",14:25:23,NEFT
CXFY99245025482787,GB97FHKC16607677923892,11/26/2015,7610.47,100002,Y,Medicals,IE,POS,Dr,18:46:17,21:44:38,8/11/2017,22963956,99.9,3,"Dinner cost general better old director. Partner service drop hotel pay chair. Anything whole whatever cover heart coach.
Say total camera level clear actually authority. Fall what low image.",19:37:44,RTGS
CXFY99245025482787,GB97FHKC16607677923892,11/26/2015,8364.09,100002,N,Credited,MI,MOBILE,Cr,7:03:14,13:21:20,8/18/2017,8120571,753.62,7,"Point example crime example. Fire during relate.
Discuss avoid hit we weight per owner. Reality pull sell draw hit bad relationship.
Factor group cultural office seat baby large.",10:40:39,DD
CXFY99245025482787,GB97FHKC16607677923892,11/26/2015,9117.71,100002,N,Credited,FF,PC,Cr,18:08:24,22:59:17,8/18/2017,80522904,753.62,7,"Your challenge suffer who rate. Sign strong deep society since.
Move food authority. Apply resource use card. Budget involve how herself.",21:09:43,DD
CXFY99245025482787,GB97FHKC16607677923892,11/26/2015,10540.73,100002,N,Credited,CHROME,PC,Cr,7:32:48,10:11:37,8/25/2017,87480948,1423.02,3,Air bag will employee him suddenly coach. Though man many Mrs ground industry series. Early happen popular medical reason degree between.,8:16:33,RTGS
CXFY99245025482787,GB97FHKC16607677923892,11/26/2015,9117.71,100002,Y,Dining,SAFARI,POS,Dr,9:27:32,13:36:32,8/25/2017,86879583,1423.02,2,"Yard future some final actually assume officer. Alone reality music here.
Professional property hundred turn change sell ready. Trade doctor half very apply.",12:10:56,IMPS
CXFY99245025482787,GB97FHKC16607677923892,11/26/2015,10540.73,100002,N,Credited,OPERA,PC,Cr,19:46:14,24:42:48,8/25/2017,1375558,1423.02,7,"Price situation fight just. Service board movie compare talk bit.
Mouth effort consumer himself one who small. East begin program the modern back.
North green local reason. Company order feel bring.",22:34:39,DD
CXFY99245025482787,GB97FHKC16607677923892,11/26/2015,11858.14,100002,N,Credited,EDGE,PC,Cr,10:30:07,15:39:05,8/26/2017,6095543,1317.41,4,Goal effort statement I carry wait speech machine. Record government meeting current. Ten science brother peace.,11:53:14,UPI
CXFY99245025482787,GB97FHKC16607677923892,11/26/2015,10540.73,100002,Y,Transportation,EDGE,MOBILE,Dr,15:16:00,17:42:40,8/26/2017,23526990,1317.41,2,"Almost second water president success current. Year back quality per leader. Conference body answer computer.
Red add billion run morning federal local many. Really organization exactly seem.",16:37:29,IMPS
CXFY99245025482787,GB97FHKC16607677923892,11/26/2015,10616.62,100002,N,Credited,FF,POS,Cr,15:56:10,21:55:03,9/5/2017,42962052,75.89,4,"Mention those law among authority majority. Value career not amount range far suffer.
Race house probably wall also trial food country. Blood cell movement avoid.",18:42:43,UPI
CXFY99245025482787,GB97FHKC16607677923892,11/26/2015,9628.72,100002,Y,Rent,SAFARI,POS,Dr,11:07:48,13:20:04,9/14/2017,18076455,987.9,6,Soon quickly play let exactly should floor. Economic both everything become personal player. Trouble range draw. Another dream continue subject middle set ago.,11:58:09,CHEQUE
CXFY99245025482787,GB97FHKC16607677923892,11/26/2015,8640.82,100002,Y,Personal Care,MI,POS,Dr,12:10:36,17:04:13,9/14/2017,66685401,987.9,4,"Technology become particular color hundred. Space instead spring process member outside. Here avoid cost end rather both.
Blood drive mother four key suggest. Benefit present participant somebody.",15:05:05,UPI
CXFY99245025482787,GB97FHKC16607677923892,11/26/2015,7652.92,100002,Y,Medicals,MI,POS,Dr,21:45:55,25:11:25,9/14/2017,81695720,987.9,6,Bit Democrat determine even suggest building city. Government watch cup goal. Medical student east return by.,23:50:18,CHEQUE
CXFY99245025482787,GB97FHKC16607677923892,11/26/2015,7539.14,100002,Y,Groceries,CHROME,PC,Dr,8:10:59,13:17:01,10/3/2017,61530003,113.78,5,"Take environmental back nothing art similar. Upon plan commercial.
Throw ten special look.",10:42:33,CARDS
CXFY99245025482787,GB97FHKC16607677923892,11/26/2015,7425.36,100002,Y,Insurance,FF,MOBILE,Dr,13:00:30,17:55:06,10/3/2017,96642849,113.78,1,Speak its box control plant. Soldier the difference avoid. Provide tree level.,15:51:33,NEFT
CXFY99245025482787,GB97FHKC16607677923892,11/26/2015,7311.58,100002,Y,Entertainment,IE,PC,Dr,17:29:30,19:54:37,10/3/2017,40473642,113.78,6,"Because matter hope throughout might.
Daughter beautiful relationship pass. Drive forward well culture task school do. Bad significant quite appear.",18:46:19,CHEQUE
CXFY99245025482787,GB97FHKC16607677923892,11/26/2015,7707.1,100002,N,Credited,OPERA,MOBILE,Cr,6:08:40,8:52:30,10/12/2017,30510944,395.52,1,"Throughout surface require near food black. Voice nation lawyer write west.
Main group idea ability up process enter. Apply key point computer. Her wind decade present after on.",8:11:20,NEFT
CXFY99245025482787,GB97FHKC16607677923892,11/26/2015,7311.58,100002,Y,Transportation,IE,PC,Dr,14:12:24,16:50:38,10/12/2017,77364227,395.52,3,"Compare practice security ahead Congress for cause. Pick cultural fight effect tax poor thank tax.
Outside knowledge ok total of. Seat he choice them. Stage certain member.",15:27:10,RTGS
CXFY99245025482787,GB97FHKC16607677923892,11/26/2015,7707.1,100002,N,Credited,CHROME,PC,Cr,21:46:27,25:25:18,10/12/2017,1922912,395.52,5,Cut resource brother democratic physical should. Staff personal chair. Worker force rather growth attorney.,23:35:16,CARDS
CXFY99245025482787,GB97FHKC16607677923892,11/26/2015,7047.97,100002,Y,Rent,EDGE,MOBILE,Dr,10:26:32,15:46:40,10/16/2017,60735720,659.13,5,"Card offer including current myself shoulder realize. Present pattern raise Mrs then commercial. Baby half each hair rise.
Development radio system fact against production imagine remember.",12:50:33,CARDS
CXFY99245025482787,GB97FHKC16607677923892,11/26/2015,7707.1,100002,N,Credited,SAFARI,PC,Cr,22:12:03,26:06:44,10/16/2017,42407775,659.13,7,"Phone probably deal. Major someone store risk.
People power piece every century by what. Main science read.",23:19:30,DD
CXFY99245025482787,GB97FHKC16607677923892,11/26/2015,6475.37,100002,Y,Online Shopping,MI,PC,Dr,6:23:35,9:13:17,10/18/2017,71254388,1231.73,7,"Decade discover left but month. Middle work training also stay everyone difference.
Or feeling water can know consumer. Until defense send institution enough mission time.",7:25:12,DD
CXFY99245025482787,GB97FHKC16607677923892,11/26/2015,5243.64,100002,Y,Groceries,FF,MOBILE,Dr,8:15:22,10:43:41,10/18/2017,9603738,1231.73,5,These raise both like impact spend down. Rest likely want sort machine prevent although. Notice scientist remain after go people draw. Speak person federal.,9:47:31,CARDS
CXFY99245025482787,GB97FHKC16607677923892,11/26/2015,4011.91,100002,Y,Entertainment,MI,MOBILE,Dr,10:57:36,13:50:43,10/18/2017,47645721,1231.73,3,"Involve expert indicate kid or direction firm. Tv guess lead actually.
Accept style even space ability. Low student though summer.",12:16:50,RTGS
CXFY99245025482787,GB97FHKC16607677923892,11/26/2015,5243.64,100002,N,Credited,IE,PC,Cr,17:31:25,18:59:03,10/18/2017,42193470,1231.73,3,"Off shake western ability read ask purpose.
Without get than marriage audience. Later present school west. Move happy draw think tough during laugh.",18:23:39,RTGS
CXFY99245025482787,GB97FHKC16607677923892,11/26/2015,4011.91,100002,Y,Medicals,MI,POS,Dr,19:59:59,22:22:59,10/18/2017,3074794,1231.73,3,Source fight myself PM keep. Cold show book account quickly town success.,20:41:39,RTGS
CXFY99245025482787,GB97FHKC16607677923892,11/26/2015,3298.98,100002,Y,Rent,IE,PC,Dr,8:59:26,13:22:54,10/20/2017,80241386,712.93,4,"Environment glass standard break improve. Color particular yet news.
Officer we option trip knowledge on customer success. Clearly process develop sport buy wonder.",10:51:35,UPI
CXFY99245025482787,GB97FHKC16607677923892,11/26/2015,4011.91,100002,N,Credited,IE,MOBILE,Cr,13:01:08,15:11:35,10/20/2017,93017350,712.93,3,"Necessary door eye break. Plant force discussion so left hot long. Change ever box trade want.
Attention concern man local. Friend add concern hope imagine game hear.",14:10:03,RTGS
CXFY99245025482787,GB97FHKC16607677923892,11/26/2015,3298.98,100002,Y,Groceries,IE,MOBILE,Dr,18:48:39,22:05:50,10/20/2017,71064048,712.93,7,Notice speak trade perform walk pressure they. Appear production say full. Writer new author event already where little.,21:20:48,DD
CXFY99245025482787,GB97FHKC16607677923892,11/26/2015,3103.67,100002,Y,Utilities,EDGE,POS,Dr,5:42:31,8:05:28,10/21/2017,19390963,195.31,6,"Spend capital walk likely mean will. Anything ten police station.
Tend explain blue. Ability public series experience woman tax throw visit. Certain maybe city just. And arrive plant hand floor.",6:26:01,CHEQUE
CXFY99245025482787,GB97FHKC16607677923892,11/26/2015,2908.36,100002,Y,Dining,EDGE,POS,Dr,9:32:47,12:38:43,10/21/2017,68922382,195.31,1,Light unit three. Case allow where base another friend oil little. Very safe require high writer miss general.,11:26:47,NEFT
CXFY99245025482787,GB97FHKC16607677923892,11/26/2015,2713.05,100002,Y,Entertainment,SAFARI,POS,Dr,10:30:28,13:11:19,10/21/2017,86747462,195.31,3,Single analysis when choice foreign camera few toward. Whom goal strategy quickly thousand. Debate safe dark half difference. Among dinner four still risk authority drug stay.,12:09:30,RTGS
CXFY99245025482787,GB97FHKC16607677923892,11/26/2015,2517.74,100002,Y,Online Shopping,IE,POS,Dr,17:52:50,19:51:38,10/21/2017,11131748,195.31,7,"Along move run defense bank anyone who change.
Her oil crime consider Mrs. Quickly catch son least.
Pattern cup learn pull. From wonder military keep. Interest voice think stock throughout.",19:22:34,DD
CXFY99245025482787,GB97FHKC16607677923892,11/26/2015,2713.05,100002,N,Credited,FF,PC,Cr,19:05:09,21:19:35,10/21/2017,50495214,195.31,4,"Last past out million must sort law. State whom nearly. Behind entire low.
Prove space medical reach outside western join loss. Court out media agency value common.",20:05:06,UPI
CXFY99245025482787,GB97FHKC16607677923892,11/26/2015,1909.56,100002,Y,Personal Care,CHROME,POS,Dr,11:45:28,16:20:58,10/25/2017,98730483,803.49,7,Cup mother already find concern step. Plan central experience. Quite southern personal ask might inside. Include offer not side action must.,14:00:04,DD
CXFY99245025482787,GB97FHKC16607677923892,11/26/2015,1106.07,100002,Y,Insurance,CHROME,PC,Dr,21:32:14,26:31:04,10/25/2017,78010796,803.49,5,"Identify community mention piece affect. Feeling if fact guess worry certain one. Song thus never born trip worry.
Quality describe stage name.
Week hour more lot particularly four represent.",22:38:51,CARDS
CXFY99245025482787,GB97FHKC16607677923892,11/26/2015,1805.32,100002,N,Credited,OPERA,MOBILE,Cr,9:52:31,18:46:50,10/27/2017,12895977,699.25,6,"See time reality recent sit young international. Too language test feeling somebody cut eight.
Air admit day administration. Music offer notice administration include best. Head end herself.",14:52:56,CHEQUE
CXFY99245025482787,GB97FHKC16607677923892,11/26/2015,3404.66,100002,N,Credited,SAFARI,MOBILE,Cr,18:42:58,28:14:53,10/29/2017,45414145,1599.34,1,"Our song cup oil first.
Face trade international deal tonight. Series individual finish laugh call.",22:36:54,NEFT
CXFY99245025482787,GB97FHKC16607677923892,11/26/2015,4514.38,100002,N,Credited,IE,PC,Cr,5:12:46,11:34:01,11/4/2017,22772435,1109.72,1,"Billion act term. Color game listen all white during.
Serious affect she wear about price small. Three amount at plan possible pass indeed accept. Color past like at area he low either.",8:06:51,NEFT
CXFY99245025482787,GB97FHKC16607677923892,11/26/2015,5624.1,100002,N,Credited,IE,MOBILE,Cr,21:31:34,24:43:13,11/4/2017,27725665,1109.72,6,"Prepare office serious. Me happen whatever almost party leg Mr administration. Necessary according good smile ready.
Over specific election full firm never tax.",23:12:22,CHEQUE
CXFY99245025482787,GB97FHKC16607677923892,11/26/2015,4678.57,100002,Y,Transportation,EDGE,MOBILE,Dr,3:45:33,6:26:42,11/11/2017,81455874,945.53,7,"Or short entire whatever fire last. Image than note.
Avoid business that pull various. Cost recent sea imagine. Big she defense a alone treat road level.",5:12:42,DD
CXFY99245025482787,GB97FHKC16607677923892,11/26/2015,3733.04,100002,Y,Entertainment,FF,MOBILE,Dr,9:15:14,11:44:32,11/11/2017,49475838,945.53,7,Affect support again forward school service sister hand. Budget degree environmental health together hour.,10:50:08,DD
CXFY99245025482787,GB97FHKC16607677923892,11/26/2015,4678.57,100002,N,Credited,EDGE,MOBILE,Cr,12:50:12,14:38:59,11/11/2017,82195373,945.53,5,Only suddenly sell fast cell hear their student. Thus Congress arrive real hundred. Range begin charge another north story affect although. Fast middle begin detail north together know.,14:10:24,CARDS
CXFY99245025482787,GB97FHKC16607677923892,11/26/2015,3733.04,100002,Y,Dining,OPERA,PC,Dr,19:21:00,20:47:36,11/11/2017,16561359,945.53,1,"Control herself white past score. Wish determine list risk little toward.
From side hundred once eat ground. Wife in daughter these floor fine.",19:58:23,NEFT
CXFY99245025482787,GB97FHKC16607677923892,11/26/2015,4678.57,100002,N,Credited,CHROME,POS,Cr,21:08:00,23:09:00,11/11/2017,81540372,945.53,6,"Health to born research strong store cup. Notice option leave instead buy southern end. Near record whether.
Fact eight a central. Subject financial student interesting color finish.",21:45:09,CHEQUE
CXFY99245025482787,GB97FHKC16607677923892,11/26/2015,4069.86,100002,Y,Household Consumables,MI,POS,Dr,11:32:50,16:25:19,11/18/2017,68459666,608.71,2,"According talk PM executive newspaper general. Maybe south few.
Administration draw mean. Yourself win close financial should history. Fund western recognize more memory our vote.",12:34:50,IMPS
CXFY99245025482787,GB97FHKC16607677923892,11/26/2015,4678.57,100002,N,Credited,MI,POS,Cr,22:51:13,25:22:52,11/18/2017,23209435,608.71,1,As less so leader join seven. Young thing religious you situation officer. Expect other note send. Impact day pick song face now.,23:55:53,NEFT
CXFY99245025482787,GB97FHKC16607677923892,11/26/2015,3687.54,100002,Y,Insurance,SAFARI,PC,Dr,3:08:35,6:45:56,12/2/2017,15486813,991.03,4,"Along they fund understand hot capital.
Lawyer rather special join since itself.",5:08:53,UPI
CXFY99245025482787,GB97FHKC16607677923892,11/26/2015,2696.51,100002,Y,Rent,EDGE,POS,Dr,9:35:34,11:55:29,12/2/2017,15672346,991.03,7,Song alone with. Animal explain act free study. Paper painting service pretty. South financial never matter difference discussion from.,10:34:51,DD
CXFY99245025482787,GB97FHKC16607677923892,11/26/2015,3687.54,100002,N,Credited,SAFARI,POS,Cr,17:10:52,20:13:12,12/2/2017,89393246,991.03,1,"Fill southern mother plant director. Next its marriage teach hit. Prepare among whole president.
Hot agent daughter hold. Most throughout parent turn. His door provide.",19:04:17,NEFT
CXFY99245025482787,GB97FHKC16607677923892,11/26/2015,2696.51,100002,Y,Household Consumables,MI,POS,Dr,17:31:51,20:39:57,12/2/2017,78664852,991.03,6,Family close painting send news available mother hand. Culture quickly meeting successful important close. Live hour data feeling.,19:29:27,CHEQUE
CXFY99245025482787,GB97FHKC16607677923892,11/26/2015,3912.14,100002,N,Credited,IE,PC,Cr,5:51:08,7:52:56,12/12/2017,29837939,1215.63,2,"Result this magazine conference technology first recently. Television act sea clearly agent.
Strategy political star tell show deep nor.",6:37:48,IMPS
CXFY99245025482787,GB97FHKC16607677923892,11/26/2015,5127.77,100002,N,Credited,SAFARI,PC,Cr,9:51:21,14:18:12,12/12/2017,25996937,1215.63,1,Order perhaps want safe. Thing style enough stand head religious.,12:39:00,NEFT
CXFY99245025482787,GB97FHKC16607677923892,11/26/2015,6343.4,100002,N,Credited,CHROME,POS,Cr,15:47:48,19:50:48,12/12/2017,98090785,1215.63,6,Official hundred ahead sell. Themselves sport car test begin address yeah. Old kid experience to quickly add free cold.,18:42:54,CHEQUE
CXFY99245025482787,GB97FHKC16607677923892,11/26/2015,7261.06,100002,N,Credited,MI,MOBILE,Cr,8:03:29,10:33:11,12/13/2017,84291677,917.66,5,"Else training thus bar son land. Create add edge large option. It customer among after though.
Eye together not suggest difference day. Notice economy clear fall possible democratic onto.",9:11:01,CARDS
CXFY99245025482787,GB97FHKC16607677923892,11/26/2015,8178.72,100002,N,Credited,IE,POS,Cr,9:29:32,14:01:24,12/13/2017,55009546,917.66,2,"Along organization question food food. Law avoid major audience. Lawyer customer quality step month group.
Feeling production water national near pressure most prepare.",11:37:47,IMPS
CXFY99245025482787,GB97FHKC16607677923892,11/26/2015,9096.38,100002,N,Credited,SAFARI,PC,Cr,12:29:45,15:16:20,12/13/2017,15331441,917.66,1,Maybe benefit according our enough argue suggest. Clearly behind born small just letter place. Growth figure different girl painting.,14:37:50,NEFT
CXFY99245025482787,GB97FHKC16607677923892,11/26/2015,8178.72,100002,Y,Entertainment,EDGE,POS,Dr,20:19:09,24:22:04,12/13/2017,26092676,917.66,6,College fall task major eye practice edge. A rule each however institution contain boy which. Wife future recognize organization brother.,22:31:54,CHEQUE
CXFY99245025482787,GB97FHKC16607677923892,11/26/2015,6537.56,100002,Y,Personal Care,EDGE,PC,Dr,4:51:38,7:50:52,12/19/2017,63811254,1641.16,5,"Important wrong manage court become store full. Tough last tough up well clearly stock.
Decide charge minute while key production thing. Adult this own half produce thus. Over just assume.",6:44:18,CARDS
CXFY99245025482787,GB97FHKC16607677923892,11/26/2015,8178.72,100002,N,Credited,FF,PC,Cr,7:23:58,9:35:14,12/19/2017,31283038,1641.16,2,White particular issue be anyone production. Control reason address either. Billion have growth difference voice yourself.,8:07:23,IMPS
CXFY99245025482787,GB97FHKC16607677923892,11/26/2015,6537.56,100002,Y,Medicals,FF,MOBILE,Dr,11:35:18,14:44:43,12/19/2017,14918674,1641.16,5,"Site source score today art agent there. Weight appear collection keep suffer fish choice.
Nature meeting Republican the ask. Of magazine bag treatment box water out capital.",13:05:00,CARDS
CXFY99245025482787,GB97FHKC16607677923892,11/26/2015,4896.4,100002,Y,Utilities,EDGE,PC,Dr,16:51:46,18:08:05,12/19/2017,8065087,1641.16,7,"College especially four answer baby house meet. Still east list including.
Leave although stage above. Western may century organization myself rest dog. Least language information TV.",17:42:56,DD
CXFY99245025482787,GB97FHKC16607677923892,11/26/2015,6537.56,100002,N,Credited,SAFARI,PC,Cr,21:06:19,23:45:56,12/19/2017,55613361,1641.16,5,"Place power nearly mother. Back radio would only. Matter least nor worry pattern.
Research natural during. Lot think office risk mind than start. More above thought treat time against.",22:39:59,CARDS
CXFY99245025482787,GB97FHKC16607677923892,11/26/2015,4922.42,100002,Y,Rent,EDGE,MOBILE,Dr,12:13:51,18:32:03,12/23/2017,84005274,1615.14,1,"Sometimes suffer also maybe image north. Federal need again ball town center type.
Type level admit either over company.",13:42:50,NEFT
CXFY99245025482787,GB97FHKC16607677923892,11/26/2015,6620.43,100002,N,Credited,CHROME,PC,Cr,9:39:06,17:06:10,12/24/2017,32295016,1698.01,4,"Popular writer about travel edge address. Parent much cause keep sure popular allow.
Try so allow magazine minute quickly measure. Attorney debate here party. Better inside total appear keep TV.",14:14:54,UPI
CXFY99245025482787,GB97FHKC16607677923892,11/26/2015,7225.03,100002,N,Credited,MI,MOBILE,Cr,5:26:32,9:23:14,12/25/2017,55577106,604.6,1,Fund rise play dinner level American. Growth once small debate. Particular thing near mother very level in still.,7:26:53,NEFT
CXFY99245025482787,GB97FHKC16607677923892,11/26/2015,6620.43,100002,Y,Transportation,SAFARI,MOBILE,Dr,10:16:51,14:06:29,12/25/2017,3319963,604.6,4,"End practice few if money yourself happen some. Food PM class reality onto answer increase.
Beyond true capital move. Stand option investment cold event book.",12:08:48,UPI
CXFY99245025482787,GB97FHKC16607677923892,11/26/2015,7225.03,100002,N,Credited,OPERA,MOBILE,Cr,14:18:33,17:22:32,12/25/2017,80034377,604.6,1,"Laugh road beautiful discussion capital subject raise ground. Design cause memory address drop. Girl career southern pretty indeed.
Region account agency wonder score fire.",15:17:53,NEFT
CXFY99245025482787,GB97FHKC16607677923892,11/26/2015,7829.63,100002,N,Credited,IE,MOBILE,Cr,19:00:34,22:45:34,12/25/2017,73753261,604.6,4,Official seem dinner reach lose garden present. All skin seat language direction clear charge. Trial message miss until character someone education.,21:03:52,UPI
CXFY99245025482787,GB97FHKC16607677923892,11/26/2015,9122.37,100002,N,Credited,EDGE,PC,Cr,14:00:12,19:54:39,12/27/2017,76411175,1292.74,7,Race sometimes consider before central. Space area family exist. Forget human only decide yes short must. Outside figure sing six focus himself character measure.,17:26:31,DD
CXFY99245025482787,GB97FHKC16607677923892,11/26/2015,10508.72,100002,N,Credited,SAFARI,POS,Cr,3:29:24,9:11:21,1/20/2018,48926270,1386.35,4,"Power town that visit almost note west form. Firm quality reach nature.
Our draw value concern everything rock. Industry whose like particular production focus affect. Financial quite from.",6:12:02,UPI
CXFY99245025482787,GB97FHKC16607677923892,11/26/2015,11895.07,100002,N,Credited,FF,MOBILE,Cr,12:17:09,17:16:58,1/20/2018,61727311,1386.35,1,"Likely standard season share country ground begin among. Like just Congress.
Number knowledge artist where. Process teacher PM bed group civil. Even program national hair former another.",14:39:27,NEFT
CXFY99245025482787,GB97FHKC16607677923892,11/26/2015,13281.42,100002,N,Credited,IE,MOBILE,Cr,21:58:40,23:59:56,1/20/2018,91442345,1386.35,6,"Finish term environment add bed night Democrat. Year nothing draw water picture side because.
Energy walk outside outside. Be environment under from catch.",23:18:18,CHEQUE
CXFY99245025482787,GB97FHKC16607677923892,11/26/2015,11501.32,100002,Y,Dining,FF,MOBILE,Dr,14:45:50,19:13:23,1/21/2018,80609339,1780.1,2,"Everyone per heart recently. Audience laugh lead approach stay.
Move hundred camera leader else tonight better just. Same miss message security air stuff.",16:12:05,IMPS
CXFY99245025482787,GB97FHKC16607677923892,11/26/2015,11144.63,100002,Y,Household Consumables,SAFARI,PC,Dr,14:45:31,17:37:40,1/22/2018,39946270,356.69,6,Decision catch budget occur another own question. Black heart ability with opportunity. According arm special may today.,16:02:27,CHEQUE
CXFY99245025482787,GB97FHKC16607677923892,11/26/2015,9256,100002,Y,Household Consumables,MI,MOBILE,Dr,3:48:39,5:50:41,1/27/2018,42872931,1888.63,1,"Star alone wait significant wrong. Before find morning create seven in.
Lead computer lawyer activity under. Trouble letter bank box color talk.",5:14:55,NEFT
CXFY99245025482787,GB97FHKC16607677923892,11/26/2015,7367.37,100002,Y,Transportation,CHROME,MOBILE,Dr,9:57:41,12:09:39,1/27/2018,77302304,1888.63,7,"Town term myself continue write include what. Increase history drop new.
Trip even contain anything return. Thousand doctor claim half. Might moment approach.",10:49:27,DD
CXFY99245025482787,GB97FHKC16607677923892,11/26/2015,5478.74,100002,Y,Medicals,MI,MOBILE,Dr,12:04:48,15:57:57,1/27/2018,54860735,1888.63,3,"Such upon go. Model administration plant society each line.
Tonight produce just her require try. Her way play million project true.",13:58:56,RTGS
CXFY99245025482787,GB97FHKC16607677923892,11/26/2015,3590.11,100002,Y,Insurance,OPERA,POS,Dr,15:55:26,19:46:00,1/27/2018,96581643,1888.63,1,Help nature difference perform. Religious else trouble word personal.,17:54:29,NEFT
CXFY99245025482787,GB97FHKC16607677923892,11/26/2015,5478.74,100002,N,Credited,MI,PC,Cr,20:23:52,23:07:42,1/27/2018,73512776,1888.63,6,"Amount sense mind community. Street control help until a. Blue understand pretty along clear full.
Husband there sing series. Customer member cell black.",21:53:02,CHEQUE
CXFY99245025482787,GB97FHKC16607677923892,11/26/2015,6909.42,100002,N,Credited,IE,POS,Cr,16:20:48,19:50:19,2/9/2018,587785,1430.68,2,Career base win nation family. Page arm order audience game though miss.,17:52:57,IMPS
CXFY99245025482787,GB97FHKC16607677923892,11/26/2015,5906.59,100002,Y,Transportation,IE,PC,Dr,6:14:38,10:28:38,2/19/2018,99601317,1002.83,5,Beat class four training difference sit strategy clearly. Security just method investment. Light according religious national sit enjoy third. Stuff suddenly answer whether.,7:46:49,CARDS
CXFY99245025482787,GB97FHKC16607677923892,11/26/2015,4903.76,100002,Y,Rent,SAFARI,POS,Dr,11:28:11,14:27:06,2/19/2018,28270669,1002.83,6,Including wife stage here service foot. Prove ready event position. Themselves southern author its. Eight wear politics me option maybe buy.,12:13:13,CHEQUE
CXFY99245025482787,GB97FHKC16607677923892,11/26/2015,5906.59,100002,N,Credited,OPERA,PC,Cr,18:24:48,21:11:29,2/19/2018,50870004,1002.83,4,"Among join good. Share better artist born investment save national. Simply share thought feel.
Rate coach remember top policy.",20:11:56,UPI
CXFY99245025482787,GB97FHKC16607677923892,11/26/2015,5593.81,100002,Y,Dining,SAFARI,POS,Dr,12:45:10,18:53:57,2/20/2018,66133902,312.78,2,"Difficult institution speech nature population person. Movement college lawyer about.
You instead health agree. About their task poor. Us style difference mother human anything.",17:21:36,IMPS
CXFY99245025482787,GB97FHKC16607677923892,11/26/2015,6840.41,100002,N,Credited,EDGE,PC,Cr,9:27:54,14:00:59,2/25/2018,36415281,1246.6,7,"Body material wish case during. Myself important attention hear.
Medical pattern drop song. Radio beautiful part late. Although during various. Debate system thus do once article.",12:42:57,DD
CXFY99245025482787,GB97FHKC16607677923892,11/26/2015,8087.01,100002,N,Credited,MI,MOBILE,Cr,20:12:26,25:09:51,2/25/2018,20880637,1246.6,7,"Follow strategy scientist generation among attorney education serious.
Issue player drive space sure old can. Major create ahead. Show want condition debate read.",22:15:07,DD
CXFY99245025482787,GB97FHKC16607677923892,11/26/2015,6704.98,100002,Y,Online Shopping,SAFARI,POS,Dr,8:26:59,15:38:24,2/26/2018,93940108,1382.03,5,"Simply street safe threat. Bar draw let. Later major tell despite interesting.
Movie it detail partner suffer. Fund be summer now. Available again interesting before hour better indeed.",11:46:01,CARDS
CXFY99245025482787,GB97FHKC16607677923892,11/26/2015,8087.01,100002,N,Credited,EDGE,PC,Cr,15:40:20,19:30:54,2/26/2018,57642550,1382.03,1,Military teacher southern begin include event myself. Sometimes free policy shake director in push.,17:15:41,NEFT
CXFY99245025482787,GB97FHKC16607677923892,11/26/2015,9763.36,100002,N,Credited,EDGE,PC,Cr,9:16:43,13:08:09,3/13/2018,67792818,1676.35,4,State crime loss. Whether four way spring executive. Likely Republican measure left candidate.,11:24:28,UPI
CXFY99245025482787,GB97FHKC16607677923892,11/26/2015,11439.71,100002,N,Credited,CHROME,POS,Cr,10:15:12,15:23:37,3/13/2018,61401198,1676.35,3,"Child total event discover. Hear do significant up rate try should. She PM education alone herself.
Anyone type opportunity tell issue TV him. Several newspaper happy me I him light.",13:04:39,RTGS
CXFY99245025482787,GB97FHKC16607677923892,11/26/2015,9763.36,100002,Y,Transportation,EDGE,POS,Dr,16:31:34,20:26:10,3/13/2018,42270553,1676.35,6,"Seat trouble forget. Whose sometimes friend situation big scene. Onto involve movie mission.
Music during room model gun.
Former part anyone. Painting think start themselves keep.",18:53:12,CHEQUE
CXFY99245025482787,GB97FHKC16607677923892,11/26/2015,11335.34,100002,N,Credited,IE,POS,Cr,7:46:35,10:00:05,4/9/2018,97414919,1571.98,4,"Wear important federal sure. Night anything sister effort model. Purpose understand miss training price process call.
Change line training performance key. Interest listen item community.",8:39:43,UPI
CXFY99245025482787,GB97FHKC16607677923892,11/26/2015,9763.36,100002,Y,Medicals,EDGE,POS,Dr,8:25:12,12:39:15,4/9/2018,27736210,1571.98,4,Evidence across push better exist rule college. Weight rise stage leave. Sort mission study expert who financial. Hundred full camera two.,10:32:23,UPI
CXFY99245025482787,GB97FHKC16607677923892,11/26/2015,11335.34,100002,N,Credited,EDGE,PC,Cr,18:31:46,21:05:56,4/9/2018,40899794,1571.98,6,"Area whatever prove floor trial cup ahead action.
Crime early brother father modern base do. Trouble account degree fear.",19:05:32,CHEQUE
CXFY99245025482787,GB97FHKC16607677923892,11/26/2015,9763.36,100002,Y,Insurance,MI,PC,Dr,20:24:58,23:40:34,4/9/2018,92781092,1571.98,5,"Business teach ok throughout away responsibility. More say head paper. Also west actually Democrat official.
Off actually social certainly local respond drop.",22:44:40,CARDS
CXFY99245025482787,GB97FHKC16607677923892,11/26/2015,8513.05,100002,Y,Transportation,SAFARI,PC,Dr,17:35:17,26:08:30,5/12/2018,78837355,1250.31,5,"Chair open animal suggest save maintain TV.
Stop leader before make firm forward success. Color participant group leg body bill central. Relationship American back information ability.",20:35:41,CARDS
CXFY99245025482787,GB97FHKC16607677923892,11/26/2015,7596.88,100002,Y,Insurance,MI,PC,Dr,6:47:37,11:32:33,5/18/2018,21434884,916.17,6,"Present argue marriage cost street church.
Produce wear people then little paper dinner.
Later mean instead common trouble.",8:48:55,CHEQUE
CXFY99245025482787,GB97FHKC16607677923892,11/26/2015,8513.05,100002,N,Credited,CHROME,PC,Cr,14:52:11,18:42:01,5/18/2018,39409935,916.17,5,"Herself compare contain happy. Especially would campaign various.
Feel decide personal subject animal. Character theory reason wind final however. Simply answer to scene.",17:04:22,CARDS
CXFY99245025482787,GB97FHKC16607677923892,11/26/2015,7287.26,100002,Y,Rent,SAFARI,POS,Dr,4:41:51,7:40:43,5/19/2018,36139101,1225.79,1,Return spend wish light various institution himself set. Western operation unit that the report. Least mind west defense then.,6:40:23,NEFT
CXFY99245025482787,GB97FHKC16607677923892,11/26/2015,8513.05,100002,N,Credited,FF,POS,Cr,9:48:37,12:23:14,5/19/2018,52490651,1225.79,7,"Soon cultural everything thousand fill peace. There head challenge language.
Matter off card tend senior responsibility son person. Good Democrat ability interest. Final happen mind class physical.",11:40:36,DD
CXFY99245025482787,GB97FHKC16607677923892,11/26/2015,9738.84,100002,N,Credited,IE,PC,Cr,11:37:16,15:11:18,5/19/2018,40822488,1225.79,1,Republican nearly deep big. Small year beautiful offer college. Cultural international very school open they far clearly.,13:19:55,NEFT
CXFY99245025482787,GB97FHKC16607677923892,11/26/2015,10964.63,100002,N,Credited,OPERA,MOBILE,Cr,14:44:40,17:39:47,5/19/2018,56290028,1225.79,5,"Six despite pretty drop center worry. Never teach continue. Authority admit writer over west.
View leave federal trouble issue still another.",16:12:12,CARDS
CXFY99245025482787,GB97FHKC16607677923892,11/26/2015,9738.84,100002,Y,Rent,IE,POS,Dr,21:16:49,23:30:02,5/19/2018,76503047,1225.79,2,"Yard hot rather. Identify same recognize film PM establish. Plant class possible gun fill.
It scientist very onto any focus increase usually. Trouble friend can food home.",22:45:41,IMPS
CXFY99245025482787,GB97FHKC16607677923892,11/26/2015,9847.47,100002,N,Credited,FF,PC,Cr,2:15:22,5:12:56,5/21/2018,37391188,108.63,4,"Body provide five long assume tax respond. Federal figure term evidence growth person.
Scene once treat owner PM anyone million.",4:01:08,UPI
CXFY99245025482787,GB97FHKC16607677923892,11/26/2015,9956.1,100002,N,Credited,CHROME,POS,Cr,7:36:38,11:00:41,5/21/2018,94986464,108.63,6,"Chair protect me stock special religious real.
Road ten figure skin success investment only. Since social story bed reason give. Course attack bar wait conference fine education.",9:13:17,CHEQUE
CXFY99245025482787,GB97FHKC16607677923892,11/26/2015,10064.73,100002,N,Credited,OPERA,POS,Cr,12:31:49,14:39:31,5/21/2018,92227286,108.63,1,Short left alone institution hold. Brother event person pass provide small agent. Travel discover natural television. Heavy star budget picture attorney.,13:17:48,NEFT
CXFY99245025482787,GB97FHKC16607677923892,11/26/2015,10173.36,100002,N,Credited,MI,PC,Cr,18:26:05,20:39:22,5/21/2018,27414910,108.63,6,"Girl help response hospital around. President including wall catch. Young room peace someone morning a can see.
Grow she if start thought because impact. Cut TV know food me top item.",19:49:50,CHEQUE
CXFY99245025482787,GB97FHKC16607677923892,11/26/2015,10064.73,100002,Y,Dining,CHROME,PC,Dr,20:09:59,22:56:33,5/21/2018,26002057,108.63,3,"Camera customer always. Training he side.
Charge same college receive ten decision benefit. Shake suffer adult federal hundred.
Debate official clearly. Always president off note apply culture.",21:56:19,RTGS
CXFY99245025482787,GB97FHKC16607677923892,11/26/2015,10027.15,100002,Y,Personal Care,EDGE,POS,Dr,11:59:23,19:25:00,5/25/2018,56506037,37.58,4,Single when their executive tell. Short property father leave enough activity. Necessary billion serve start prevent together pay.,15:43:41,UPI
CXFY99245025482787,GB97FHKC16607677923892,11/26/2015,9989.57,100002,Y,Online Shopping,IE,PC,Dr,15:30:43,17:50:43,5/25/2018,60732767,37.58,2,"Job during spring rather race compare upon. Today agent itself detail central us.
Law direction nice explain despite clearly everybody. Focus by some.",16:52:03,IMPS
CXFY99245025482787,GB97FHKC16607677923892,11/26/2015,11615.33,100002,N,Credited,MI,PC,Cr,3:35:28,5:44:10,6/13/2018,46930705,1625.76,1,"System evidence floor forward magazine bill ground.
Room clearly response picture organization. Several believe shake edge.",4:56:54,NEFT
CXFY99245025482787,GB97FHKC16607677923892,11/26/2015,13241.09,100002,N,Credited,FF,MOBILE,Cr,11:01:52,13:27:35,6/13/2018,83165665,1625.76,6,Maybe tend edge strong three dog. Style sport drop black policy. Value young term detail seven fill.,12:17:22,CHEQUE
CXFY99245025482787,GB97FHKC16607677923892,11/26/2015,11615.33,100002,Y,Entertainment,SAFARI,MOBILE,Dr,15:08:19,18:10:11,6/13/2018,13497262,1625.76,3,"Class benefit leg approach. Hit good argue son somebody simply.
Somebody east decide food. Production plant his world successful generation.",17:27:12,RTGS
CXFY99245025482787,GB97FHKC16607677923892,11/26/2015,13241.09,100002,N,Credited,MI,PC,Cr,18:40:09,21:20:51,6/13/2018,81775156,1625.76,6,"Tend worry rate idea religious station. Worry it heart maintain standard.
Bank figure surface product keep behavior me black. Up drive lot all. Interest pretty measure call home.",20:16:57,CHEQUE
CXFY99245025482787,GB97FHKC16607677923892,11/26/2015,14600.56,100002,N,Credited,OPERA,POS,Cr,12:54:21,15:31:22,6/16/2018,31301381,1359.47,7,"May appear most wear specific real gun. Mr smile toward suggest.
Save health between rich. Same mother between no race call.",14:33:46,DD
CXFY99245025482787,GB97FHKC16607677923892,11/26/2015,15960.03,100002,N,Credited,FF,PC,Cr,15:58:26,22:51:53,6/16/2018,46158826,1359.47,3,"View protect front put budget maybe can. Middle put whom civil. Now continue represent long remain.
Read career radio wear town. Not phone soon. Hair say population their.",18:55:35,RTGS
CXFY99245025482787,GB97FHKC16607677923892,11/26/2015,15256.36,100002,Y,Transportation,CHROME,MOBILE,Dr,4:44:35,8:30:03,6/23/2018,97215868,703.67,5,Win might leader take without possible voice others. Individual car office interesting figure. Baby stage available ever blue.,7:07:01,CARDS
CXFY99245025482787,GB97FHKC16607677923892,11/26/2015,15960.03,100002,N,Credited,OPERA,PC,Cr,11:01:35,13:48:34,6/23/2018,20642556,703.67,2,Full past about as then message manager. Where small city factor. Left cell machine family end cold everybody. She administration nearly answer.,12:32:53,IMPS
CXFY99245025482787,GB97FHKC16607677923892,11/26/2015,16663.7,100002,N,Credited,MI,POS,Cr,15:25:36,17:54:13,6/23/2018,20478223,703.67,2,"Eye ball economic. Military reality couple generation. We former benefit health goal many minute yard.
Measure hot personal glass do executive finally hit. Civil skin whom hundred.",16:47:22,IMPS
CXFY99245025482787,GB97FHKC16607677923892,11/26/2015,17367.37,100002,N,Credited,FF,POS,Cr,18:40:01,21:38:24,6/23/2018,3689608,703.67,6,"Current check since how.
Keep hair growth process.
Cup market notice on government actually. Rich catch election half color. Live trade in operation. Area realize health bill Congress.",19:55:36,CHEQUE
CXFY99245025482787,GB97FHKC16607677923892,11/26/2015,18880.25,100002,N,Credited,CHROME,POS,Cr,12:38:06,17:01:48,6/25/2018,13584153,1512.88,6,Those cold record television pull dog price. Know store address thousand. Cut behind fly agree less least. Cell floor improve why despite.,15:19:24,CHEQUE
CXFY99245025482787,GB97FHKC16607677923892,11/26/2015,17367.37,100002,Y,Entertainment,SAFARI,POS,Dr,21:06:50,26:27:23,6/25/2018,67325870,1512.88,6,"Sit factor others run large choice. Evidence believe open because international including top daughter.
Open face than take accept. Close radio note send face serve name.",23:02:27,CHEQUE
CXFY99245025482787,GB97FHKC16607677923892,11/26/2015,18666.59,100002,N,Credited,EDGE,MOBILE,Cr,9:01:45,12:05:48,6/29/2018,74673360,1299.22,6,"These build card often. Foreign score accept choose campaign bill.
Special relate on financial.
Media other they consumer radio car. International turn beautiful month court friend until.",10:33:44,CHEQUE
CXFY99245025482787,GB97FHKC16607677923892,11/26/2015,17367.37,100002,Y,Insurance,OPERA,POS,Dr,15:37:08,18:47:04,6/29/2018,53011565,1299.22,7,"Million collection case arm. Else success less behind. Lead up small.
One experience after company. Interesting leg center give event state understand. Talk anything seem always response.",17:13:29,DD
CXFY99245025482787,GB97FHKC16607677923892,11/26/2015,18666.59,100002,N,Credited,OPERA,PC,Cr,16:54:36,20:32:10,6/29/2018,87497892,1299.22,6,Source article may teach. Benefit ok home. Trouble listen billion information wall.,19:32:10,CHEQUE
CXFY99245025482787,GB97FHKC16607677923892,11/26/2015,17216.66,100002,Y,Transportation,MI,PC,Dr,4:52:50,7:48:50,7/1/2018,60883339,1449.93,4,Authority cultural be college. Power him tough himself worry trip. Standard well garden them sister itself decade.,7:07:12,UPI
CXFY99245025482787,GB97FHKC16607677923892,11/26/2015,15766.73,100002,Y,Groceries,OPERA,POS,Dr,7:29:22,11:04:35,7/1/2018,51386047,1449.93,7,"Like green I owner.
Door accept main meet name seem. Reach argue teacher affect message Mrs leg.",9:38:28,DD
CXFY99245025482787,GB97FHKC16607677923892,11/26/2015,14316.8,100002,Y,Rent,FF,PC,Dr,15:02:40,18:31:22,7/1/2018,69406188,1449.93,7,Wrong no seven when partner subject under. Ready home its pick. Kid today billion bank high.,17:11:39,DD
CXFY99245025482787,GB97FHKC16607677923892,11/26/2015,15766.73,100002,N,Credited,IE,PC,Cr,22:46:50,24:30:51,7/1/2018,3448403,1449.93,7,"Range strong eight join. Relate beat artist.
Level someone yes religious. Side lawyer memory knowledge health cultural summer reveal. Community wish adult door.",23:16:13,DD
CXFY99245025482787,GB97FHKC16607677923892,11/26/2015,16891.57,100002,N,Credited,FF,PC,Cr,7:06:36,12:11:47,7/4/2018,20339913,1124.84,1,"Education design husband agreement popular. Activity assume wife administration right red hundred.
Vote attorney stage option wait interview more. Fact edge now.",10:14:00,NEFT
CXFY99245025482787,GB97FHKC16607677923892,11/26/2015,18016.41,100002,N,Credited,FF,MOBILE,Cr,17:53:55,22:16:44,7/4/2018,81941995,1124.84,7,"Garden society clearly such indeed.
Water across hair part especially media. My agency general catch tend but.
Team listen white our. Suddenly you represent television. Back south sign thus.",20:08:35,DD
CXFY99245025482787,GB97FHKC16607677923892,11/26/2015,18390.66,100002,N,Credited,SAFARI,PC,Cr,5:58:21,9:09:48,7/5/2018,21823220,374.25,6,"General goal analysis image society hard weight. Indicate run of cost. Hope husband away.
Toward chance world indicate. Class force soldier executive type work.",7:18:45,CHEQUE
CXFY99245025482787,GB97FHKC16607677923892,11/26/2015,18764.91,100002,N,Credited,CHROME,MOBILE,Cr,7:23:24,10:22:24,7/5/2018,27240601,374.25,3,"Prepare more guy order reality. Sell evening animal business. Learn color memory risk force.
Main piece us history collection. System option night bill kind.",8:37:44,RTGS
CXFY99245025482787,GB97FHKC16607677923892,11/26/2015,19139.16,100002,N,Credited,FF,POS,Cr,13:41:00,16:10:57,7/5/2018,33406213,374.25,7,Car physical would medical. Responsibility more on race imagine particular. Put suffer expert article.,14:17:51,DD
CXFY99245025482787,GB97FHKC16607677923892,11/26/2015,19513.41,100002,N,Credited,FF,POS,Cr,15:59:58,19:29:18,7/5/2018,13632250,374.25,5,Customer training no second important professor be. Score race law run walk tend pass. Dark property by around head cup price.,17:32:53,CARDS
CXFY99245025482787,GB97FHKC16607677923892,11/26/2015,19139.16,100002,Y,Transportation,IE,PC,Dr,22:10:33,24:26:04,7/5/2018,72660058,374.25,6,"Example simply best purpose quickly list black. Follow since plan condition free base.
Technology money mission. Assume so write training near want.",23:17:54,CHEQUE
CXFY99245025482787,GB97FHKC16607677923892,11/26/2015,20487.32,100002,N,Credited,CHROME,MOBILE,Cr,12:06:24,17:03:29,7/28/2018,95229775,1348.16,7,"Bed without role season measure. Financial report design recognize wear agree attorney. Push mind single.
Find success both type. Road view news movie. Sense wind play continue story.",14:01:43,DD
CXFY99245025482787,GB97FHKC16607677923892,11/26/2015,19139.16,100002,Y,Medicals,SAFARI,PC,Dr,16:27:18,19:37:05,7/28/2018,22224996,1348.16,6,"Possible interesting customer window over lay civil. Movement above surface.
Fight put want ready boy television. Tv kid vote bar trip high million. Few as support affect.",17:15:23,CHEQUE
CXFY99245025482787,GB97FHKC16607677923892,11/26/2015,19404.28,100002,N,Credited,FF,POS,Cr,4:25:33,6:42:12,7/30/2018,92932784,265.12,7,"Watch sit lot son marriage. Training property appear fast west world leave.
Office after establish. Foot live fact explain. Never action senior hair evidence strong save medical.",6:13:24,DD
CXFY99245025482787,GB97FHKC16607677923892,11/26/2015,19139.16,100002,Y,Insurance,SAFARI,MOBILE,Dr,10:31:38,12:42:32,7/30/2018,81693856,265.12,6,Minute understand ground with attorney notice. Time huge daughter study I everyone movement. Still view theory organization center door.,11:05:09,CHEQUE
CXFY99245025482787,GB97FHKC16607677923892,11/26/2015,18874.04,100002,Y,Dining,CHROME,POS,Dr,10:47:37,13:13:02,7/30/2018,68972936,265.12,3,"Produce father doctor western about. Only west sign pull wide among.
East listen administration perhaps either feeling. Oil pull buy too watch choice. Development growth thus difficult nature.",12:28:12,RTGS
CXFY99245025482787,GB97FHKC16607677923892,11/26/2015,18608.92,100002,Y,Rent,SAFARI,POS,Dr,15:20:22,18:53:02,7/30/2018,34358696,265.12,2,"Interview whatever program our wind off tough. Run why control range suggest less certain.
Meeting your note concern. Black whose past a compare computer in. Thus unit hard parent decade.",17:08:03,IMPS
CXFY99245025482787,GB97FHKC16607677923892,11/26/2015,18874.04,100002,N,Credited,FF,PC,Cr,21:24:56,24:41:40,7/30/2018,27354537,265.12,7,Leader summer or same four particularly break window. Kid develop fear learn. Face number organization bring environmental message.,22:50:09,DD
CXFY99245025482787,GB97FHKC16607677923892,11/26/2015,18016.27,100002,Y,Entertainment,OPERA,MOBILE,Dr,9:16:24,12:27:22,8/7/2018,88665924,857.77,6,"Suddenly one surface fight next provide.
Class among food recent three animal. Teach third rate clearly or treatment member.
Force run wife event thus team. Effort reality there give ready.",10:14:11,CHEQUE
CXFY99245025482787,GB97FHKC16607677923892,11/26/2015,18874.04,100002,N,Credited,CHROME,POS,Cr,13:05:34,15:27:10,8/7/2018,59286448,857.77,1,"During music generation as stage up subject. Finish condition really. Third item which part mother wrong between.
Throughout recent science media can. Will firm your room son military day seem.",13:51:30,NEFT
CXFY99245025482787,GB97FHKC16607677923892,11/26/2015,19731.81,100002,N,Credited,CHROME,MOBILE,Cr,18:04:11,19:49:47,8/7/2018,61088221,857.77,7,"Spring onto might. Next share worry that stock.
Population side him exist piece do standard only. Prevent west away city.",19:10:53,DD
CXFY99245025482787,GB97FHKC16607677923892,11/26/2015,21471.94,100002,N,Credited,EDGE,PC,Cr,5:22:35,11:09:47,8/9/2018,21625473,1740.13,3,"From step face child site morning. Range state other.
Performance gun north the rate. Scientist serious everything parent fill. Talk fall though fine everything most.",8:55:59,RTGS
CXFY99245025482787,GB97FHKC16607677923892,11/26/2015,23212.07,100002,N,Credited,SAFARI,PC,Cr,18:44:34,25:24:56,8/9/2018,22077325,1740.13,5,Or space care over community for. Family surface right billion.,22:25:47,CARDS
CXFY99245025482787,GB97FHKC16607677923892,11/26/2015,22654,100002,Y,Household Consumables,FF,PC,Dr,6:05:36,9:55:42,8/16/2018,19990965,558.07,2,Research land table. Size child same difference plan join suffer. Floor probably note piece resource service home.,9:05:16,IMPS
CXFY99245025482787,GB97FHKC16607677923892,11/26/2015,22095.93,100002,Y,Entertainment,SAFARI,PC,Dr,10:22:05,15:53:16,8/16/2018,83668005,558.07,6,"Smile will middle tend meet appear own appear. Pattern tree professional sport at.
Establish stage center leave after. Store child course behind.",13:01:50,CHEQUE
CXFY99245025482787,GB97FHKC16607677923892,11/26/2015,21537.86,100002,Y,Personal Care,CHROME,PC,Dr,17:42:11,22:06:27,8/16/2018,35206811,558.07,5,Wait apply relate real imagine television maintain. Less whom very six to.,19:11:27,CARDS
CXFY99245025482787,GB97FHKC16607677923892,11/26/2015,23376.26,100002,N,Credited,EDGE,MOBILE,Cr,6:31:31,12:41:24,8/23/2018,20600686,1838.4,2,"Take military raise thank north area. Story medical word fund perform exist box. Develop she begin but free military.
Same build true type course into we. Film care room result company test.",10:28:33,IMPS
CXFY99245025482787,GB97FHKC16607677923892,11/26/2015,25214.66,100002,N,Credited,MI,PC,Cr,15:39:07,19:07:58,8/23/2018,93810661,1838.4,6,"Father everything situation artist. Coach across perform standard after seek piece find.
Door quickly near field. American successful understand guy. Over particular little morning although.",18:07:32,CHEQUE
CXFY99245025482787,GB97FHKC16607677923892,11/26/2015,23328.26,100002,Y,Medicals,IE,MOBILE,Dr,2:55:05,6:01:08,8/28/2018,30799974,1886.4,4,"Usually simple big explain. Hand thing describe father. Law year government dinner.
As we of health. Perhaps fact reflect itself arrive campaign.
Friend training maybe it.",4:24:31,UPI
CXFY99245025482787,GB97FHKC16607677923892,11/26/2015,25214.66,100002,N,Credited,SAFARI,MOBILE,Cr,10:00:35,11:44:44,8/28/2018,2733968,1886.4,4,"Ball until paper. Pattern high those newspaper mention account garden. Each around cost war.
Hope life art enough road both. When others experience thing will bit cost.",10:29:54,UPI
CXFY99245025482787,GB97FHKC16607677923892,11/26/2015,23328.26,100002,Y,Personal Care,MI,POS,Dr,12:57:57,15:11:41,8/28/2018,96942956,1886.4,6,"Street partner ready minute. Look discuss kid should those candidate.
Structure and per. Opportunity evening usually home board gun. Skill authority woman require he side moment.",13:34:20,CHEQUE
CXFY99245025482787,GB97FHKC16607677923892,11/26/2015,25214.66,100002,N,Credited,IE,PC,Cr,16:45:50,18:15:03,8/28/2018,34742204,1886.4,7,"Hear guy energy southern quality write stuff then. International up allow show meet risk.
Town instead five miss. Pattern policy family since blue.",17:11:57,DD
CXFY99245025482787,GB97FHKC16607677923892,11/26/2015,23328.26,100002,Y,Transportation,IE,MOBILE,Dr,21:17:24,23:50:12,8/28/2018,1959451,1886.4,4,Knowledge son arrive standard note improve. Attack fire he drive. Heart down industry quality meet. Fact bill political visit hair card shoulder.,22:53:46,UPI
CXFY99245025482787,GB97FHKC16607677923892,11/26/2015,21939.08,100002,Y,Entertainment,MI,POS,Dr,9:16:47,12:23:19,8/31/2018,29419241,1389.18,1,Stock section glass four do record. Land point father computer watch question future they.,11:44:21,NEFT
CXFY99245025482787,GB97FHKC16607677923892,11/26/2015,23328.26,100002,N,Credited,IE,POS,Cr,14:56:44,18:07:20,8/31/2018,89709108,1389.18,6,"Into place suggest rule talk find. Just several threat practice price.
Same cell end politics hand. Civil government seven fast fine fight blood discussion.",16:38:36,CHEQUE
CXFY99245025482787,GB97FHKC16607677923892,11/26/2015,21939.08,100002,Y,Groceries,OPERA,PC,Dr,20:37:10,24:55:01,8/31/2018,50690916,1389.18,4,Maybe economy challenge site artist exist. Understand public media scene many five. Thousand standard media scientist effect ten grow.,22:22:37,UPI
CXFY99245025482787,GB97FHKC16607677923892,11/26/2015,22682.9,100002,N,Credited,SAFARI,PC,Cr,16:47:39,22:25:18,9/6/2018,75342364,743.82,7,"Thing return with never. East wide yes both serious agree.
Size design individual image.
Remember put religious mean add sing short. There five care then big modern. Short share outside bag.",19:51:13,DD
CXFY99245025482787,GB97FHKC16607677923892,11/26/2015,22984.14,100002,N,Credited,MI,MOBILE,Cr,22:06:36,25:52:31,9/13/2018,23763142,301.24,6,"Contain series century happy toward dinner enjoy. Suggest example fact eight. Base job best mouth same.
Win tough new send democratic wait southern. Focus behind church wear.",23:52:26,CHEQUE
CXFY99245025482787,GB97FHKC16607677923892,11/26/2015,22048.69,100002,Y,Medicals,SAFARI,POS,Dr,7:45:24,12:06:52,9/14/2018,11204022,935.45,3,"News truth four same avoid. Coach writer support. Husband around free property think.
Economic present medical well watch institution practice. Manager artist great crime.",9:56:43,RTGS
CXFY99245025482787,GB97FHKC16607677923892,11/26/2015,22984.14,100002,N,Credited,FF,MOBILE,Cr,14:24:13,19:10:26,9/14/2018,3532607,935.45,5,Five reduce tell work hold. Director chance reflect beyond anything read issue. Whether live charge few threat change.,18:02:52,CARDS
CXFY99245025482787,GB97FHKC16607677923892,11/26/2015,24219.67,100002,N,Credited,FF,PC,Cr,6:55:10,11:06:21,9/15/2018,69092282,1235.53,3,"Move write daughter card toward attorney. Member second six history. Never culture among response cut such.
Service actually heart someone hold arrive. Strong use blue local tough environmental.",8:36:45,RTGS
CXFY99245025482787,GB97FHKC16607677923892,11/26/2015,22984.14,100002,Y,Personal Care,EDGE,MOBILE,Dr,14:22:08,18:04:56,9/15/2018,35806820,1235.53,2,Data these may once property suffer experience. Candidate goal anything create ago. Trade movie record truth certainly seat. Matter employee possible together many establish traditional.,16:46:05,IMPS
CXFY99245025482787,GB97FHKC16607677923892,11/26/2015,23036.82,100002,N,Credited,SAFARI,MOBILE,Cr,12:25:35,18:39:58,9/16/2018,17544139,52.68,2,"Wife forget yard bag along language happen building. Work admit mind however.
Work step ability standard trouble. Heavy certainly board light. Art rest drop color western his always industry.",14:50:59,IMPS
CXFY99245025482787,GB97FHKC16607677923892,11/26/2015,23089.5,100002,N,Credited,MI,PC,Cr,19:08:26,23:07:49,9/16/2018,59059868,52.68,7,"Risk field big determine example drive. Art rather though book whether.
Either stage different job prevent. Group push anyone study effort.",20:39:27,DD
CXFY99245025482787,GB97FHKC16607677923892,11/26/2015,22222.41,100002,Y,Medicals,SAFARI,MOBILE,Dr,8:26:14,11:22:37,9/17/2018,82484422,867.09,5,"Run sing I mouth set.
Run plant maintain difficult piece. Paper perhaps their receive although wrong threat little. Politics plan future especially actually camera.",10:45:36,CARDS
CXFY99245025482787,GB97FHKC16607677923892,11/26/2015,21355.32,100002,Y,Insurance,EDGE,PC,Dr,14:13:23,17:34:47,9/17/2018,19247908,867.09,6,"Rest arrive have sit city especially. With north from spend letter. Your sometimes six people.
Reason indicate knowledge my huge strategy. Wall choice list.",15:58:30,CHEQUE
CXFY99245025482787,GB97FHKC16607677923892,11/26/2015,20488.23,100002,Y,Transportation,FF,MOBILE,Dr,17:08:10,20:04:42,9/17/2018,84559104,867.09,2,Science ever believe hear book administration. What color outside animal subject. Environmental forget throughout if lay return start.,18:18:50,IMPS
CXFY99245025482787,GB97FHKC16607677923892,11/26/2015,21662.65,100002,N,Credited,MI,MOBILE,Cr,12:34:23,16:11:15,9/26/2018,72189689,1174.42,5,Summer understand garden fund. Lawyer every learn meet skin difficult.,14:26:45,CARDS
CXFY99245025482787,GB97FHKC16607677923892,11/26/2015,20488.23,100002,Y,Groceries,OPERA,MOBILE,Dr,14:39:59,17:21:09,9/26/2018,61128750,1174.42,5,"Himself tell herself behavior miss.
Seem bar perform avoid what turn if. Shoulder suffer management would environment result player.",16:21:22,CARDS
CXFY99245025482787,GB97FHKC16607677923892,11/26/2015,18850.85,100002,Y,Rent,SAFARI,POS,Dr,9:20:38,12:35:17,10/7/2018,36321896,1637.38,1,Financial beautiful stage possible. Person hair hour again live early. Painting seem education mission school according popular.,11:53:13,NEFT
CXFY99245025482787,GB97FHKC16607677923892,11/26/2015,17213.47,100002,Y,Groceries,MI,POS,Dr,11:14:36,16:43:31,10/7/2018,16506893,1637.38,2,Score bar theory probably traditional wall hard into. Democratic set down within. Day sit eight challenge.,14:00:40,IMPS
CXFY99245025482787,GB97FHKC16607677923892,11/26/2015,15576.09,100002,Y,Insurance,CHROME,PC,Dr,20:27:48,24:26:33,10/7/2018,81654574,1637.38,5,"Reduce six health medical. Offer high four vote husband fight end.
Woman newspaper old table game indicate west author. Source fast bill wide sport. Consumer as over now. Cover always what.",22:15:29,CARDS
CXFY99245025482787,GB97FHKC16607677923892,11/26/2015,17492.63,100002,N,Credited,IE,POS,Cr,5:31:58,10:05:24,10/12/2018,9561625,1916.54,4,National economic week happen large senior player. Star near beat we perhaps more board. Call may them bad remember.,7:45:01,UPI
CXFY99245025482787,GB97FHKC16607677923892,11/26/2015,15576.09,100002,Y,Personal Care,FF,MOBILE,Dr,11:02:58,13:10:55,10/12/2018,81346837,1916.54,5,Piece have live record school eye. Share author concern international.,12:19:36,CARDS
CXFY99245025482787,GB97FHKC16607677923892,11/26/2015,13659.55,100002,Y,Dining,MI,PC,Dr,13:28:15,16:34:55,10/12/2018,24677905,1916.54,2,"That professor stuff truth magazine dinner. Worry dream add floor. Commercial politics he should sound.
Pm serve address Congress. Drug enough baby trial especially no.",15:24:04,IMPS
CXFY99245025482787,GB97FHKC16607677923892,11/26/2015,15576.09,100002,N,Credited,MI,MOBILE,Cr,22:34:39,25:16:36,10/12/2018,15940636,1916.54,2,"Write likely he cover someone. Central later executive fire six away whatever. Story step our while answer so.
Compare very prepare staff while front arrive.",23:27:41,IMPS
CXFY99245025482787,GB97FHKC16607677923892,11/26/2015,16583.65,100002,N,Credited,FF,POS,Cr,5:57:04,9:14:17,10/14/2018,72813874,1007.56,4,"Sign future movement certain manager remember. Ever capital prevent according series item. Opportunity look last him as.
With quickly book early itself read. Food quickly air matter bit say next.",8:03:48,UPI
CXFY99245025482787,GB97FHKC16607677923892,11/26/2015,17591.21,100002,N,Credited,EDGE,PC,Cr,9:44:39,11:42:22,10/14/2018,41118504,1007.56,5,"Begin somebody eat race human later. Three impact mention skin on. Manage throughout no book option amount.
Couple nothing enjoy once international worker open. Necessary need society ability.",10:32:14,CARDS
CXFY99245025482787,GB97FHKC16607677923892,11/26/2015,18598.77,100002,N,Credited,FF,POS,Cr,13:59:16,15:51:01,10/14/2018,58731833,1007.56,1,"Environmental which significant true.
Here side energy painting. Candidate fill table tend beat organization yourself. Read fund decide available establish may own.",15:06:41,NEFT
CXFY99245025482787,GB97FHKC16607677923892,11/26/2015,19606.33,100002,N,Credited,SAFARI,POS,Cr,20:50:54,23:31:31,10/14/2018,30005532,1007.56,2,"Low challenge author yourself find. Bill change down some PM.
Particularly medical eat pay history car goal.",22:46:29,IMPS
CXFY99245025482787,GB97FHKC16607677923892,11/26/2015,20563.47,100002,N,Credited,IE,POS,Cr,3:01:29,6:47:00,10/17/2018,68625092,957.14,6,"Change set as. Data condition traditional provide positive most.
Better same charge detail money sister away. Coach pressure cover our. Share campaign system on city start film suddenly.",4:51:48,CHEQUE
CXFY99245025482787,GB97FHKC16607677923892,11/26/2015,19606.33,100002,Y,Entertainment,FF,MOBILE,Dr,9:22:23,13:14:05,10/17/2018,23260788,957.14,1,"Investment know every purpose. Opportunity two usually after health. Different lot nothing close.
Take along evidence listen your woman reveal. Beautiful field guess reduce listen heart pressure.",11:20:50,NEFT
CXFY99245025482787,GB97FHKC16607677923892,11/26/2015,20563.47,100002,N,Credited,SAFARI,MOBILE,Cr,16:10:26,18:52:05,10/17/2018,99939328,957.14,3,Pull out economic anything social recent. Financial but begin film yet. Suggest popular seem family expert pay yet. Event store follow plant mouth.,17:57:59,RTGS
CXFY99245025482787,GB97FHKC16607677923892,11/26/2015,21520.61,100002,N,Credited,MI,MOBILE,Cr,19:29:35,21:52:06,10/17/2018,25097542,957.14,2,"Poor check factor painting family. Rich artist baby sport. Cause upon dinner.
Behind guess strong sport.
Edge type begin simple. Lay near career wall summer moment likely.",21:16:33,IMPS
CXFY99245025482787,GB97FHKC16607677923892,11/26/2015,22540.77,100002,N,Credited,OPERA,POS,Cr,2:45:47,4:55:51,10/23/2018,55568647,1020.16,5,Might game class week eye answer. Catch figure tend car. Investment future direction board themselves walk activity. Cup red each let country hundred.,4:11:23,CARDS
CXFY99245025482787,GB97FHKC16607677923892,11/26/2015,23560.93,100002,N,Credited,SAFARI,MOBILE,Cr,7:23:18,10:06:49,10/23/2018,10333327,1020.16,1,"Reflect trip individual few especially stand nearly.
Hope near view pretty physical appear manage. Yard cultural former room then civil test. Value system cut glass example able full.",8:35:17,NEFT
CXFY99245025482787,GB97FHKC16607677923892,11/26/2015,22540.77,100002,Y,Household Consumables,IE,PC,Dr,14:29:44,16:25:58,10/23/2018,95041087,1020.16,7,Total within discuss way seven cup. Mission avoid sister quickly. Lay act bit mind radio change. Current study edge finish carry today.,15:13:36,DD
CXFY99245025482787,GB97FHKC16607677923892,11/26/2015,21520.61,100002,Y,Medicals,SAFARI,PC,Dr,16:48:40,19:46:52,10/23/2018,74774739,1020.16,1,"Perform easy there her dog class. Red section pass rich about event.
Property play trade run risk. Town change know majority.",18:27:41,NEFT
CXFY99245025482787,GB97FHKC16607677923892,11/26/2015,20500.45,100002,Y,Online Shopping,CHROME,PC,Dr,18:40:55,21:38:58,10/23/2018,71023052,1020.16,1,Stage soldier begin step school feel camera tough. Add skin ability finally others small service. Born together force move can every point. Threat head image identify.,20:31:29,NEFT
CXFY99245025482787,GB97FHKC16607677923892,11/26/2015,19711,100002,Y,Utilities,MI,MOBILE,Dr,11:00:36,15:25:10,10/24/2018,34760413,789.45,7,Television strategy detail tell generation church decade. White lose ever loss range list.,12:09:42,DD
CXFY99245025482787,GB97FHKC16607677923892,11/26/2015,18921.55,100002,Y,Utilities,SAFARI,MOBILE,Dr,21:48:21,26:35:41,10/24/2018,36746705,789.45,6,Society art summer. Month glass executive new responsibility senior executive.,22:46:00,CHEQUE
CXFY99245025482787,GB97FHKC16607677923892,11/26/2015,19683.3,100002,N,Credited,OPERA,POS,Cr,4:19:06,6:37:15,10/26/2018,78936058,761.75,5,Miss stay citizen. Why society standard remember toward business yet attorney.,5:50:46,CARDS
CXFY99245025482787,GB97FHKC16607677923892,11/26/2015,18921.55,100002,Y,Entertainment,IE,POS,Dr,8:24:09,11:33:06,10/26/2018,41150399,761.75,4,"Alone front result rest. Ok that base.
Five red leader from road. Help need raise turn human. Method go current school keep late.",9:55:52,UPI
CXFY99245025482787,GB97FHKC16607677923892,11/26/2015,18159.8,100002,Y,Rent,CHROME,PC,Dr,13:16:30,16:44:25,10/26/2018,90164392,761.75,6,Training clear series tend enter apply record foot. Subject decision support offer Republican ground institution trade. Create white during along similar parent reduce.,14:50:37,CHEQUE
CXFY99245025482787,GB97FHKC16607677923892,11/26/2015,18921.55,100002,N,Credited,CHROME,POS,Cr,16:38:26,19:55:08,10/26/2018,80293798,761.75,5,He develop despite four oil agreement control or. Relate bag interesting design. Customer account American region back single size.,18:11:37,CARDS
CXFY99245025482787,GB97FHKC16607677923892,11/26/2015,18159.8,100002,Y,Online Shopping,IE,POS,Dr,18:29:50,21:31:50,10/26/2018,91193988,761.75,7,"Tv general size because report writer foot. Total culture voice.
Probably end point easy develop hit.
Thus pay medical. Data school two beautiful. Majority international understand general.",20:23:53,DD
CXFY99245025482787,GB97FHKC16607677923892,11/26/2015,18773.2,100002,N,Credited,FF,PC,Cr,6:11:37,10:06:21,10/30/2018,3593561,613.4,4,Factor attack lawyer effort. Color produce central. Role term break executive something chair.,7:58:20,UPI
CXFY99245025482787,GB97FHKC16607677923892,11/26/2015,18159.8,100002,Y,Dining,MI,POS,Dr,11:35:19,13:50:42,10/30/2018,63687033,613.4,4,"Recognize practice represent send usually born per. Happy station nation five test.
Key field yes view join. Start popular tonight firm direction practice painting. Magazine coach word by.",12:32:17,UPI
CXFY99245025482787,GB97FHKC16607677923892,11/26/2015,17546.4,100002,Y,Rent,SAFARI,POS,Dr,20:18:52,24:33:01,10/30/2018,79288385,613.4,5,Bag guess case order recent moment. Dog prove let process finally structure wall. Air similar rest share other. Focus who peace security range.,22:45:30,CARDS
CXFY99245025482787,GB97FHKC16607677923892,11/26/2015,18669.31,100002,N,Credited,SAFARI,POS,Cr,6:50:31,9:29:03,11/5/2018,38287121,1122.91,2,Letter resource under she. Because door dark from. Order authority per see itself knowledge Mr.,8:19:47,IMPS
CXFY99245025482787,GB97FHKC16607677923892,11/26/2015,17546.4,100002,Y,Personal Care,CHROME,PC,Dr,11:41:25,14:55:39,11/5/2018,38387890,1122.91,1,"Could such recognize away learn laugh.
Manager better nation. Use speech firm everyone data control cup phone.",12:37:53,NEFT
CXFY99245025482787,GB97FHKC16607677923892,11/26/2015,18669.31,100002,N,Credited,FF,POS,Cr,13:50:28,18:05:09,11/5/2018,34643235,1122.91,4,"Election school affect federal. Clear image send improve daughter and.
Against successful billion lose much week for. Example parent general member fly special child.",15:42:39,UPI
CXFY99245025482787,GB97FHKC16607677923892,11/26/2015,17546.4,100002,Y,Dining,FF,POS,Dr,20:07:06,23:33:15,11/5/2018,12094202,1122.91,3,"Provide me garden ten. Local size for baby human.
Up military hour outside far third. Raise matter strong feel buy shoulder. Professional purpose space prepare protect inside.",21:28:45,RTGS
CXFY99245025482787,GB97FHKC16607677923892,11/26/2015,18841.11,100002,N,Credited,OPERA,PC,Cr,13:36:16,18:21:44,11/9/2018,64766515,1294.71,2,Hold walk raise. Piece its big figure tax. Simply case rich evidence product enter age.,15:16:29,IMPS
CXFY99245025482787,GB97FHKC16607677923892,11/26/2015,17546.4,100002,Y,Utilities,OPERA,POS,Dr,14:32:55,20:08:31,11/9/2018,73128304,1294.71,6,"Station wide support career generation lead save. Newspaper allow she sell program east.
Material tough change believe too network speech. Good space rise most thank fund father.",16:10:00,CHEQUE
CXFY99245025482787,GB97FHKC16607677923892,11/26/2015,18285.74,100002,N,Credited,CHROME,POS,Cr,3:25:00,6:29:00,11/15/2018,96577776,739.34,4,"Western point near company hard. Force join power dream southern check trip face.
Cultural he operation. Else sea customer. Each rule positive contain value attack production grow.",4:41:23,UPI
CXFY99245025482787,GB97FHKC16607677923892,11/26/2015,19025.08,100002,N,Credited,IE,POS,Cr,8:34:25,12:01:00,11/15/2018,42676331,739.34,4,"Fish data large lot. Floor couple begin happy chance give adult. More tonight experience in safe.
Record decision wide check provide black. He he during physical network. Church in no long indicate.",10:26:17,UPI
CXFY99245025482787,GB97FHKC16607677923892,11/26/2015,19764.42,100002,N,Credited,EDGE,MOBILE,Cr,11:27:51,13:46:36,11/15/2018,60039071,739.34,3,"Own while support. Star item group owner set heavy it.
Fact until home service role. Fill player court assume huge show summer song.",13:20:36,RTGS
CXFY99245025482787,GB97FHKC16607677923892,11/26/2015,19025.08,100002,Y,Online Shopping,OPERA,PC,Dr,17:08:36,19:18:05,11/15/2018,23705258,739.34,7,"Believe lose point. Art fear audience technology nearly two. Near though organization. Find TV eye whose last capital.
Hold blood dinner involve. Include song decision none wide.",18:38:11,DD
CXFY99245025482787,GB97FHKC16607677923892,11/26/2015,19764.42,100002,N,Credited,OPERA,POS,Cr,22:45:59,24:38:29,11/15/2018,16781177,739.34,7,"Home again white more. Choice their stuff. General half admit deep.
Certain energy adult exactly effort popular us. Decision may heavy when customer sound.",23:53:31,DD
CXFY99245025482787,GB97FHKC16607677923892,11/26/2015,21415.89,100002,N,Credited,EDGE,MOBILE,Cr,6:26:23,9:19:49,11/18/2018,68524302,1651.47,3,Organization other whose call staff. Computer medical bad down oil son half. Into probably drug process.,7:06:02,RTGS
CXFY99245025482787,GB97FHKC16607677923892,11/26/2015,19764.42,100002,Y,Insurance,SAFARI,POS,Dr,11:58:07,14:05:03,11/18/2018,40416250,1651.47,1,"Understand recent want lawyer cost science term. Return call law thing whose scientist.
Shake against dinner onto. Because beat commercial seek moment. Suddenly want order outside way research.",12:55:43,NEFT
CXFY99245025482787,GB97FHKC16607677923892,11/26/2015,18112.95,100002,Y,Transportation,MI,PC,Dr,16:10:14,19:46:27,11/18/2018,87260175,1651.47,1,Or speech week tax us keep sell foot. Best natural their here officer state run. Trial value ahead magazine area. Ok staff language single ready commercial.,18:09:30,NEFT
CXFY99245025482787,GB97FHKC16607677923892,11/26/2015,16461.48,100002,Y,Dining,CHROME,MOBILE,Dr,19:23:58,22:17:39,11/18/2018,21700460,1651.47,4,"Once fall possible happy war finally house. Too garden choice source. Rest player clearly production.
Own office sign. Marriage field actually produce such whole owner.",20:36:24,UPI
CXFY99245025482787,GB97FHKC16607677923892,11/26/2015,14555.48,100002,Y,Household Consumables,IE,POS,Dr,4:15:22,6:33:10,11/23/2018,16972575,1906,4,"Follow least writer common mention bad big. Learn over air from name effort.
Top response once pay happy sort to population. Sea enjoy arm.
Various ready actually hair increase at bed plan.",6:02:24,UPI
CXFY99245025482787,GB97FHKC16607677923892,11/26/2015,12649.48,100002,Y,Groceries,SAFARI,POS,Dr,7:52:07,12:17:19,11/23/2018,10009666,1906,5,"East argue their use end daughter. News dark woman health certainly class front.
Agency down notice number direction hand hard. Project series low be. Guy back student film able ten interest kitchen.",9:53:46,CARDS
CXFY99245025482787,GB97FHKC16607677923892,11/26/2015,14555.48,100002,N,Credited,IE,POS,Cr,14:26:13,17:48:18,11/23/2018,56009446,1906,1,"See tree boy TV. Word leader sport meet budget.
Reason prepare discuss might treatment. Shake art down her black concern east investment.
Read inside like cut such building value. Sister family hot.",15:37:15,NEFT
CXFY99245025482787,GB97FHKC16607677923892,11/26/2015,12649.48,100002,Y,Household Consumables,SAFARI,POS,Dr,20:45:08,25:20:41,11/23/2018,10728192,1906,4,"Attention its ability them daughter. To event civil why. Myself nice glass.
Teacher stop ever statement. Address various them structure bag. Talk listen later worker chance week.",23:03:20,UPI
CXFY99245025482787,GB97FHKC16607677923892,11/26/2015,14444.06,100002,N,Credited,MI,PC,Cr,6:28:57,11:16:24,12/6/2018,14156892,1794.58,2,Federal price try democratic likely. Whole develop actually forward computer can player cup.,8:34:33,IMPS
CXFY99245025482787,GB97FHKC16607677923892,11/26/2015,12649.48,100002,Y,Personal Care,MI,MOBILE,Dr,18:51:18,21:58:41,12/6/2018,95079479,1794.58,4,"White audience recent. Task life operation human. When us bar investment.
Less glass feeling change make fall film. State fine mean well add national voice. Arm many finish.",20:57:28,UPI
CXFY99245025482787,GB97FHKC16607677923892,11/26/2015,12181.94,100002,Y,Household Consumables,CHROME,POS,Dr,6:11:50,9:54:02,12/10/2018,2280677,467.54,6,"Table example fire model because market.
Page almost beat. Stand source idea. Western meet cell.
Ask war good ability.",8:30:29,CHEQUE
CXFY99245025482787,GB97FHKC16607677923892,11/26/2015,12649.48,100002,N,Credited,CHROME,PC,Cr,9:12:30,12:29:02,12/10/2018,17224635,467.54,5,Sea attack for idea state party tough whole. Toward road idea those.,11:02:57,CARDS
CXFY99245025482787,GB97FHKC16607677923892,11/26/2015,12181.94,100002,Y,Transportation,CHROME,MOBILE,Dr,16:47:49,19:19:35,12/10/2018,13234812,467.54,3,Suggest lay discussion exist chair able. Watch huge record class not charge culture film. Treatment term he concern name.,17:28:54,RTGS
CXFY99245025482787,GB97FHKC16607677923892,11/26/2015,11714.4,100002,Y,Groceries,OPERA,PC,Dr,19:08:06,23:18:57,12/10/2018,81037315,467.54,2,"But cultural result less so hold good. Mind never find be least not community.
Probably practice business. Those well technology yes change.",21:04:13,IMPS
CXFY99245025482787,GB97FHKC16607677923892,11/26/2015,12669.41,100002,N,Credited,FF,MOBILE,Cr,4:46:09,7:02:11,12/26/2018,74537464,955.01,7,Him accept party effort impact Democrat product. Behind them until effect way. Those church ok base.,6:17:49,DD
CXFY99245025482787,GB97FHKC16607677923892,11/26/2015,13624.42,100002,N,Credited,FF,PC,Cr,8:42:12,10:50:52,12/26/2018,22373557,955.01,5,"Study claim central wrong. Work stand American course suggest seem network success.
Listen sort determine no past option pretty road. Let arrive same.",9:36:41,CARDS
CXFY99245025482787,GB97FHKC16607677923892,11/26/2015,12669.41,100002,Y,Rent,IE,POS,Dr,12:04:52,13:59:45,12/26/2018,42406501,955.01,4,"Old long and. Move firm lawyer.
Fast ability clear stage half. Just pull seem court building.
Quite key mention.",13:00:00,UPI
CXFY99245025482787,GB97FHKC16607677923892,11/26/2015,11714.4,100002,Y,Rent,MI,MOBILE,Dr,16:52:30,19:08:02,12/26/2018,74129560,955.01,4,"Foreign resource store respond. Member give girl until weight same against. Professor up behind question feel.
Player sure Democrat point. End eat candidate billion.",17:39:12,UPI
CXFY99245025482787,GB97FHKC16607677923892,11/26/2015,12669.41,100002,N,Credited,MI,MOBILE,Cr,19:32:20,21:34:26,12/26/2018,26702117,955.01,3,"Key reflect little former. Detail reveal together notice reduce team garden successful.
Personal stay away doctor avoid year number. Personal trip enter commercial.",20:33:11,RTGS
CXFY99245025482787,GB97FHKC16607677923892,11/26/2015,11572.97,100002,Y,Personal Care,CHROME,MOBILE,Dr,9:17:57,17:16:24,12/31/2018,15767226,1096.44,4,Factor of third play feeling eat. Age analysis less city south. Mission identify serious high. Those daughter factor soon people window per near.,13:58:44,UPI
CXFY99245025482787,GB97FHKC16607677923892,11/26/2015,13373.54,100002,N,Credited,OPERA,PC,Cr,4:55:46,7:59:53,1/5/2019,14410345,1800.57,1,Religious bag whatever new kitchen television. Pattern detail leave shoulder machine. Glass talk major without than. Stay never yet also commercial star over.,6:29:09,NEFT
CXFY99245025482787,GB97FHKC16607677923892,11/26/2015,11572.97,100002,Y,Online Shopping,IE,POS,Dr,13:34:36,18:16:19,1/5/2019,20159641,1800.57,2,"Spring phone cell audience but see read second. Consumer floor citizen represent responsibility.
Understand address dark for. Per least sing important. So president live rise gas toward wind.",15:42:15,IMPS
CXFY99245025482787,GB97FHKC16607677923892,11/26/2015,9772.4,100002,Y,Rent,OPERA,MOBILE,Dr,18:43:07,22:05:46,1/5/2019,64988887,1800.57,3,Within although property two subject. Third half specific add floor sound. Cut service wait. Sometimes table new report should late.,19:58:50,RTGS
CXFY99245025482787,GB97FHKC16607677923892,11/26/2015,11354.35,100002,N,Credited,MI,POS,Cr,6:54:48,12:14:49,2/2/2019,98993994,1581.95,6,"Investment stuff condition. Generation main third.
Population player today purpose far. Mission everybody accept century chair.",9:52:23,CHEQUE
CXFY99245025482787,GB97FHKC16607677923892,11/26/2015,9772.4,100002,Y,Personal Care,OPERA,POS,Dr,12:13:07,14:31:36,2/2/2019,67951017,1581.95,6,"Section staff minute. State federal raise major.
Sell improve reduce rise weight enough. Different maybe great choice research direction keep product. Somebody none call president.",13:08:15,CHEQUE
CXFY99245025482787,GB97FHKC16607677923892,11/26/2015,11354.35,100002,N,Credited,CHROME,POS,Cr,22:02:11,24:20:38,2/2/2019,91628664,1581.95,5,"This know view store.
Tonight say offer between ahead among. Someone area social listen quality marriage next. Skin born relate great character me situation.",23:42:20,CARDS
CXFY99245025482787,GB97FHKC16607677923892,11/26/2015,9725.53,100002,Y,Personal Care,EDGE,PC,Dr,6:26:21,10:15:22,2/6/2019,58216460,1628.82,2,"Art prepare give guy fall. Such pattern while trip position phone lead level.
We word whom feeling quite name contain agree. Power hot red political administration ten.",8:44:31,IMPS
CXFY99245025482787,GB97FHKC16607677923892,11/26/2015,8096.71,100002,Y,Household Consumables,IE,POS,Dr,10:20:03,15:20:32,2/6/2019,82343965,1628.82,3,"Bag low quickly good while democratic smile want. Pay which create. Perhaps model road pull cover.
Page across increase then. Stop for report since offer move home.",13:07:49,RTGS
CXFY99245025482787,GB97FHKC16607677923892,11/26/2015,6467.89,100002,Y,Entertainment,SAFARI,PC,Dr,16:30:40,20:12:26,2/6/2019,38061103,1628.82,4,"Capital manage pick lawyer make station then. No process blue health lay rate.
Know standard chance member future rule. Fast age notice rate yeah run hit.",18:33:05,UPI
CXFY99245025482787,GB97FHKC16607677923892,11/26/2015,6311.26,100002,Y,Insurance,IE,PC,Dr,3:33:47,6:07:58,2/26/2019,45012297,156.63,5,"Themselves his pay it different source information. Approach throughout head.
Pay tend feel subject. Edge hotel seem. Behind page admit.
Sort table rest about knowledge however. Some ever stop yeah.",5:37:45,CARDS
CXFY99245025482787,GB97FHKC16607677923892,11/26/2015,6154.63,100002,Y,Utilities,OPERA,MOBILE,Dr,11:41:02,14:39:56,2/26/2019,13204259,156.63,5,Fear kid sign. Whose yard debate. Prove particularly specific serious look teacher member perhaps.,13:44:50,CARDS
CXFY99245025482787,GB97FHKC16607677923892,11/26/2015,6311.26,100002,N,Credited,MI,MOBILE,Cr,15:02:09,18:29:09,2/26/2019,66898658,156.63,5,"Hard now make great. Lead question fund environment view. Appear cut left hard could.
Dream necessary student value town. Discover want baby nature network hair.",16:46:57,CARDS
CXFY99245025482787,GB97FHKC16607677923892,11/26/2015,6154.63,100002,Y,Rent,EDGE,POS,Dr,20:40:43,25:02:19,2/26/2019,27719435,156.63,5,"Crime tell house board store. Field third service sport world. None feel tough keep expect.
Require option toward over force us. Beautiful beyond area term. At movie option evening.",22:58:50,CARDS
CXFY99245025482787,GB97FHKC16607677923892,11/26/2015,5131.68,100002,Y,Online Shopping,EDGE,PC,Dr,6:48:40,10:25:56,3/3/2019,85716476,1022.95,1,"Must thank build call girl account plant. Cause money site cold edge majority magazine.
Officer guy always view. Hundred line learn rule result continue. Major should call road.",8:52:59,NEFT
CXFY99245025482787,GB97FHKC16607677923892,11/26/2015,4108.73,100002,Y,Dining,EDGE,POS,Dr,8:29:48,10:22:57,3/3/2019,19153346,1022.95,4,Read pull service structure friend care. Perform offer yard subject memory goal beyond. My class both wife benefit population fish material.,9:52:45,UPI
CXFY99245025482787,GB97FHKC16607677923892,11/26/2015,3085.78,100002,Y,Insurance,IE,MOBILE,Dr,15:52:28,20:35:16,3/3/2019,88846569,1022.95,3,Sure guess expect recognize fall. Treat mother charge common else sometimes major high. Far study book approach glass.,18:15:22,RTGS
CXFY99245025482787,GB97FHKC16607677923892,11/26/2015,4108.73,100002,N,Credited,FF,POS,Cr,17:38:26,21:31:46,3/3/2019,68192884,1022.95,6,"Strong national top teach. Sort rise image evidence agreement today memory American.
Usually positive enter hot guy seem particular. At design bar past organization argue either.",19:23:35,CHEQUE
CXFY99245025482787,GB97FHKC16607677923892,11/26/2015,3046.34,100002,Y,Medicals,FF,MOBILE,Dr,13:28:30,17:41:24,3/4/2019,55740159,1062.39,2,"Ago you morning either. Feel much matter camera. Nice Democrat practice positive quite movement consider.
Floor story allow guess everybody relate. Pass detail executive these various travel special.",15:20:43,IMPS
CXFY99245025482787,GB97FHKC16607677923892,11/26/2015,2005.03,100002,Y,Household Consumables,EDGE,POS,Dr,2:57:31,6:25:24,3/11/2019,7258169,1041.31,3,"Crime sea the her two now. Fast successful voice something week west create. Letter result make election issue thing.
Region option central support must sport easy.",4:54:10,RTGS
CXFY99245025482787,GB97FHKC16607677923892,11/26/2015,3046.34,100002,N,Credited,CHROME,POS,Cr,7:46:40,9:47:11,3/11/2019,77986115,1041.31,5,"Mission table firm rate few. Approach stage property walk who.
Yes write establish perform system option tend nation. Could several design study fire. Benefit though wrong write.",8:58:22,CARDS
CXFY99245025482787,GB97FHKC16607677923892,11/26/2015,4087.65,100002,N,Credited,MI,PC,Cr,10:57:02,14:04:06,3/11/2019,77590381,1041.31,7,"Happen large sense raise sign. Identify morning message feeling suggest. Already little over produce there also past.
First deal say hear blue part add. Among out simply consumer.",12:21:08,DD
CXFY99245025482787,GB97FHKC16607677923892,11/26/2015,5128.96,100002,N,Credited,EDGE,PC,Cr,17:02:24,18:44:20,3/11/2019,14124570,1041.31,2,"Somebody lot increase talk certain show. See future particular.
Leave site too oil point prepare. Mission without enter east. Throw their group.",18:00:33,IMPS
CXFY99245025482787,GB97FHKC16607677923892,11/26/2015,6170.27,100002,N,Credited,CHROME,POS,Cr,19:14:20,22:06:46,3/11/2019,53543332,1041.31,2,"One establish just establish. Animal century in significant simple. Blood a leave program edge sound late.
Anything serious make knowledge win bring market. Usually wind fine able modern when half.",20:19:04,IMPS
CXFY99245025482787,GB97FHKC16607677923892,11/26/2015,5996.39,100002,Y,Personal Care,FF,PC,Dr,5:16:59,8:04:00,3/18/2019,65481066,173.88,5,"Beat happy stage charge society.
Sister every every second company official. Each smile response.
Case most especially important term season. Religious story low big final once they level.",6:30:15,CARDS
CXFY99245025482787,GB97FHKC16607677923892,11/26/2015,5822.51,100002,Y,Rent,OPERA,PC,Dr,9:29:24,11:50:45,3/18/2019,24288392,173.88,2,"Money career road mention land. Other state country free citizen determine. Successful great meeting them speak.
Tell whatever left dinner politics. Reason group bit health tough.",10:20:44,IMPS
CXFY99245025482787,GB97FHKC16607677923892,11/26/2015,5648.63,100002,Y,Personal Care,FF,PC,Dr,16:15:30,18:21:36,3/18/2019,55579476,173.88,6,"Either idea card reason. Republican win together eye easy perhaps.
Answer candidate nature radio bad garden place. Think project perhaps do take writer ability.",17:22:12,CHEQUE
CXFY99245025482787,GB97FHKC16607677923892,11/26/2015,5474.75,100002,Y,Online Shopping,FF,PC,Dr,20:16:29,24:18:10,3/18/2019,13655549,173.88,3,"Popular individual seven draw woman. Person benefit in five where suggest answer. Crime myself figure study.
Concern catch probably. With work medical administration. Agreement by need.",22:34:08,RTGS
CXFY99245025482787,GB97FHKC16607677923892,11/26/2015,6995.56,100002,N,Credited,CHROME,PC,Cr,10:32:08,13:54:46,3/21/2019,89998786,1520.81,6,Mr Mr particularly break defense. From get bank ability himself between.,11:13:43,CHEQUE
CXFY99245025482787,GB97FHKC16607677923892,11/26/2015,8516.37,100002,N,Credited,OPERA,PC,Cr,16:15:40,20:27:04,3/21/2019,93504744,1520.81,4,Population ever probably later bit. Machine development story value thousand above.,17:58:52,UPI
CXFY99245025482787,GB97FHKC16607677923892,11/26/2015,6995.56,100002,Y,Insurance,MI,PC,Dr,16:51:49,19:53:27,3/21/2019,31552516,1520.81,2,"Wonder hour couple article security will. Wish growth put statement begin yourself he away. Near degree run.
Leader just only. Recent moment operation bad look east. Author reach choose.",18:25:45,IMPS
CXFY99245025482787,GB97FHKC16607677923892,11/26/2015,5290.46,100002,Y,Household Consumables,IE,POS,Dr,9:56:31,16:05:32,3/27/2019,94887525,1705.1,4,"Think understand sing some. Level may artist start soldier clearly myself. Do father plan skin.
Language could reason day executive customer arm.",13:54:34,UPI
CXFY99245025482787,GB97FHKC16607677923892,11/26/2015,6995.56,100002,N,Credited,IE,MOBILE,Cr,20:45:07,24:22:39,3/27/2019,19344171,1705.1,3,"If before until somebody quickly compare eight. Would likely surface help. Suggest foreign determine.
Section purpose yet adult within.",21:55:02,RTGS
CXFY99245025482787,GB97FHKC16607677923892,11/26/2015,5149.87,100002,Y,Entertainment,CHROME,POS,Dr,5:12:50,7:53:02,3/30/2019,32188547,1845.69,3,"Seem show have lay just professional pass feel. Level over energy fly less. Write consider term become by why story.
Agency production if meet along. Center if skill modern federal any bit.",6:03:26,RTGS
CXFY99245025482787,GB97FHKC16607677923892,11/26/2015,6995.56,100002,N,Credited,MI,MOBILE,Cr,7:06:13,9:53:04,3/30/2019,52690532,1845.69,5,"Democrat option maybe choose you window.
Present exist also professional. Maintain meeting church understand these trade sound model.
Not the few music way month. Daughter mind develop than.",8:32:58,CARDS
CXFY99245025482787,GB97FHKC16607677923892,11/26/2015,5149.87,100002,Y,Dining,SAFARI,MOBILE,Dr,11:18:36,14:15:37,3/30/2019,58787441,1845.69,4,"Or seek decade call institution then. Share prevent seven enjoy ten could moment. Dream force baby production thus.
This somebody computer draw common. Possible long arrive force time color.",12:28:28,UPI
CXFY99245025482787,GB97FHKC16607677923892,11/26/2015,3304.18,100002,Y,Rent,FF,PC,Dr,15:39:14,17:21:07,3/30/2019,79985161,1845.69,1,Again quality practice than. Career seek couple after history product. Read improve every trial word no think man. Hit view loss against.,16:55:11,NEFT
CXFY99245025482787,GB97FHKC16607677923892,11/26/2015,1458.49,100002,Y,Utilities,CHROME,PC,Dr,20:56:59,24:25:41,3/30/2019,78510968,1845.69,3,Toward hospital appear Mr. Face condition order American man win list. Full quality eye natural consumer term.,22:29:54,RTGS
CXFY99245025482787,GB97FHKC16607677923892,11/26/2015,1028.07,100002,Y,Utilities,SAFARI,PC,Dr,6:32:51,8:05:48,4/8/2019,91435989,430.42,1,"Season address project when fall score family. Big painting over including money.
Thing future either guess audience head fish. Likely brother century station speech continue.",7:35:10,NEFT
CXFY99245025482787,GB97FHKC16607677923892,11/26/2015,597.65,100002,Y,Utilities,OPERA,MOBILE,Dr,11:22:35,12:50:47,4/8/2019,52380334,430.42,5,"Mind during his film three new expert its. Beat force follow board often.
Ago space health be treatment senior campaign. Style card office main industry. Late career left cell newspaper deal.",11:47:54,CARDS
CXFY99245025482787,GB97FHKC16607677923892,11/26/2015,1028.07,100002,N,Credited,MI,POS,Cr,12:58:50,15:46:59,4/8/2019,80602002,430.42,3,Must exist wait TV it really no. Country particular way bad. Generation beyond chair instead without price break.,14:39:35,RTGS
CXFY99245025482787,GB97FHKC16607677923892,11/26/2015,1458.49,100002,N,Credited,OPERA,MOBILE,Cr,19:29:32,21:32:41,4/8/2019,11943907,430.42,5,"A western training. Teacher since threat these attack.
School himself size picture right by view. Four suggest Republican involve share. Live rule throw million.",19:56:00,CARDS
CXFY99245025482787,GB97FHKC16607677923892,11/26/2015,1888.91,100002,N,Credited,EDGE,POS,Cr,23:18:03,25:53:03,4/8/2019,32320169,430.42,3,"Really north let industry.
Professor ground throughout imagine. Hear old land hold.",23:59:14,RTGS
CXFY99245025482787,GB97FHKC16607677923892,11/26/2015,2550.95,100002,N,Credited,EDGE,POS,Cr,6:48:39,11:06:25,4/9/2019,79782623,662.04,2,"Week you would. Story score idea mean more. National happen discuss yet common season affect.
Process such spend remain. Simply thank fill like that.",8:34:28,IMPS
CXFY99245025482787,GB97FHKC16607677923892,11/26/2015,3212.99,100002,N,Credited,SAFARI,MOBILE,Cr,16:00:23,22:09:15,4/9/2019,8790101,662.04,2,Amount it cut lay process claim. However purpose son tough find director.,18:32:02,IMPS
CXFY99245025482787,GB97FHKC16607677923892,11/26/2015,2779.03,100002,Y,Groceries,IE,MOBILE,Dr,17:01:21,23:02:09,4/15/2019,69150678,433.96,2,Develop really positive minute yes. Hear eye so site. Kitchen by artist finally product capital everyone.,19:48:29,IMPS
CXFY99245025482787,GB97FHKC16607677923892,11/26/2015,3952.04,100002,N,Credited,MI,MOBILE,Cr,20:00:36,25:44:54,4/22/2019,14687266,1173.01,1,Institution partner firm you show floor student. Turn myself face program tough admit.,22:58:53,NEFT
CXFY99245025482787,GB97FHKC16607677923892,11/26/2015,5261.42,100002,N,Credited,CHROME,PC,Cr,7:16:03,13:56:50,4/30/2019,4809746,1309.38,6,"Professional indicate president his. Break reduce father really. Contain tell agree rise.
Reveal why hold gas usually agree at. During risk test study leader although. Spend green store lay.",9:59:29,CHEQUE
CXFY99245025482787,GB97FHKC16607677923892,11/26/2015,6570.8,100002,N,Credited,IE,MOBILE,Cr,19:37:02,26:23:59,4/30/2019,29556427,1309.38,4,"Senior free during language particularly go.
State team scene special blood. During contain arrive water. Car probably pretty road either phone.",23:05:07,UPI
CXFY99245025482787,GB97FHKC16607677923892,11/26/2015,8514.95,100002,N,Credited,CHROME,MOBILE,Cr,5:56:19,9:31:23,5/1/2019,54945326,1944.15,7,"Bar service four where stay opportunity.
Deep lawyer billion national community score. Among office home learn building report.",7:30:10,DD
CXFY99245025482787,GB97FHKC16607677923892,11/26/2015,10459.1,100002,N,Credited,SAFARI,MOBILE,Cr,10:58:58,13:53:32,5/1/2019,75705466,1944.15,1,"Scene message within. Well wish hot soldier nearly recent discussion out.
Amount not half interview knowledge cost point yeah. Spring almost easy yourself.",12:40:59,NEFT
CXFY99245025482787,GB97FHKC16607677923892,11/26/2015,12403.25,100002,N,Credited,CHROME,PC,Cr,16:22:11,19:23:11,5/1/2019,75047054,1944.15,3,"Picture challenge class rate trip. Skill image next kind address reason blood. Economy day western card political drive course.
Become site purpose might. Manage something meet truth.",17:01:00,RTGS
CXFY99245025482787,GB97FHKC16607677923892,11/26/2015,14347.4,100002,N,Credited,FF,MOBILE,Cr,18:44:25,20:27:38,5/1/2019,17384520,1944.15,2,Wonder lay news from institution attack resource. Management body between history four fast eye.,19:26:00,IMPS
CXFY99245025482787,GB97FHKC16607677923892,11/26/2015,13644.57,100002,Y,Dining,FF,MOBILE,Dr,4:30:31,6:07:10,5/4/2019,87211528,702.83,4,State clearly special partner hundred cell finally simply. Back skill interesting industry condition. Old arm himself.,5:15:09,UPI
CXFY99245025482787,GB97FHKC16607677923892,11/26/2015,12941.74,100002,Y,Insurance,CHROME,MOBILE,Dr,8:47:01,10:48:09,5/4/2019,34420140,702.83,3,"Treat sort also official Republican right. Number keep be know memory. President operation election result seek manage edge.
Off military one report. Civil night land lose success resource produce.",9:56:21,RTGS
CXFY99245025482787,GB97FHKC16607677923892,11/26/2015,13644.57,100002,N,Credited,CHROME,POS,Cr,10:47:54,13:47:35,5/4/2019,40449524,702.83,3,"Term leg major stuff black view. Best look half century knowledge we edge government.
Wrong ball main some cold education near American. Tell to live story bar.",12:41:03,RTGS
CXFY99245025482787,GB97FHKC16607677923892,11/26/2015,12941.74,100002,Y,Medicals,IE,POS,Dr,16:50:02,20:35:02,5/4/2019,49567571,702.83,6,Again fish reduce me choice ever soon. Tax PM see high whether perform. Campaign Democrat eye court job senior nice.,18:36:18,CHEQUE
CXFY99245025482787,GB97FHKC16607677923892,11/26/2015,12238.91,100002,Y,Entertainment,SAFARI,POS,Dr,21:42:26,24:30:24,5/4/2019,6321291,702.83,5,"Democrat prevent management real camera. Staff short matter sit phone month southern. Television inside star operation. Doctor for quality particular raise book two.
Page born bar kitchen pretty for.",22:51:43,CARDS
CXFY99245025482787,GB97FHKC16607677923892,11/26/2015,11199.43,100002,Y,Rent,FF,PC,Dr,7:54:28,14:00:35,5/6/2019,361002,1039.48,6,"Stuff seat move trip. Result choice value table recognize hot. Agreement ten specific on order.
Call even home hotel east. Program while after yourself hospital account detail.",12:07:04,CHEQUE
CXFY99245025482787,GB97FHKC16607677923892,11/26/2015,9710.12,100002,Y,Personal Care,OPERA,PC,Dr,6:53:02,10:44:35,5/7/2019,6861452,1489.31,2,"Threat measure bed machine.
Action site force continue culture easy smile. Summer work out decision. Career fact season ahead.",9:12:08,IMPS
CXFY99245025482787,GB97FHKC16607677923892,11/26/2015,11199.43,100002,N,Credited,CHROME,POS,Cr,17:35:38,22:50:33,5/7/2019,86305433,1489.31,4,Safe have instead onto want. Fill so how could election plant since do. Dog when ten level building. Order world happy continue.,19:55:43,UPI
CXFY99245025482787,GB97FHKC16607677923892,11/26/2015,11699.96,100002,N,Credited,EDGE,PC,Cr,5:43:02,6:59:47,5/10/2019,40152455,500.53,2,"Season stage phone exist treatment well. Best cold for lot.
Indicate win explain a thought. Visit our from generation tend reason into. Executive box brother ten campaign buy glass above.",6:19:24,IMPS
CXFY99245025482787,GB97FHKC16607677923892,11/26/2015,12200.49,100002,N,Credited,FF,PC,Cr,8:19:06,9:20:51,5/10/2019,75205539,500.53,5,"Own town research truth specific. Already mind west take will operation.
Girl room share current environment. Lawyer better national energy. Seven make model. Much piece a pattern statement.",8:52:30,CARDS
CXFY99245025482787,GB97FHKC16607677923892,11/26/2015,11699.96,100002,Y,Utilities,MI,PC,Dr,12:34:56,14:08:00,5/10/2019,10016114,500.53,4,Article task perform recognize former require. And marriage special our grow. Over actually certainly various if value toward.,13:11:35,UPI
CXFY99245025482787,GB97FHKC16607677923892,11/26/2015,12200.49,100002,N,Credited,OPERA,PC,Cr,15:44:20,17:56:17,5/10/2019,24623612,500.53,2,"Occur forget dark issue easy draw. This write answer some grow her us.
South like let occur law. Sing door education political bank threat. Painting scientist event either.",17:16:34,IMPS
CXFY99245025482787,GB97FHKC16607677923892,11/26/2015,12701.02,100002,N,Credited,SAFARI,POS,Cr,23:11:24,25:07:55,5/10/2019,73374046,500.53,2,"Establish against year carry person occur. Notice Republican leg. Positive democratic feeling machine allow night.
Nearly phone population wall. Step structure body.",23:39:04,IMPS
CXFY99245025482787,GB97FHKC16607677923892,11/26/2015,11130.27,100002,Y,Groceries,EDGE,POS,Dr,8:11:03,12:05:53,5/15/2019,86861007,1570.75,2,"Alone minute reveal their song.
Fish risk firm shoulder own blue indeed. Ago exist meet. Line present recognize reason instead source.",9:37:25,IMPS
CXFY99245025482787,GB97FHKC16607677923892,11/26/2015,9559.52,100002,Y,Entertainment,CHROME,MOBILE,Dr,12:22:46,17:14:03,5/15/2019,97477334,1570.75,7,"Test ago election. Second high box officer rule serve since wife.
Statement writer instead attorney support short. Him begin finally red million do stuff despite.",14:15:21,DD
CXFY99245025482787,GB97FHKC16607677923892,11/26/2015,7988.77,100002,Y,Entertainment,FF,PC,Dr,22:28:46,26:36:07,5/15/2019,12690657,1570.75,1,"Husband be west three. Public family research college fire. To few save cut some.
Radio very it night. Recently think send can. Those full serious positive other. Bank beyond everything kind either.",23:50:34,NEFT
CXFY99245025482787,GB97FHKC16607677923892,11/26/2015,9088.44,100002,N,Credited,FF,PC,Cr,11:56:52,22:19:20,5/19/2019,30447646,1099.67,2,Reach by receive add then teach him road. Pass at resource loss nice recent. Idea notice PM everybody.,17:38:01,IMPS
CXFY99245025482787,GB97FHKC16607677923892,11/26/2015,9565.77,100002,N,Credited,OPERA,POS,Cr,13:07:08,19:03:57,5/22/2019,99069155,477.33,2,"Range town involve nice major. End law specific than may recognize.
Wide picture mouth road as level. Any rule certainly resource modern few seat.",15:40:35,IMPS
CXFY99245025482787,GB97FHKC16607677923892,11/26/2015,7850.17,100002,Y,Utilities,FF,MOBILE,Dr,9:02:19,11:50:13,5/25/2019,76483929,1715.6,4,"Glass forward cell husband during quite. Smile style institution coach. Rather likely sort throw exactly.
Less whom quite chance religious throw police. Relationship move admit suddenly apply.",10:51:35,UPI
CXFY99245025482787,GB97FHKC16607677923892,11/26/2015,9565.77,100002,N,Credited,OPERA,MOBILE,Cr,16:09:19,19:45:44,5/25/2019,8023612,1715.6,6,Public name network population which local. Art represent likely would big human grow.,16:53:15,CHEQUE
CXFY99245025482787,GB97FHKC16607677923892,11/26/2015,11281.37,100002,N,Credited,IE,PC,Cr,19:47:45,24:20:05,5/25/2019,7317705,1715.6,4,"Course ball world. Start girl baby.
Candidate sport hot attention. Space whole pass manage read week near.",21:49:27,UPI
CXFY99245025482787,GB97FHKC16607677923892,11/26/2015,10202.4,100002,Y,Transportation,FF,PC,Dr,7:47:50,13:12:34,6/10/2019,10949498,1078.97,4,"Report reason beautiful of project. Product type information reveal wide. Reveal radio seat white than cold fact.
Play hope until effect. Father watch also child. Detail other letter traditional.",10:37:19,UPI
CXFY99245025482787,GB97FHKC16607677923892,11/26/2015,11281.37,100002,N,Credited,MI,PC,Cr,14:23:34,19:24:45,6/10/2019,21634260,1078.97,2,Store service threat Democrat success. Management finally positive I yourself. Either tend I leave trade recently to.,17:31:32,IMPS
CXFY99245025482787,GB97FHKC16607677923892,11/26/2015,10503.01,100002,Y,Online Shopping,IE,MOBILE,Dr,7:44:19,14:44:13,6/18/2019,72818275,778.36,6,"Sell identify keep explain scene simple her issue. Example often keep parent your station poor.
Vote song light treat wonder assume. Great day clearly nothing ok individual record.",10:57:16,CHEQUE
CXFY99245025482787,GB97FHKC16607677923892,11/26/2015,9724.65,100002,Y,Rent,OPERA,POS,Dr,13:45:50,18:34:17,6/18/2019,86615129,778.36,1,"Cold four maintain fall. Quite garden stand relate.
Local program between mouth. Feeling measure behavior mind edge. Benefit floor student full event.",16:54:22,NEFT
CXFY99245025482787,GB97FHKC16607677923892,11/26/2015,10542.61,100002,N,Credited,FF,MOBILE,Cr,14:44:52,18:26:33,6/23/2019,65783825,817.96,4,"Ask participant argue example cup their station. Alone game opportunity major build alone. Lead central edge light of.
Consider national card certainly reach bad onto.",15:53:47,UPI
CXFY99245025482787,GB97FHKC16607677923892,11/26/2015,11360.57,100002,N,Credited,OPERA,PC,Cr,20:20:48,25:10:00,6/23/2019,13115791,817.96,1,"Resource world should modern school. Month later indeed war. Nice structure every particularly white. Republican relate wife particularly.
Per compare word week. Dinner artist current lot cut seat.",22:45:48,NEFT
CXFY99245025482787,GB97FHKC16607677923892,11/26/2015,11331.97,100002,Y,Insurance,CHROME,POS,Dr,4:10:43,5:53:48,7/1/2019,12385287,28.6,4,"Fast finally loss morning. Determine more this you himself yard anything history. Beyond ability quickly.
From garden age above note center action. Serve bed information house market design the.",5:20:00,UPI
CXFY99245025482787,GB97FHKC16607677923892,11/26/2015,11303.37,100002,Y,Dining,MI,MOBILE,Dr,9:43:53,12:26:58,7/1/2019,19082288,28.6,5,"Interesting head improve. Imagine president ten player machine image type. Far and eye question.
Common threat challenge add three every course. On charge difference green writer already contain.",10:44:10,CARDS
CXFY99245025482787,GB97FHKC16607677923892,11/26/2015,11274.77,100002,Y,Insurance,FF,POS,Dr,14:58:27,18:15:08,7/1/2019,52387883,28.6,1,Mr scene age. List each difference range become. Here huge training bar improve parent.,16:53:05,NEFT
CXFY99245025482787,GB97FHKC16607677923892,11/26/2015,11246.17,100002,Y,Online Shopping,IE,PC,Dr,19:08:37,23:17:26,7/1/2019,11656005,28.6,2,"Shoulder left Congress. Catch collection organization perhaps side. Now window paper beautiful.
Prepare mouth picture window.",21:24:49,IMPS
CXFY99245025482787,GB97FHKC16607677923892,11/26/2015,10299.51,100002,Y,Medicals,FF,PC,Dr,11:51:46,18:23:04,7/2/2019,49535211,946.66,3,"Congress source debate rule skin machine. One affect little term.
Company voice during able whom participant first mouth. Economy concern exist food.",15:31:38,RTGS
CXFY99245025482787,GB97FHKC16607677923892,11/26/2015,9352.85,100002,Y,Groceries,EDGE,MOBILE,Dr,14:48:30,19:59:01,7/2/2019,48370349,946.66,2,"While listen very process. Local table place pull.
Their range rich even. At same politics help. Someone order watch since show night.",16:30:22,IMPS
CXFY99245025482787,GB97FHKC16607677923892,11/26/2015,10119.12,100002,N,Credited,FF,POS,Cr,7:35:10,12:14:47,7/13/2019,24232302,766.27,2,"Head western pick your. Return beautiful experience these year why house. Personal run although upon but.
Seven then improve operation. Have treat part character them road until difficult.",10:38:44,IMPS
CXFY99245025482787,GB97FHKC16607677923892,11/26/2015,9352.85,100002,Y,Rent,MI,PC,Dr,14:23:14,21:37:41,7/13/2019,32974218,766.27,2,"Ground member trade necessary off look east thousand. Parent suddenly film of where.
Star action pressure among those media organization. Particularly perform clearly official form issue.",18:11:31,IMPS
CXFY99245025482787,GB97FHKC16607677923892,11/26/2015,8085.97,100002,Y,Rent,IE,PC,Dr,6:15:19,8:53:47,7/24/2019,84762320,1266.88,4,Record personal control hear. Box region factor control look. Usually speak use technology.,7:40:24,UPI
CXFY99245025482787,GB97FHKC16607677923892,11/26/2015,6819.09,100002,Y,Groceries,EDGE,PC,Dr,9:15:10,11:20:09,7/24/2019,62483988,1266.88,2,Green represent smile sometimes than organization in. Least election reveal politics pick sure. Company ball issue left arrive.,9:45:48,IMPS
CXFY99245025482787,GB97FHKC16607677923892,11/26/2015,8085.97,100002,N,Credited,SAFARI,PC,Cr,14:42:53,17:14:22,7/24/2019,37543877,1266.88,4,What institution letter morning few only. Second exactly exactly. Treatment share first low million. Both forward dark how group matter.,15:53:20,UPI
CXFY99245025482787,GB97FHKC16607677923892,11/26/2015,6819.09,100002,Y,Household Consumables,OPERA,MOBILE,Dr,18:24:46,20:31:00,7/24/2019,52795039,1266.88,4,Area those require research move. Stand consumer large within. In entire she kid green save herself. Budget brother impact act so.,19:00:13,UPI
CXFY99245025482787,GB97FHKC16607677923892,11/26/2015,5552.21,100002,Y,Entertainment,FF,POS,Dr,19:55:49,22:05:44,7/24/2019,56132236,1266.88,6,Risk home whole lay history hundred choose. Financial store long pass wrong house. Choose economy computer interest film deep part.,20:33:31,CHEQUE
CXFY99245025482787,GB97FHKC16607677923892,11/26/2015,4517.36,100002,Y,Online Shopping,OPERA,POS,Dr,10:30:48,15:07:50,7/25/2019,5801053,1034.85,6,"High yes sport system compare record rise.
Effort involve discussion leave finish per. Per west reach fight rather hotel. Woman police about arrive example.",13:23:29,CHEQUE
CXFY99245025482787,GB97FHKC16607677923892,11/26/2015,3830.55,100002,Y,Personal Care,FF,MOBILE,Dr,5:39:05,9:23:35,8/1/2019,22145598,686.81,6,"Tree everybody local. Building other understand huge interesting vote miss.
Those box up build protect to. Near little voice class between thank. Mention history test ball new help result.",6:30:31,CHEQUE
CXFY99245025482787,GB97FHKC16607677923892,11/26/2015,4517.36,100002,N,Credited,MI,PC,Cr,11:42:40,15:04:52,8/1/2019,91522177,686.81,3,"Second high side analysis term imagine. Direction start buy president price second.
Find people enter. Or return page foreign walk partner. Quite generation marriage difference.",14:24:40,RTGS
CXFY99245025482787,GB97FHKC16607677923892,11/26/2015,3830.55,100002,Y,Rent,SAFARI,PC,Dr,17:57:23,23:05:31,8/1/2019,54179615,686.81,3,Wonder owner remember according power gun individual. Million director rather administration plan. Some writer general hope leg.,20:45:23,RTGS
CXFY99245025482787,GB97FHKC16607677923892,11/26/2015,5189.83,100002,N,Credited,FF,PC,Cr,10:00:21,16:10:21,8/5/2019,84444691,1359.28,6,Oil result do heart yet life. Clearly society else. Us attention environmental draw contain include few.,12:27:04,CHEQUE
CXFY99245025482787,GB97FHKC16607677923892,11/26/2015,6549.11,100002,N,Credited,EDGE,MOBILE,Cr,14:28:51,20:46:39,8/5/2019,80330714,1359.28,4,"Level politics in tree friend. Smile realize million health society various myself. Middle third forward perhaps.
Well couple whatever training. Discuss experience ever expert some.",16:58:52,UPI
CXFY99245025482787,GB97FHKC16607677923892,11/26/2015,6950.37,100002,N,Credited,IE,PC,Cr,7:04:40,12:08:35,8/9/2019,22219794,401.26,5,"Left chair so today. Training second dog after heart. Activity else some whom yeah. Board above on head but economy.
Tend administration vote ability either work stay voice.",9:35:11,CARDS
CXFY99245025482787,GB97FHKC16607677923892,11/26/2015,7351.63,100002,N,Credited,CHROME,PC,Cr,11:35:38,17:06:20,8/9/2019,24853118,401.26,4,"Go station child. Sing especially black mean.
Red according type. He bring majority policy magazine.
Race prepare return above think argue clear. Look author them explain.",14:14:26,UPI
CXFY99245025482787,GB97FHKC16607677923892,11/26/2015,6950.37,100002,Y,Medicals,IE,MOBILE,Dr,20:19:25,22:54:39,8/9/2019,50807161,401.26,1,"Class play turn run such although. Option off sea on trial kitchen arrive.
Report police event manage analysis support require.",20:56:19,NEFT
CXFY99245025482787,GB97FHKC16607677923892,11/26/2015,7213.77,100002,N,Credited,SAFARI,PC,Cr,8:11:25,11:23:43,8/10/2019,98750597,263.4,6,"Argue paper forget everyone. Me give apply property.
Alone great not will affect knowledge. Far challenge eight learn of factor hour. Adult people a after small.",8:53:47,CHEQUE
CXFY99245025482787,GB97FHKC16607677923892,11/26/2015,7477.17,100002,N,Credited,FF,MOBILE,Cr,11:17:01,15:00:11,8/10/2019,85588509,263.4,1,"Own reflect my goal central. Answer watch popular spring wrong feeling own.
Get dinner game look again level history. Painting range value course area few.",12:26:56,NEFT
CXFY99245025482787,GB97FHKC16607677923892,11/26/2015,7740.57,100002,N,Credited,CHROME,MOBILE,Cr,17:27:19,21:01:33,8/10/2019,8540096,263.4,3,Food really among take money clearly final. Hand stock create sometimes successful mention big. Appear seem where argue.,19:43:16,RTGS
CXFY99245025482787,GB97FHKC16607677923892,11/26/2015,8573.44,100002,N,Credited,OPERA,PC,Cr,15:38:23,20:50:48,8/22/2019,64282671,832.87,5,"Eye letter his forward interest break suggest. Should great write possible response want.
Her table significant defense. Region more tough beat political. Commercial hair friend role ability.",17:52:38,CARDS
CXFY99245025482787,GB97FHKC16607677923892,11/26/2015,6959.88,100002,Y,Household Consumables,SAFARI,PC,Dr,13:12:55,20:45:18,8/23/2019,97460985,1613.56,2,"Agree worker image create. Artist control member find.
Federal this there early tell everybody. Better win lot draw. Health benefit director speak while later.
Its stage factor difficult.",16:20:35,IMPS
CXFY99245025482787,GB97FHKC16607677923892,11/26/2015,4982.6,100002,Y,Rent,MI,PC,Dr,12:33:56,17:14:31,8/28/2019,95838694,1977.28,3,"Worker check reach home natural. Add she real pass decision next agency.
Cultural technology worker collection send. Message change help they play among.",13:57:49,RTGS
CXFY99245025482787,GB97FHKC16607677923892,11/26/2015,6959.88,100002,N,Credited,CHROME,MOBILE,Cr,19:14:32,21:08:22,8/28/2019,45270994,1977.28,3,"Western treat beat seem. Least them safe couple buy year already.
Law lawyer century hot seek each. Station build risk.",20:10:23,RTGS
CXFY99245025482787,GB97FHKC16607677923892,11/26/2015,8079.42,100002,N,Credited,SAFARI,PC,Cr,5:14:22,7:53:28,8/31/2019,32935103,1119.54,7,"Why medical book current indicate successful.
Man kid reality people imagine. We power miss one appear fire while. General have culture kitchen during.",6:31:35,DD
CXFY99245025482787,GB97FHKC16607677923892,11/26/2015,6959.88,100002,Y,Personal Care,IE,POS,Dr,8:40:29,12:52:14,8/31/2019,86598972,1119.54,3,"State speak away black purpose exactly. Never so indicate leave member.
So here appear establish score good shake five. Teach size dog action keep offer.",10:48:27,RTGS
CXFY99245025482787,GB97FHKC16607677923892,11/26/2015,5840.34,100002,Y,Insurance,CHROME,PC,Dr,14:06:51,16:45:38,8/31/2019,87468373,1119.54,2,Chair structure travel. Office to billion teach campaign purpose lead. Music later east up quality machine position.,15:00:24,IMPS
CXFY99245025482787,GB97FHKC16607677923892,11/26/2015,6959.88,100002,N,Credited,FF,MOBILE,Cr,19:28:26,21:23:41,8/31/2019,63513677,1119.54,6,"Realize question land simply. Cost drive expert popular investment never away.
Maintain bad ok religious. Experience record base couple education shake reach. Always surface be nation letter.",20:07:06,CHEQUE
CXFY99245025482787,GB97FHKC16607677923892,11/26/2015,8326.27,100002,N,Credited,SAFARI,POS,Cr,21:31:36,26:00:10,9/4/2019,91986979,1366.39,2,"Another word break apply husband former. Break open military fund its catch.
Fish ground where main visit subject. Adult cut fear pull young nature instead test.",23:35:28,IMPS
CXFY99245025482787,GB97FHKC16607677923892,11/26/2015,7264.24,100002,Y,Medicals,CHROME,MOBILE,Dr,4:22:16,8:27:14,9/18/2019,75285548,1062.03,3,"Fish discuss town write so. Add use word maintain either explain.
Themselves matter ten specific major current far brother. Law wind purpose blue prove media important.",6:10:24,RTGS
CXFY99245025482787,GB97FHKC16607677923892,11/26/2015,6202.21,100002,Y,Household Consumables,MI,POS,Dr,14:41:21,17:52:51,9/18/2019,70190465,1062.03,6,"Employee source though base employee heart. Mention star large about member. Be attention data money again fast.
Fear building plan reason. Boy doctor likely.
Feeling specific project value.",17:13:34,CHEQUE
CXFY99245025482787,GB97FHKC16607677923892,11/26/2015,5140.18,100002,Y,Medicals,SAFARI,POS,Dr,20:15:55,23:48:49,9/18/2019,94320756,1062.03,2,"Education back some throw. Age place vote care too onto. Entire occur begin language.
Quite rich bag figure.",21:26:41,IMPS
CXFY99245025482787,GB97FHKC16607677923892,11/26/2015,6069.09,100002,N,Credited,OPERA,POS,Cr,13:27:44,19:44:16,10/2/2019,9864139,928.91,3,"Weight too matter reach. Site far list. Ask during over six.
Direction reality wear national window assume. System woman answer very. Whom sell recognize hit common.",15:59:51,RTGS
CXFY99245025482787,GB97FHKC16607677923892,11/26/2015,5821.75,100002,Y,Dining,SAFARI,POS,Dr,16:41:56,22:50:54,10/3/2019,77367105,247.34,4,"Current military study hear. Bar town popular industry. Hit cold ask piece serious Mr like media.
Ball believe population campaign. Factor order rate computer care land.",19:02:33,UPI
CXFY99245025482787,GB97FHKC16607677923892,11/26/2015,4835.94,100002,Y,Personal Care,IE,POS,Dr,18:15:31,21:16:04,10/6/2019,86024655,985.81,2,Figure girl visit wide should way himself federal. Whatever board none wife answer. Yet letter sister hold he from.,20:01:25,IMPS
CXFY99245025482787,GB97FHKC16607677923892,11/26/2015,6793.38,100002,N,Credited,CHROME,MOBILE,Cr,18:35:02,23:43:36,10/15/2019,61865020,1957.44,6,"Require box look follow future ground would. From where grow reduce receive. Decade half certainly record.
Glass decision more anyone budget hard. Pretty despite role game student paper.",21:16:34,CHEQUE
CXFY99245025482787,GB97FHKC16607677923892,11/26/2015,6615.52,100002,Y,Insurance,MI,PC,Dr,8:43:44,14:19:09,10/21/2019,92754508,177.86,6,System number economy training. There take boy loss save main. Cup company hot information report try discussion claim. Chair ago because available personal.,11:34:25,CHEQUE
CXFY99245025482787,GB97FHKC16607677923892,11/26/2015,6793.38,100002,N,Credited,EDGE,MOBILE,Cr,15:47:51,20:59:49,10/21/2019,80514428,177.86,4,"Woman east family. Center conference east list like time debate. Mr since memory ready view.
Drug hit administration. Service half require woman other score.",19:43:48,UPI
CXFY99245025482787,GB97FHKC16607677923892,11/26/2015,8146.12,100002,N,Credited,SAFARI,MOBILE,Cr,7:30:28,11:21:51,10/29/2019,34013236,1352.74,4,Money house into family medical particular reach seek. Billion left include enjoy morning. Group deal miss quickly church total leg.,9:00:52,UPI
CXFY99245025482787,GB97FHKC16607677923892,11/26/2015,6793.38,100002,Y,Groceries,SAFARI,POS,Dr,10:17:19,12:08:32,10/29/2019,16639584,1352.74,7,Operation view continue need program. Money various main soldier choose everything. Scene tell institution they store star.,11:13:05,DD
CXFY99245025482787,GB97FHKC16607677923892,11/26/2015,8146.12,100002,N,Credited,CHROME,POS,Cr,16:07:26,18:07:20,10/29/2019,99882068,1352.74,1,"Nature true growth. Through guess wind serve. Behind collection official but into.
Ground mother any box near start research. Program as well sign environmental hear if.",17:38:09,NEFT
CXFY99245025482787,GB97FHKC16607677923892,11/26/2015,6793.38,100002,Y,Insurance,CHROME,PC,Dr,21:53:43,24:08:32,10/29/2019,45434303,1352.74,5,"Child heavy television it second police. Wife part follow money but cell ground.
Soldier life though box her when.
Hot program way work. Consider manager level.",22:56:45,CARDS
CXFY99245025482787,GB97FHKC16607677923892,11/26/2015,5695.53,100002,Y,Entertainment,FF,POS,Dr,4:57:45,7:57:44,10/30/2019,51010188,1097.85,7,Impact test arm material major candidate high nothing. Religious character help new important blue. Scientist teacher against thought television rock.,6:11:19,DD
CXFY99245025482787,GB97FHKC16607677923892,11/26/2015,6793.38,100002,N,Credited,SAFARI,POS,Cr,13:23:14,14:40:23,10/30/2019,79996709,1097.85,6,"Way could base out anything. Start year day turn capital sister early. Positive think will fear.
They piece TV wall age conference. Leader and whole might last arm several.",13:54:00,CHEQUE
CXFY99245025482787,GB97FHKC16607677923892,11/26/2015,5695.53,100002,Y,Dining,OPERA,MOBILE,Dr,13:15:37,15:29:13,10/30/2019,50502561,1097.85,5,"Accept pattern professional shake board college church statement.
Focus three performance treatment road truth. Whom Mr win ground model rock. Discussion matter describe whatever top increase.",14:45:31,CARDS
CXFY99245025482787,GB97FHKC16607677923892,11/26/2015,6793.38,100002,N,Credited,FF,PC,Cr,21:33:14,24:10:43,10/30/2019,4704270,1097.85,7,"In short management from everything.
Rise senior lead mouth capital worker.",23:25:38,DD
CXFY99245025482787,GB97FHKC16607677923892,11/26/2015,5516.35,100002,Y,Insurance,MI,MOBILE,Dr,5:54:27,10:42:20,11/2/2019,28589952,1277.03,4,Performance no full. Everyone popular across often focus hold control.,8:50:04,UPI
CXFY99245025482787,GB97FHKC16607677923892,11/26/2015,4239.32,100002,Y,Utilities,OPERA,POS,Dr,13:36:38,18:10:02,11/2/2019,67386161,1277.03,5,"True over none difficult. Seek dinner local term space. First good question project skin all.
Day me film southern.
Blood serious its. Democratic family finish increase.",15:35:26,CARDS
CXFY99245025482787,GB97FHKC16607677923892,11/26/2015,2962.29,100002,Y,Groceries,MI,MOBILE,Dr,19:46:41,23:16:16,11/2/2019,27097038,1277.03,4,Relationship task military sure American actually. As him fly someone identify return behind. Bag instead good management bag stuff. Buy follow need could defense list.,22:10:43,UPI
CXFY99245025482787,GB97FHKC16607677923892,11/26/2015,4442.53,100002,N,Credited,MI,MOBILE,Cr,13:29:44,17:49:36,11/16/2019,25714920,1480.24,7,"Remain program teacher relate care his operation. Late heart ground cultural before likely whole.
Well spend serve table plan.
Small image me.",15:23:13,DD
CXFY99245025482787,GB97FHKC16607677923892,11/26/2015,5922.77,100002,N,Credited,EDGE,PC,Cr,20:41:35,26:44:53,11/16/2019,4105855,1480.24,5,"Heavy national important know such method. Garden major especially similar. Would bring woman between.
Day part notice radio executive step right including. Writer purpose decide.",22:57:26,CARDS
CXFY99245025482787,GB97FHKC16607677923892,11/26/2015,5382.59,100002,Y,Medicals,MI,MOBILE,Dr,7:04:32,10:36:28,11/29/2019,95424835,540.18,3,Ball lead girl ability value brother lay. Teach sit artist up win outside think act.,9:11:29,RTGS
CXFY99245025482787,GB97FHKC16607677923892,11/26/2015,4842.41,100002,Y,Medicals,FF,POS,Dr,14:16:41,19:57:36,11/29/2019,99776312,540.18,4,Others work remain strategy not possible option whom. Book garden institution raise research. Speak suggest body. Phone writer story much image head respond.,16:55:48,UPI
CXFY99245025482787,GB97FHKC16607677923892,11/26/2015,4057.22,100002,Y,Insurance,SAFARI,MOBILE,Dr,11:24:37,15:03:56,11/30/2019,19373546,785.19,5,"Leader impact college. Prepare page difficult though despite. Free prove cold build capital anyone.
New opportunity weight social green first certain. Next way top accept too building defense.",12:33:21,CARDS
CXFY99245025482787,GB97FHKC16607677923892,11/26/2015,3272.03,100002,Y,Transportation,MI,POS,Dr,21:43:17,25:19:39,11/30/2019,57062648,785.19,4,"Because whole issue generation my. City coach conference form.
However later hard newspaper individual authority. Pattern they left travel exist just me. Market represent prove stuff plan health.",23:28:52,UPI
CXFY99245025482787,GB97FHKC16607677923892,11/26/2015,5103.88,100002,N,Credited,IE,MOBILE,Cr,9:55:25,15:45:36,12/6/2019,46919205,1831.85,2,"Fly write ball teacher simple college author couple. Challenge hold our chair quite expert.
Fill often city remain. Sense field despite even.",13:15:08,IMPS
CXFY99245025482787,GB97FHKC16607677923892,11/26/2015,3272.03,100002,Y,Dining,CHROME,POS,Dr,21:53:08,24:50:53,12/6/2019,4512189,1831.85,7,"Board beat detail speech grow expert.
Here agreement candidate policy dream leader imagine. Eye sure boy arrive bank. Style cause certainly late child. Nothing tree to five.",23:51:48,DD
CXFY99245025482787,GB97FHKC16607677923892,11/26/2015,1758.26,100002,Y,Medicals,MI,MOBILE,Dr,9:06:20,15:09:16,12/15/2019,32478297,1513.77,2,"Important while return store their lead. Operation large girl.
Identify several plan commercial think position near little. Research face become cut different second cut.
Far add region top health.",11:34:21,IMPS
CXFY99245025482787,GB97FHKC16607677923892,11/26/2015,244.49,100002,Y,Personal Care,IE,MOBILE,Dr,20:04:12,24:38:28,12/15/2019,44069377,1513.77,2,"Table two cold leader. Coach use surface left camera production know American.
He thing spring lead building out question. Leg billion enough bed woman tax assume city.",21:16:44,IMPS
CXFY99245025482787,GB97FHKC16607677923892,11/26/2015,1400.03,100002,N,Credited,IE,POS,Cr,9:17:18,12:12:38,12/30/2019,58329207,1155.54,4,"Recognize answer draw great chance then think. Free hundred adult four learn prove.
Use ball world job. Skill cause central answer.",10:44:00,UPI
CXFY99245025482787,GB97FHKC16607677923892,11/26/2015,2555.57,100002,N,Credited,EDGE,POS,Cr,12:10:26,14:00:38,12/30/2019,54550247,1155.54,4,"A card very else yet site. Begin power easy Republican can somebody.
Six along future education through much evening. Once say bag case house wife. Debate establish left share especially enjoy what.",13:30:20,UPI
CXFY99245025482787,GB97FHKC16607677923892,11/26/2015,1400.03,100002,Y,Groceries,MI,POS,Dr,17:08:39,19:27:17,12/30/2019,93979191,1155.54,7,Song source body determine himself move writer. Third though hundred their address. Ahead despite coach where deal degree.,17:45:10,DD
CXFY99245025482787,GB97FHKC16607677923892,11/26/2015,2555.57,100002,N,Credited,SAFARI,POS,Cr,19:49:45,22:26:50,12/30/2019,56005141,1155.54,4,Up opportunity not figure plant though. Participant student bank those himself. Structure leave center film time space perform face.,20:49:39,UPI
CXFY99245025482787,GB97FHKC16607677923892,11/26/2015,3908.26,100002,N,Credited,EDGE,POS,Cr,21:37:03,29:10:56,1/1/2020,83128769,1352.69,4,"Risk change fact answer nor. Lose specific tax interview.
Republican term yeah himself challenge. Big choice amount land suddenly choose. Chair coach ok follow sense behavior impact discuss.",23:53:26,UPI
CXFY99245025482787,GB97FHKC16607677923892,11/26/2015,2824.45,100002,Y,Rent,MI,POS,Dr,16:46:45,27:00:55,1/4/2020,63988932,1083.81,1,"Marriage attorney might quickly. Teach several color first these pass my.
Chair brother energy throw behind. Likely laugh direction.
Thing beat boy can leader short seem.",22:40:51,NEFT
CXFY99245025482787,GB97FHKC16607677923892,11/26/2015,3673.2,100002,N,Credited,EDGE,POS,Cr,16:44:20,23:02:48,1/14/2020,70994339,848.75,5,Positive million recognize force career wrong. Rule whom office particularly. Away soldier thousand.,20:48:57,CARDS
CXFY99245025482787,GB97FHKC16607677923892,11/26/2015,2209.97,100002,Y,Online Shopping,SAFARI,PC,Dr,5:12:08,7:24:58,1/16/2020,53893710,1463.23,2,"Set happen security tonight course. Town front learn participant standard land.
Usually miss fill bad. Technology happy environment machine himself successful behind.",5:53:01,IMPS
CXFY99245025482787,GB97FHKC16607677923892,11/26/2015,3673.2,100002,N,Credited,EDGE,MOBILE,Cr,8:30:59,10:46:17,1/16/2020,64297569,1463.23,6,Speech just particular for activity surface develop. Study sister than win another past government institution.,10:00:49,CHEQUE
CXFY99245025482787,GB97FHKC16607677923892,11/26/2015,2209.97,100002,Y,Online Shopping,SAFARI,PC,Dr,17:49:10,19:57:06,1/16/2020,47031777,1463.23,4,"However trouble seek forget debate security chair.
Spring along national tell form fine military. Site picture car security gas.",18:18:10,UPI
CXFY99245025482787,GB97FHKC16607677923892,11/26/2015,746.74,100002,Y,Dining,IE,POS,Dr,20:28:55,23:11:12,1/16/2020,80915256,1463.23,2,"Door case short along itself current discover. Tell pattern represent stock. Market head get trip trade.
Small offer hand effect heart. Take activity everyone hour crime gas discover.",21:21:17,IMPS
CXFY99245025482787,GB97FHKC16607677923892,11/26/2015,705.16,100002,Y,Groceries,SAFARI,POS,Dr,3:29:58,6:30:21,1/25/2020,4403555,41.58,7,Blue despite mean speech college level rest grow. Manager free little information best follow.,5:17:32,DD
CXFY99245025482787,GB97FHKC16607677923892,11/26/2015,746.74,100002,N,Credited,IE,PC,Cr,7:44:32,11:49:20,1/25/2020,47315341,41.58,7,"She question realize benefit however attack. Onto represent life occur where hundred.
Wear effort do loss. Participant action listen bag get three.",10:08:16,DD
CXFY99245025482787,GB97FHKC16607677923892,11/26/2015,788.32,100002,N,Credited,FF,MOBILE,Cr,15:26:07,18:52:10,1/25/2020,12300082,41.58,2,"Force food strong impact pattern decade why. Identify keep process across including establish very.
Sit lose none never. Claim reality church.",16:45:23,IMPS
CXFY99245025482787,GB97FHKC16607677923892,11/26/2015,829.9,100002,N,Credited,SAFARI,MOBILE,Cr,18:42:17,21:26:50,1/25/2020,72836200,41.58,7,"Like number risk that inside season. Security former country loss cultural bad medical.
Condition maybe car share loss effect approach. His first mention adult.",19:44:38,DD
CXFY99245025482787,GB97FHKC16607677923892,11/26/2015,410.92,100002,Y,Rent,IE,MOBILE,Dr,13:02:45,21:00:22,1/28/2020,91842374,418.98,3,Real deal yard remain get. Real remain only structure.,17:03:37,RTGS
CXFY99245025482787,GB97FHKC16607677923892,11/26/2015,1207.53,100002,N,Credited,EDGE,POS,Cr,9:07:15,10:29:19,3/1/2020,58231944,796.61,2,"Study oil result radio have painting drug.
Institution imagine a learn see responsibility. Worker million will information adult.
Just threat same. Skill receive everyone. Give sister test.",9:57:48,IMPS
CXFY99245025482787,GB97FHKC16607677923892,11/26/2015,2004.14,100002,N,Credited,OPERA,POS,Cr,11:07:13,13:33:20,3/1/2020,2101903,796.61,1,"Oil chance result night nation sign. Magazine voice beat home guess score.
Foot town within up.
Adult quite hard appear community. Our present she.",12:44:12,NEFT
CXFY99245025482787,GB97FHKC16607677923892,11/26/2015,1207.53,100002,Y,Online Shopping,SAFARI,POS,Dr,15:59:12,17:40:47,3/1/2020,86724265,796.61,5,"Everyone sing also. Able about respond court. Movement recent anything city try have tonight.
True anything mission above official show reach. Strategy event Democrat there itself.",16:46:23,CARDS
CXFY99245025482787,GB97FHKC16607677923892,11/26/2015,2004.14,100002,N,Credited,IE,POS,Cr,20:49:27,23:38:08,3/1/2020,7702686,796.61,3,Model threat this us herself four. Occur kitchen turn wind choice. Deal professional hope really need against attorney.,22:02:01,RTGS
CXFY99245025482787,GB97FHKC16607677923892,11/26/2015,3885.57,100002,N,Credited,SAFARI,PC,Cr,7:35:15,9:49:47,3/7/2020,8666697,1881.43,6,On set perform democratic international answer follow. Later face for born across student bring young.,8:57:59,CHEQUE
CXFY99245025482787,GB97FHKC16607677923892,11/26/2015,5767,100002,N,Credited,FF,PC,Cr,8:15:52,11:34:16,3/7/2020,38242397,1881.43,1,"Certainly including father red. Outside car camera evidence perform.
Throw official safe difference simple sure four. Room mean leave individual tonight resource. White wide wall when.",9:48:10,NEFT
CXFY99245025482787,GB97FHKC16607677923892,11/26/2015,7648.43,100002,N,Credited,SAFARI,MOBILE,Cr,14:16:49,17:42:14,3/7/2020,18128130,1881.43,6,Into create direction world current. Culture care fact health past. Fish fear pass appear country structure short.,16:06:11,CHEQUE
CXFY99245025482787,GB97FHKC16607677923892,11/26/2015,9529.86,100002,N,Credited,SAFARI,MOBILE,Cr,18:16:34,22:12:34,3/7/2020,23743137,1881.43,4,"Leader hand cut enough should. Certain crime edge stock their. Section analysis wrong air owner store.
Short far they song. Always realize wrong under east. Near customer magazine left trial arrive.",20:22:25,UPI
CXFY99245025482787,GB97FHKC16607677923892,11/26/2015,7915.88,100002,Y,Utilities,EDGE,POS,Dr,3:40:53,7:05:40,3/9/2020,18326338,1613.98,1,Whatever medical upon simple now common hit. Development least commercial film nation including blue. Outside should quickly story threat.,5:40:34,NEFT
CXFY99245025482787,GB97FHKC16607677923892,11/26/2015,6301.9,100002,Y,Personal Care,EDGE,POS,Dr,8:26:12,10:40:44,3/9/2020,79087698,1613.98,5,There street option hope. Environment result sport better mother discuss game serious. Unit hold option technology.,9:24:38,CARDS
CXFY99245025482787,GB97FHKC16607677923892,11/26/2015,4687.92,100002,Y,Dining,SAFARI,MOBILE,Dr,13:03:52,16:09:45,3/9/2020,17390835,1613.98,6,"How article cell special. Style form together choice career mind discover tax. Would same maybe range.
Term especially information deal young couple new. Give agency so affect expect we list late.",14:40:16,CHEQUE
CXFY99245025482787,GB97FHKC16607677923892,11/26/2015,3073.94,100002,Y,Entertainment,EDGE,POS,Dr,16:06:39,19:18:55,3/9/2020,84514196,1613.98,3,"Behind film without thing surface pretty. Air dream alone outside.
Project build training if new girl. Religious while student despite concern young left politics.",17:38:28,RTGS
CXFY99245025482787,GB97FHKC16607677923892,11/26/2015,1459.96,100002,Y,Transportation,FF,POS,Dr,21:42:42,23:07:12,3/9/2020,90018596,1613.98,7,Design street back black. You chair offer positive contain.,22:08:53,DD
CXFY99245025482787,GB97FHKC16607677923892,11/26/2015,1325.91,100002,Y,Medicals,FF,PC,Dr,6:41:23,10:12:26,3/20/2020,80496892,134.05,4,"Station knowledge policy court. First whole such seem.
Serve suffer central not including. Nothing partner everything fill. Really word leave certainly wide. Someone the baby.",8:36:51,UPI
CXFY99245025482787,GB97FHKC16607677923892,11/26/2015,1459.96,100002,N,Credited,FF,PC,Cr,12:51:58,15:13:10,3/20/2020,99097455,134.05,2,Morning such campaign financial and. Trouble accept loss TV mother. Turn movie significant star success share.,14:21:43,IMPS
CXFY99245025482787,GB97FHKC16607677923892,11/26/2015,1325.91,100002,Y,Rent,MI,POS,Dr,16:39:43,18:16:41,3/20/2020,22981066,134.05,2,"If agent mouth draw. Compare main believe cover find service. Else catch type son though other they.
Give better radio. Relate concern hair campaign all really. Since none project their keep there.",17:08:36,IMPS
CXFY99245025482787,GB97FHKC16607677923892,11/26/2015,1459.96,100002,N,Credited,CHROME,PC,Cr,18:51:17,22:33:44,3/20/2020,88538235,134.05,1,"Manage show study hit might available. Director which consider.
Support true threat two on them.",20:22:59,NEFT
CXFY99245025482787,GB97FHKC16607677923892,11/26/2015,2026.12,100002,N,Credited,FF,MOBILE,Cr,4:54:22,7:00:59,4/1/2020,29372904,566.16,2,"Step move important open keep. Reality ahead every property per.
Allow top Mr. Bill suddenly so drug husband would.",6:26:26,IMPS
CXFY99245025482787,GB97FHKC16607677923892,11/26/2015,1459.96,100002,Y,Transportation,SAFARI,MOBILE,Dr,6:43:44,10:03:22,4/1/2020,47191860,566.16,5,"Short want easy performance thing without. Camera little student second probably beyond list such.
Else energy close interview avoid program. Simply dinner quickly none thousand.",8:31:21,CARDS
CXFY99245025482787,GB97FHKC16607677923892,11/26/2015,893.8,100002,Y,Online Shopping,IE,PC,Dr,14:42:37,15:43:49,4/1/2020,1349672,566.16,7,"Agency take culture life bad. What theory career reason environment.
Themselves through minute it career. Their enter nice house argue stop. Guess a upon customer federal.",15:12:42,DD
CXFY99245025482787,GB97FHKC16607677923892,11/26/2015,1459.96,100002,N,Credited,FF,MOBILE,Cr,15:48:17,17:33:33,4/1/2020,87571981,566.16,1,"Student town site model production. Approach similar finally speech kitchen fast interesting name.
Less decide worry page. Marriage seek deep how attack. Fund before discover child foot sometimes.",16:13:08,NEFT
CXFY99245025482787,GB97FHKC16607677923892,11/26/2015,2026.12,100002,N,Credited,FF,PC,Cr,21:57:33,23:19:57,4/1/2020,89710432,566.16,7,"Statement it we data financial yard. Position minute call hundred very recently bit policy. East feeling day. Community nice build nice anyone start.
Piece leg it only. Nice ok from leave.",22:46:33,DD
CXFY99245025482787,GB97FHKC16607677923892,11/26/2015,247.32,100002,Y,Medicals,FF,POS,Dr,11:43:32,21:55:31,4/5/2020,77091338,1778.8,5,"Lot play pass student. Talk generation paper key. Stage room rock expect rise.
Final movie dinner response. Actually forward grow he.",16:32:04,CARDS
CXFY99245025482787,GB97FHKC16607677923892,11/26/2015,2246.57,100002,N,Credited,OPERA,MOBILE,Cr,3:34:22,6:46:21,4/13/2020,1392036,1999.25,3,"Seek almost fast bad system easy. Form food receive care your woman.
Floor husband modern leg ask program school report. Bad weight boy first fall. Employee author safe the thousand hotel.",5:31:29,RTGS
CXFY99245025482787,GB97FHKC16607677923892,11/26/2015,4245.82,100002,N,Credited,MI,PC,Cr,7:48:17,11:17:32,4/13/2020,70078466,1999.25,4,"Music employee point agreement be. Thus suggest also purpose lay eye work.
Capital state kind not shoulder. Hospital us positive. Recent difference risk lose.",9:47:00,UPI
CXFY99245025482787,GB97FHKC16607677923892,11/26/2015,2246.57,100002,Y,Entertainment,FF,POS,Dr,13:15:08,16:38:24,4/13/2020,64601601,1999.25,5,"Management represent health evening.
Number court participant region party others among. People adult computer beautiful lawyer new.",15:09:50,CARDS
CXFY99245025482787,GB97FHKC16607677923892,11/26/2015,4245.82,100002,N,Credited,SAFARI,PC,Cr,18:44:32,20:03:50,4/13/2020,92066106,1999.25,4,"Avoid surface only. Ok foot get truth hundred until. Whole beautiful organization defense.
As officer woman fine local high skin. Fight serve by boy building read most situation.",19:18:50,UPI
CXFY99245025482787,GB97FHKC16607677923892,11/26/2015,2246.57,100002,Y,Online Shopping,EDGE,POS,Dr,19:13:19,21:34:28,4/13/2020,53196453,1999.25,7,Something instead contain allow even central bag. Art statement try ago. Because yard trial grow attack market move.,20:24:26,DD
CXFY99245025482787,GB97FHKC16607677923892,11/26/2015,2411.61,100002,N,Credited,EDGE,PC,Cr,6:17:44,8:50:50,4/15/2020,11843122,165.04,6,"Personal data development mean keep. Find end against design.
Describe budget scene their hard effort raise issue. National prevent we heart white short. Him person service yeah season.",7:58:46,CHEQUE
CXFY99245025482787,GB97FHKC16607677923892,11/26/2015,2576.65,100002,N,Credited,IE,MOBILE,Cr,9:05:42,11:27:11,4/15/2020,27144879,165.04,7,Evening certain drug up approach. Spring perhaps painting action site responsibility baby. Whole choice exactly whom friend.,10:40:19,DD
CXFY99245025482787,GB97FHKC16607677923892,11/26/2015,2741.69,100002,N,Credited,OPERA,MOBILE,Cr,12:30:25,14:38:27,4/15/2020,70302011,165.04,2,"Though man arm treatment. Identify hit second population.
New candidate also.
Give pressure prepare five. Make argue not drive.",13:04:06,IMPS
CXFY99245025482787,GB97FHKC16607677923892,11/26/2015,2576.65,100002,Y,Entertainment,EDGE,POS,Dr,16:43:41,18:23:53,4/15/2020,61999077,165.04,3,Miss yeah other we entire provide policy. Mother serious else. Tough bed new hit.,17:13:10,RTGS
CXFY99245025482787,GB97FHKC16607677923892,11/26/2015,2741.69,100002,N,Credited,FF,MOBILE,Cr,21:29:07,22:42:04,4/15/2020,77785091,165.04,3,"The start research little election around not. They the along sport whole can message.
Prevent everybody her ready edge half ball choose.",22:10:00,RTGS
CXFY99245025482787,GB97FHKC16607677923892,11/26/2015,2486.33,100002,Y,Household Consumables,IE,POS,Dr,16:13:11,22:25:14,4/29/2020,71226583,255.36,5,"Maybe common learn population read yeah long way. Week challenge safe worker again.
Nothing project push risk interview. Himself wall kitchen magazine simply.",19:04:17,CARDS
CXFY99245025482787,GB97FHKC16607677923892,11/26/2015,1425.3,100002,Y,Online Shopping,CHROME,POS,Dr,5:40:49,9:50:04,5/1/2020,40799315,1061.03,2,"Stage newspaper outside.
Government affect would it show involve step night. Person fill manage and each realize at central. Only eye leave.",8:55:19,IMPS
CXFY99245025482787,GB97FHKC16607677923892,11/26/2015,364.27,100002,Y,Personal Care,FF,PC,Dr,16:36:55,21:57:13,5/1/2020,35560296,1061.03,3,"Him cultural position any hear. Themselves here realize record. Read seek institution buy where speak. Cultural garden turn wind democratic road.
Manage adult out clear consumer. Push place remain.",19:27:09,RTGS
CXFY99245025482787,GB97FHKC16607677923892,11/26/2015,991.05,100002,N,Credited,EDGE,PC,Cr,10:17:34,13:06:04,5/15/2020,48234566,626.78,6,Movement none always part yourself night. Congress former born return. Course thought economy send opportunity under.,11:29:11,CHEQUE
CXFY99245025482787,GB97FHKC16607677923892,11/26/2015,364.27,100002,Y,Dining,MI,MOBILE,Dr,15:01:46,17:16:28,5/15/2020,41298169,626.78,7,"Draw list cup myself return.
Improve since tell. Meet what laugh speech cold.",15:48:59,DD
CXFY99245025482787,GB97FHKC16607677923892,11/26/2015,991.05,100002,N,Credited,SAFARI,POS,Cr,18:05:12,19:17:43,5/15/2020,92658004,626.78,1,More side first teacher husband. Citizen line himself foot whom box animal. Area culture soldier federal shoulder.,18:52:38,NEFT
CXFY99245025482787,GB97FHKC16607677923892,11/26/2015,364.27,100002,Y,Utilities,FF,MOBILE,Dr,22:07:45,24:16:00,5/15/2020,95984803,626.78,1,"Today response expert customer. From nearly listen catch politics particularly.
Look expert small focus music benefit without.",23:18:37,NEFT
CXFY99245025482787,GB97FHKC16607677923892,11/26/2015,113.44,100002,Y,Utilities,MI,MOBILE,Dr,18:32:39,23:06:58,5/18/2020,11806912,250.83,7,Kind smile candidate score bar small policy help. Relationship heavy head listen born statement reason. Laugh artist never movie main political.,21:16:52,DD
CXFY99245025482787,GB97FHKC16607677923892,11/26/2015,2095.8,100002,N,Credited,CHROME,PC,Cr,11:39:24,13:27:43,5/19/2020,71961446,1982.36,5,"Reality mention thank strategy.
Rise customer eye range two majority. Fear food on great.",12:41:45,CARDS
CXFY99245025482787,GB97FHKC16607677923892,11/26/2015,113.44,100002,Y,Personal Care,FF,MOBILE,Dr,22:28:47,26:10:07,5/19/2020,63738360,1982.36,7,Maintain grow word ago sit employee meet. Republican ready trade tough election director property both.,23:45:46,DD
CXFY99245025482787,GB97FHKC16607677923892,11/26/2015,341.26,100002,N,Credited,CHROME,POS,Cr,5:03:04,8:06:40,5/21/2020,66978053,227.82,4,Health reduce pass practice. Majority billion forget positive food field.,6:58:11,UPI
CXFY99245025482787,GB97FHKC16607677923892,11/26/2015,113.44,100002,Y,Household Consumables,EDGE,MOBILE,Dr,8:40:28,10:11:26,5/21/2020,19903286,227.82,4,Senior issue already student individual. Nothing market speech ground.,9:20:46,UPI
CXFY99245025482787,GB97FHKC16607677923892,11/26/2015,341.26,100002,N,Credited,CHROME,MOBILE,Cr,14:11:14,15:48:40,5/21/2020,37374051,227.82,7,Serious shake kitchen model involve. Too time owner scientist it build. Worry practice window try job happen lead ever. Address actually sort art environment.,15:09:29,DD
CXFY99245025482787,GB97FHKC16607677923892,11/26/2015,569.08,100002,N,Credited,EDGE,POS,Cr,18:28:43,20:20:37,5/21/2020,35786740,227.82,7,Finally possible so along time challenge. Whatever spend response value standard rate. Career listen better pick purpose consumer.,18:57:00,DD
CXFY99245025482787,GB97FHKC16607677923892,11/26/2015,796.9,100002,N,Credited,CHROME,POS,Cr,18:43:13,21:40:36,5/21/2020,63649772,227.82,4,"Yard after along system good brother charge. By people school hear civil everyone firm.
Choose finish keep special actually. Close ahead situation.",20:13:39,UPI
CXFY99245025482787,GB97FHKC16607677923892,11/26/2015,684.31,100002,Y,Rent,OPERA,POS,Dr,12:27:07,17:26:33,5/23/2020,3281932,112.59,6,"If process a he. Movie stop cold for yet identify year. Tough commercial loss others.
Agent ten pick with response. Serious push stage tree.",15:25:59,CHEQUE
CXFY99245025482787,GB97FHKC16607677923892,11/26/2015,796.9,100002,N,Credited,MI,PC,Cr,15:54:59,19:35:01,5/23/2020,83669026,112.59,5,"Capital defense cost painting with fear. Finish voice then option standard especially yeah. Individual unit kitchen share say.
Just report fact still newspaper own. Sure simple issue tree.",17:06:05,CARDS
CXFY99245025482787,GB97FHKC16607677923892,11/26/2015,2774.84,100002,N,Credited,SAFARI,MOBILE,Cr,7:26:54,9:16:20,5/24/2020,83109386,1977.94,7,Again house source billion. Against involve western laugh always hair resource start. Executive yourself international write.,8:23:59,DD
CXFY99245025482787,GB97FHKC16607677923892,11/26/2015,4752.78,100002,N,Credited,OPERA,PC,Cr,11:03:34,13:33:15,5/24/2020,13294137,1977.94,5,"Hair onto perform listen. Chair enjoy recently since happy play. Painting anyone garden score.
As measure treatment record. Card early beyond I only leave. Choose class tax word tough clearly.",11:36:28,CARDS
CXFY99245025482787,GB97FHKC16607677923892,11/26/2015,6730.72,100002,N,Credited,CHROME,POS,Cr,13:57:26,15:13:42,5/24/2020,72226742,1977.94,1,Career determine then save. Side cold rule task community adult box. Change if ok gun in address.,14:40:13,NEFT
CXFY99245025482787,GB97FHKC16607677923892,11/26/2015,8708.66,100002,N,Credited,OPERA,MOBILE,Cr,19:11:15,21:41:05,5/24/2020,96522004,1977.94,7,"Never be relate how money. Law write top often door. Good wear charge.
Always she daughter both. Son could thank face. Else wind new police.",20:38:17,DD
CXFY99245025482787,GB97FHKC16607677923892,11/26/2015,9325.08,100002,N,Credited,MI,PC,Cr,5:13:15,7:57:39,5/27/2020,18903447,616.42,1,Cover exist building available. Size catch take rich. Claim bit especially century public record hour.,6:00:22,NEFT
CXFY99245025482787,GB97FHKC16607677923892,11/26/2015,8708.66,100002,Y,Entertainment,OPERA,MOBILE,Dr,8:48:02,10:02:37,5/27/2020,48892544,616.42,3,"Development street source position. Increase bit her skill general I.
Citizen surface society. Safe chance stop throw black.
Either produce door Congress security force.",9:29:10,RTGS
CXFY99245025482787,GB97FHKC16607677923892,11/26/2015,9325.08,100002,N,Credited,OPERA,MOBILE,Cr,12:15:49,14:40:51,5/27/2020,49758504,616.42,1,Consumer among trade accept. Under always treat. However bank provide important prevent within main.,12:57:55,NEFT
CXFY99245025482787,GB97FHKC16607677923892,11/26/2015,8708.66,100002,Y,Medicals,MI,MOBILE,Dr,17:37:54,19:26:04,5/27/2020,74243877,616.42,3,"Social million little free marriage section. Actually rate politics cold move vote production.
Daughter already fish just shake change into. Watch recent forward explain everything.",18:32:35,RTGS
CXFY99245025482787,GB97FHKC16607677923892,11/26/2015,8092.24,100002,Y,Online Shopping,SAFARI,PC,Dr,19:23:01,20:37:24,5/27/2020,39320599,616.42,1,"Current smile indicate finally nature leg. Dog those what catch top music southern.
Per fire wonder research education imagine.",20:06:53,NEFT
CXFY99245025482787,GB97FHKC16607677923892,11/26/2015,10020.61,100002,N,Credited,OPERA,MOBILE,Cr,13:23:33,17:10:49,5/28/2020,18413168,1928.37,6,"State truth study tax way range.
Research citizen technology author magazine seven treat away. Republican card traditional yard listen of.",14:50:47,CHEQUE
CXFY99245025482787,GB97FHKC16607677923892,11/26/2015,8092.24,100002,Y,Groceries,FF,PC,Dr,14:59:41,18:49:57,5/28/2020,3549094,1928.37,5,"Character early over federal. Turn give season stock. Such research method keep.
Call may usually law social. Official or practice hand require poor.",17:11:28,CARDS
CXFY99245025482787,GB97FHKC16607677923892,11/26/2015,9814.36,100002,N,Credited,FF,PC,Cr,6:19:35,7:56:17,6/3/2020,12754885,1722.12,5,"Answer social whose good different.
Physical skill pretty environmental.
Month show sure number on item year. Including health form cup attack finally.",7:04:30,CARDS
CXFY99245025482787,GB97FHKC16607677923892,11/26/2015,8092.24,100002,Y,Transportation,OPERA,MOBILE,Dr,7:32:18,9:29:25,6/3/2020,25588071,1722.12,6,Eight effort role media. Film manage hand a charge first data. Direction dinner well send industry thus.,8:40:37,CHEQUE
CXFY99245025482787,GB97FHKC16607677923892,11/26/2015,6370.12,100002,Y,Dining,OPERA,PC,Dr,13:55:29,15:34:06,6/3/2020,2961828,1722.12,6,Media home light wear. Interesting test fast imagine sort partner. Course source sort perhaps research girl wrong prove.,14:32:57,CHEQUE
CXFY99245025482787,GB97FHKC16607677923892,11/26/2015,4648,100002,Y,Insurance,FF,MOBILE,Dr,17:32:31,20:25:15,6/3/2020,71883045,1722.12,1,"Ok research ready participant. Positive look right choose per. Nothing third unit brother everybody.
Message budget former full Mrs. Town front list box. Old with show hospital treatment.",18:35:47,NEFT
CXFY99245025482787,GB97FHKC16607677923892,11/26/2015,2925.88,100002,Y,Utilities,IE,MOBILE,Dr,22:48:44,25:19:10,6/3/2020,55698146,1722.12,7,"Growth build certain available far lead recent. Congress red yeah note keep certainly possible staff.
Book article animal pay nature.",23:39:41,DD
CXFY99245025482787,GB97FHKC16607677923892,11/26/2015,4649.4,100002,N,Credited,MI,PC,Cr,9:07:04,14:38:28,6/5/2020,53235510,1723.52,2,"Door question son race east whole.
Nation impact save fish visit turn capital. City already almost close. Air himself others.",12:20:25,IMPS
CXFY99245025482787,GB97FHKC16607677923892,11/26/2015,2925.88,100002,Y,Transportation,IE,POS,Dr,20:40:09,24:19:47,6/5/2020,35431978,1723.52,1,"Until project poor tough with whole. Government manager treatment indicate. Job artist building bed interest five air.
Deep study current customer. However goal scientist front as front.",22:59:46,NEFT
CXFY99245025482787,GB97FHKC16607677923892,11/26/2015,3376.35,100002,N,Credited,CHROME,MOBILE,Cr,10:09:41,13:48:31,6/11/2020,46151711,450.47,6,"Ask process usually rule. Level leader investment over start mean.
Real Republican black three meet skill. Month yard successful son fly stand. Argue office option move where often.",11:02:12,CHEQUE
CXFY99245025482787,GB97FHKC16607677923892,11/26/2015,2925.88,100002,Y,Personal Care,SAFARI,PC,Dr,21:07:38,26:19:05,6/11/2020,66597223,450.47,1,Language own pay interview still adult foot enjoy. Available within media remember international. Note least man write to if.,23:32:35,NEFT
CXFY99245025482787,GB97FHKC16607677923892,11/26/2015,2451.05,100002,Y,Rent,SAFARI,POS,Dr,12:06:58,17:03:34,6/16/2020,56513059,474.83,7,"Draw style anything purpose. Color factor room each relationship decision high.
Activity behavior interest authority. Amount the detail discussion. Cultural just pass film use.",13:22:38,DD
CXFY99245025482787,GB97FHKC16607677923892,11/26/2015,2925.88,100002,N,Credited,EDGE,MOBILE,Cr,14:06:26,18:33:48,6/16/2020,1390605,474.83,5,Who tonight exactly big me level. Congress sell consider employee begin. Bring federal might talk resource. Themselves strong song least bag degree.,16:56:43,CARDS
CXFY99245025482787,GB97FHKC16607677923892,11/26/2015,1511.34,100002,Y,Medicals,OPERA,MOBILE,Dr,13:20:23,20:03:03,6/17/2020,28294566,1414.54,3,"Identify bring office make water simple. Indicate should several cut impact prevent likely.
Accept lot recently against value safe. Big try assume try total he shake. Development wish fill age.",18:19:37,RTGS
CXFY99245025482787,GB97FHKC16607677923892,11/26/2015,1948.47,100002,N,Credited,IE,MOBILE,Cr,7:00:43,9:46:45,6/21/2020,26757315,437.13,6,"Occur federal ask baby conference cover. Us question piece.
Agreement economy resource his discussion. Act let recognize song. Break half environment would.",8:33:44,CHEQUE
CXFY99245025482787,GB97FHKC16607677923892,11/26/2015,1511.34,100002,Y,Insurance,OPERA,POS,Dr,10:57:15,12:17:53,6/21/2020,50779963,437.13,1,"Nearly mind happy report write create. Shoulder fear involve pass pass.
If offer direction wide least take expert. Eight everything idea again year. Night agree open entire up together.",11:33:45,NEFT
CXFY99245025482787,GB97FHKC16607677923892,11/26/2015,1074.21,100002,Y,Personal Care,MI,PC,Dr,12:55:23,16:47:10,6/21/2020,98404186,437.13,7,Age another quickly film pattern. Majority way form administration authority. Film break which environmental fact letter receive sense.,14:35:08,DD
CXFY99245025482787,GB97FHKC16607677923892,11/26/2015,637.08,100002,Y,Groceries,MI,MOBILE,Dr,21:04:53,22:58:43,6/21/2020,81912711,437.13,2,"Woman apply hold others shake. Feeling morning commercial while.
Ago leg early certainly. Low benefit staff discover life economy next. Watch key yard ahead.",21:51:50,IMPS
CXFY99245025482787,GB97FHKC16607677923892,11/26/2015,1134.52,100002,N,Credited,SAFARI,MOBILE,Cr,10:54:38,20:23:56,6/26/2020,34068373,497.44,1,"Win half life address where left. Various two reflect wish plan name third. Executive responsibility sing.
Source beyond morning charge. Beautiful economic wish reach.",15:51:56,NEFT
CXFY99245025482787,GB97FHKC16607677923892,11/26/2015,1788.26,100002,N,Credited,IE,POS,Cr,11:32:01,16:49:23,6/28/2020,39510471,653.74,3,"Should hit firm fact. Its build you which rich. Beyond step watch tough friend majority sometimes.
Guy later training sit. Indeed make significant.",14:13:54,RTGS
CXFY99245025482787,GB97FHKC16607677923892,11/26/2015,3365.36,100002,N,Credited,CHROME,PC,Cr,6:56:20,10:46:23,7/1/2020,93569002,1577.1,5,"Million government tough glass over development. Might floor black my tough get.
Partner board impact however step. Under picture wish lead right Congress field security. Increase full whether.",9:07:16,CARDS
CXFY99245025482787,GB97FHKC16607677923892,11/26/2015,4942.46,100002,N,Credited,SAFARI,PC,Cr,9:22:54,13:10:22,7/1/2020,30549098,1577.1,2,Important job ok man beautiful listen. Manager although gas thus around upon. Will capital radio model heavy. Will physical professional rather new.,12:02:15,IMPS
CXFY99245025482787,GB97FHKC16607677923892,11/26/2015,3365.36,100002,Y,Medicals,FF,MOBILE,Dr,20:45:12,23:45:17,7/1/2020,3296646,1577.1,1,"Able bill parent difficult create. Government cultural summer risk. Until data light less.
Close enter month design rise call message. Various fear reflect. He use huge health summer spend fight.",22:30:12,NEFT
CXFY99245025482787,GB97FHKC16607677923892,11/26/2015,3702.34,100002,N,Credited,MI,MOBILE,Cr,2:27:00,5:43:30,7/2/2020,70561159,336.98,3,"Cost billion development buy senior.
Such up rest forget ahead. Create save describe month professional. Person yet window PM over ago. Keep use great professor charge car line sing.",4:22:26,RTGS
CXFY99245025482787,GB97FHKC16607677923892,11/26/2015,4039.32,100002,N,Credited,IE,PC,Cr,7:53:29,9:18:08,7/2/2020,43797684,336.98,5,"Floor reach every house thus body serious. Any move foreign theory today test situation.
Pay cover hot suggest news machine. Red early up seem. Gas mean street resource four rule.",8:21:25,CARDS
CXFY99245025482787,GB97FHKC16607677923892,11/26/2015,4376.3,100002,N,Credited,EDGE,MOBILE,Cr,14:47:59,16:30:30,7/2/2020,13289171,336.98,4,"Voice according star point edge wife upon. Board trip finally take price. Environmental leader around seven better. Question off team public.
Raise here else show. Cover once hour data include.",15:33:01,UPI
CXFY99245025482787,GB97FHKC16607677923892,11/26/2015,4039.32,100002,Y,Entertainment,OPERA,MOBILE,Dr,18:32:53,20:29:38,7/2/2020,5297283,336.98,3,Our prove seek ok success century in hope. Join brother again involve source without go. Make since trade perform whatever person. Three before before four bag someone.,19:43:51,RTGS
CXFY99245025482787,GB97FHKC16607677923892,11/26/2015,3702.34,100002,Y,Entertainment,IE,POS,Dr,20:14:19,21:33:30,7/2/2020,82692490,336.98,2,"Simply a authority image box teach itself. Herself discuss common because listen black end.
Stand right four beyond certainly mouth ready. End customer station music answer.",21:04:38,IMPS
CXFY99245025482787,GB97FHKC16607677923892,11/26/2015,5582.08,100002,N,Credited,CHROME,PC,Cr,8:54:42,13:28:30,7/18/2020,77030528,1879.74,1,Have campaign crime future much ten expert. Federal decide successful nearly process black.,11:15:40,NEFT
CXFY99245025482787,GB97FHKC16607677923892,11/26/2015,3702.34,100002,Y,Transportation,OPERA,MOBILE,Dr,20:50:39,25:08:24,7/18/2020,19999708,1879.74,5,Good still civil carry sometimes threat notice. Read continue energy entire. Benefit method right serve Republican though. Team reflect page game tax.,22:22:03,CARDS
CXFY99245025482787,GB97FHKC16607677923892,11/26/2015,2524.48,100002,Y,Entertainment,OPERA,PC,Dr,5:42:22,8:31:12,7/19/2020,60987112,1177.86,5,"Research happen middle turn player cup. Instead say fire line small third Congress growth.
Base these factor through everybody. Fish vote east development lay these prove. Science thus doctor.",6:52:30,CARDS
CXFY99245025482787,GB97FHKC16607677923892,11/26/2015,1346.62,100002,Y,Insurance,IE,POS,Dr,10:58:52,12:24:17,7/19/2020,2391649,1177.86,5,War establish rather state save everything land. Traditional majority over rock. Somebody enjoy raise economic president hard.,11:54:35,CARDS
CXFY99245025482787,GB97FHKC16607677923892,11/26/2015,168.76,100002,Y,Insurance,MI,POS,Dr,14:03:35,16:59:21,7/19/2020,85284258,1177.86,2,"Option run bag amount media address respond. Rate radio cup.
Man nation network summer final method. Parent argue hope else put. Nearly note respond on condition.",15:10:02,IMPS
CXFY99245025482787,GB97FHKC16607677923892,11/26/2015,1346.62,100002,N,Credited,SAFARI,POS,Cr,19:22:01,21:42:24,7/19/2020,8545978,1177.86,7,"Maybe protect local to major set inside. Should prove bar reflect page claim.
Middle reach year hope long. If scene talk owner. Probably minute skin speech.",19:52:55,DD
CXFY99245025482787,GB97FHKC16607677923892,11/26/2015,2524.48,100002,N,Credited,IE,MOBILE,Cr,19:27:52,20:51:04,7/19/2020,34593707,1177.86,4,There room again open senior event weight. Answer necessary attack base still tree sport. Pretty hit give act court new.,20:22:11,UPI
CXFY99245025482787,GB97FHKC16607677923892,11/26/2015,619.17,100002,Y,Dining,MI,PC,Dr,9:21:20,12:11:40,7/25/2020,49034448,1905.31,5,"Training message debate four. Minute better season teach effort.
Data them seek government teach practice care. Week fine guy store. Arrive forward choice itself simple air opportunity.",10:59:32,CARDS
CXFY99245025482787,GB97FHKC16607677923892,11/26/2015,2524.48,100002,N,Credited,FF,MOBILE,Cr,16:24:11,19:12:50,7/25/2020,44859077,1905.31,3,"Carry treatment ability spend above. Thing customer book result computer next miss.
Concern its property chance. Born nothing western. Movement head order leave offer media ability.",17:38:17,RTGS
CXFY99245025482787,GB97FHKC16607677923892,11/26/2015,1843.01,100002,Y,Household Consumables,MI,PC,Dr,20:33:19,25:16:29,8/1/2020,35691495,681.47,1,Matter sound since pick. Want still reflect little magazine. Then wrong box professional carry drug first. Industry while discover box.,22:54:13,NEFT
CXFY99245025482787,GB97FHKC16607677923892,11/26/2015,1901.61,100002,N,Credited,CHROME,MOBILE,Cr,15:55:23,22:34:25,8/14/2020,34103616,58.6,2,Ahead expert lead business seven Mr strong. Opportunity manage two visit eight. Live recent history. Section nor figure front else line race.,17:37:08,IMPS
CXFY99245025482787,GB97FHKC16607677923892,11/26/2015,1561.67,100002,Y,Dining,MI,MOBILE,Dr,20:28:17,24:43:00,8/15/2020,15487346,339.94,7,"Team easy school move research certainly because. Laugh capital green leave medical oil smile.
Event as whom save administration wrong.",22:06:58,DD
CXFY99245025482787,GB97FHKC16607677923892,11/26/2015,1730.92,100002,N,Credited,IE,MOBILE,Cr,2:38:43,5:54:05,8/19/2020,31977630,169.25,7,"Power stage two picture future with can money. Just where fund story. Physical front set discover. Suddenly quickly then over.
Draw if computer project crime social. Myself hear north TV.",4:17:15,DD
CXFY99245025482787,GB97FHKC16607677923892,11/26/2015,1561.67,100002,Y,Insurance,MI,PC,Dr,11:22:56,12:38:41,8/19/2020,37225865,169.25,3,"Democratic skill cup environmental threat. Race image threat his require.
Bed indeed million worker unit speak significant. Tough maybe budget glass.",11:54:25,RTGS
CXFY99245025482787,GB97FHKC16607677923892,11/26/2015,1730.92,100002,N,Credited,MI,MOBILE,Cr,12:23:41,16:00:57,8/19/2020,2814933,169.25,2,"Boy plan require lead. Think cold call record foreign paper unit.
Pattern board care when paper table. Quite mean never ready. Force necessary several sell community.",14:05:55,IMPS
CXFY99245025482787,GB97FHKC16607677923892,11/26/2015,1900.17,100002,N,Credited,EDGE,PC,Cr,15:21:40,17:10:38,8/19/2020,86199414,169.25,1,"Step rest quite stay hot officer able hear. Training role training tell writer sit.
She run myself yeah. National sense anyone stay bag both evening. Lot cultural three forget mouth evening employee.",16:29:44,NEFT
CXFY99245025482787,GB97FHKC16607677923892,11/26/2015,1730.92,100002,Y,Online Shopping,IE,POS,Dr,21:54:08,23:54:59,8/19/2020,98027736,169.25,4,"Simple may reason run watch half movement.
Blue moment soon traditional what trouble. Research her just store do pay wait.",22:58:24,UPI
CXFY99245025482787,GB97FHKC16607677923892,11/26/2015,1106.12,100002,Y,Medicals,IE,PC,Dr,6:16:20,9:18:07,8/24/2020,56092400,624.8,4,Today board west sense individual important west. Control ability too where capital executive. Institution dinner plant despite cell.,7:26:09,UPI
CXFY99245025482787,GB97FHKC16607677923892,11/26/2015,1730.92,100002,N,Credited,EDGE,MOBILE,Cr,11:25:08,13:15:27,8/24/2020,14990793,624.8,2,"Billion behavior at marriage. Present lot buy before fly coach next. Control fly might fear wall coach nothing.
Hard suggest long local son large rock. Do owner office do reflect along.",12:34:54,IMPS
CXFY99245025482787,GB97FHKC16607677923892,11/26/2015,1106.12,100002,Y,Groceries,OPERA,MOBILE,Dr,13:36:34,15:13:44,8/24/2020,56039870,624.8,7,"Most win herself month. Create meeting argue land.
Evidence brother citizen who born avoid. Plant he learn trip skill several major. Detail adult himself.",14:33:19,DD
CXFY99245025482787,GB97FHKC16607677923892,11/26/2015,481.32,100002,Y,Insurance,MI,MOBILE,Dr,20:36:51,23:41:35,8/24/2020,54565227,624.8,5,"Away use where moment agent career. Statement have another partner thus. Development citizen join away mean.
Put discover office. Down state data us far. Live call understand.",22:26:07,CARDS
CXFY99245025482787,GB97FHKC16607677923892,11/26/2015,198.08,100002,Y,Dining,MI,MOBILE,Dr,7:10:12,16:23:33,8/26/2020,4136293,283.24,7,"Letter effect miss agree right notice probably court. Federal full white situation company trip.
Without hospital direction medical might red. Take important quite blue.",13:01:40,DD
CXFY99245025482787,GB97FHKC16607677923892,11/26/2015,1717.1,100002,N,Credited,CHROME,PC,Cr,4:48:59,8:03:04,9/13/2020,89287064,1519.02,1,"Manager people create every smile. Describe choose do budget.
Real sell shake interest personal police. Third hospital resource seek. Parent market sing own himself instead wind east.",7:05:50,NEFT
CXFY99245025482787,GB97FHKC16607677923892,11/26/2015,3236.12,100002,N,Credited,EDGE,POS,Cr,12:51:12,14:53:29,9/13/2020,97090236,1519.02,6,Activity rather subject note. Involve house five speech generation market despite season. Thousand chair area activity court make. Cup deep measure red discussion fall difference important.,14:17:58,CHEQUE
CXFY99245025482787,GB97FHKC16607677923892,11/26/2015,4755.14,100002,N,Credited,CHROME,POS,Cr,14:17:21,18:46:46,9/13/2020,1646887,1519.02,3,"Admit high security least free majority.
Cost huge few less. All agree news war yourself analysis real.
Admit carry ever appear. Hour Mr rest miss lot.",16:23:38,RTGS
CXFY99245025482787,GB97FHKC16607677923892,11/26/2015,6274.16,100002,N,Credited,SAFARI,POS,Cr,17:26:03,21:17:23,9/13/2020,9454705,1519.02,4,Commercial summer behavior behavior generation usually. Voice low exist event.,19:12:34,UPI
CXFY99245025482787,GB97FHKC16607677923892,11/26/2015,6685.43,100002,N,Credited,EDGE,PC,Cr,9:05:21,13:35:30,10/14/2020,49047547,411.27,1,Politics forward never century individual record. Plant property executive true option theory upon. Company remember clearly glass eight model.,11:15:01,NEFT
CXFY99245025482787,GB97FHKC16607677923892,11/26/2015,7096.7,100002,N,Credited,CHROME,POS,Cr,10:24:04,14:28:08,10/14/2020,80561248,411.27,6,"Eye college plant green. Executive something series choose several discussion.
Its far interesting. Style his after coach subject fish name. Structure matter stuff true.",12:13:39,CHEQUE
CXFY99245025482787,GB97FHKC16607677923892,11/26/2015,6685.43,100002,Y,Medicals,FF,MOBILE,Dr,16:38:13,19:53:11,10/14/2020,59343660,411.27,7,"Last real they your show key lawyer. Entire address both group above candidate green.
Class seem care. Challenge official specific scene nature through. Produce particularly assume trip cold land.",18:42:25,DD
CXFY99245025482787,GB97FHKC16607677923892,11/26/2015,8661.8,100002,N,Credited,MI,POS,Cr,5:42:39,7:38:11,10/19/2020,97765318,1976.37,3,"Minute product couple son. Various environment factor same job allow loss. Student card owner.
Interesting animal language heavy add watch quickly.",6:37:46,RTGS
CXFY99245025482787,GB97FHKC16607677923892,11/26/2015,6685.43,100002,Y,Dining,SAFARI,POS,Dr,13:04:06,16:20:21,10/19/2020,82066031,1976.37,3,Purpose difference last girl child. Grow make establish matter. Yet degree brother sort change others health.,14:06:29,RTGS
CXFY99245025482787,GB97FHKC16607677923892,11/26/2015,8661.8,100002,N,Credited,MI,MOBILE,Cr,14:10:24,17:06:38,10/19/2020,27985816,1976.37,7,"Ten so board deep bank Congress. Keep assume necessary task. Key role threat social sister.
Vote her the movement or trip. Statement authority according cause manage well poor.",15:01:29,DD
CXFY99245025482787,GB97FHKC16607677923892,11/26/2015,6685.43,100002,Y,Entertainment,IE,POS,Dr,20:47:05,22:54:02,10/19/2020,89437186,1976.37,7,Add look contain heavy. Might condition sign art identify. Discussion power movement your say politics indicate.,22:11:24,DD
CXFY99245025482787,GB97FHKC16607677923892,11/26/2015,6934.66,100002,N,Credited,IE,POS,Cr,8:09:21,15:31:57,10/21/2020,59757542,249.23,4,"Project education small. Of imagine young leader clear themselves.
Money must for family compare large window. Nearly never option meeting reason everything. Education spring free eye.",11:40:31,UPI
CXFY99245025482787,GB97FHKC16607677923892,11/26/2015,7183.89,100002,N,Credited,EDGE,MOBILE,Cr,19:20:19,22:56:40,10/21/2020,95068527,249.23,1,"Up single dream institution during tree. With answer offer act commercial.
Office consumer study. Perform sense recognize member night. Person source travel few out star. Cold after continue scene.",22:07:43,NEFT
CXFY99245025482787,GB97FHKC16607677923892,11/26/2015,8127.31,100002,N,Credited,EDGE,PC,Cr,15:24:29,23:33:36,10/26/2020,86676076,943.42,5,"Cold product top light three sell. Will north fact music perform policy. Write scientist laugh buy agency hear.
Class cause property interesting also against charge. Hold pressure score between.",21:14:22,CARDS
CXFY99245025482787,GB97FHKC16607677923892,11/26/2015,6863.93,100002,Y,Transportation,SAFARI,PC,Dr,13:18:43,17:18:54,11/1/2020,25613483,1263.38,3,"Act state court do. Sometimes enter pay community.
Clearly may moment one. Fly region raise cold. House six girl meet.",15:44:31,RTGS
CXFY99245025482787,GB97FHKC16607677923892,11/26/2015,5600.55,100002,Y,Personal Care,FF,MOBILE,Dr,21:40:08,26:46:58,11/1/2020,38117442,1263.38,2,"Could dark despite change home.
Her role establish. Leg language prevent fight find property often cup. Worry everybody event response.",22:59:11,IMPS
CXFY99245025482787,GB97FHKC16607677923892,11/26/2015,5508.8,100002,Y,Dining,SAFARI,PC,Dr,10:57:46,13:52:20,11/4/2020,92509023,91.75,4,"Mind serve try doctor already Congress. Put response stuff eight effect smile or. Possible small my almost describe.
Woman on Democrat especially. Eight piece their.",11:47:18,UPI
CXFY99245025482787,GB97FHKC16607677923892,11/26/2015,5417.05,100002,Y,Medicals,OPERA,MOBILE,Dr,10:43:57,14:19:20,11/4/2020,2553733,91.75,7,"Bad voice now there resource nearly because. Television our interview show easy part present.
Government my mouth weight body difference it. Tend really realize family stop. Might nearly simply.",12:06:04,DD
CXFY99245025482787,GB97FHKC16607677923892,11/26/2015,5325.3,100002,Y,Household Consumables,OPERA,PC,Dr,17:43:13,20:14:00,11/4/2020,92264984,91.75,7,"Bank save lay policy woman. Power plan hear main teacher. Understand operation sell it order name statement.
System cell thousand. Seat where body use political do.",19:18:45,DD
CXFY99245025482787,GB97FHKC16607677923892,11/26/2015,4356.19,100002,Y,Utilities,CHROME,MOBILE,Dr,12:25:28,14:48:04,11/14/2020,33120881,969.11,7,"Save treat some when new board. Cover value I. Financial issue fire morning necessary plant stand size.
Surface while necessary audience everything.",13:18:10,DD
CXFY99245025482787,GB97FHKC16607677923892,11/26/2015,3387.08,100002,Y,Household Consumables,EDGE,POS,Dr,18:38:09,22:04:04,11/14/2020,8901811,969.11,1,Business beyond special commercial task leg decision. None boy understand Democrat society station. Sell scene page turn suddenly.,19:48:51,NEFT
CXFY99245025482787,GB97FHKC16607677923892,11/26/2015,4339.03,100002,N,Credited,SAFARI,PC,Cr,16:47:13,22:11:23,11/15/2020,68378264,951.95,1,Project hope writer attorney political sister prove. Tough teach president action establish then material certainly. General hold table.,20:22:08,NEFT
CXFY99245025482787,GB97FHKC16607677923892,11/26/2015,2739.72,100002,Y,Personal Care,EDGE,MOBILE,Dr,16:31:35,24:17:27,11/18/2020,81228348,1599.31,3,"Institution measure beat commercial discuss. According truth body. More around wait check guy would.
Feeling scene reality church. Reach child up idea wrong.",20:32:07,RTGS
CXFY99245025482787,GB97FHKC16607677923892,11/26/2015,2159.72,100002,Y,Dining,OPERA,PC,Dr,3:03:26,5:29:30,11/24/2020,12651344,580,2,"Against statement least their information born measure. Case from this certain international hand support. Person capital return public.
Whom staff report almost attack. Daughter course sense out.",4:38:52,IMPS
CXFY99245025482787,GB97FHKC16607677923892,11/26/2015,1579.72,100002,Y,Transportation,CHROME,MOBILE,Dr,8:08:01,9:55:34,11/24/2020,1596441,580,3,"Record their east garden. Offer scene lead same pay.
Amount should international international direction mission hair. Establish number expert accept. Foreign get two hundred set cost.",9:01:41,RTGS
CXFY99245025482787,GB97FHKC16607677923892,11/26/2015,2159.72,100002,N,Credited,OPERA,POS,Cr,12:16:02,13:48:00,11/24/2020,74033287,580,7,"Bar such imagine hour identify. Ground while above travel cup.
Listen community film. Likely also approach professor modern short.",12:48:30,DD
CXFY99245025482787,GB97FHKC16607677923892,11/26/2015,2739.72,100002,N,Credited,MI,POS,Cr,14:58:32,17:10:31,11/24/2020,58265130,580,7,"Usually fire blue point population appear figure. Produce say agency into four movement play.
Speech which entire great.",16:03:03,DD
CXFY99245025482787,GB97FHKC16607677923892,11/26/2015,3319.72,100002,N,Credited,FF,POS,Cr,19:48:41,22:45:30,11/24/2020,88068251,580,5,"Conference why memory safe address. Take perhaps lay national. When a appear thought.
Training week check tax. Billion surface according first way wrong he.",21:48:03,CARDS
CXFY99245025482787,GB97FHKC16607677923892,11/26/2015,2816.83,100002,Y,Medicals,OPERA,PC,Dr,8:20:53,10:51:17,11/25/2020,20842918,502.89,3,"Continue attention impact four may situation. South decade marriage hospital sell south magazine.
Nice day certain operation strategy free effect hour.",9:27:09,RTGS
CXFY99245025482787,GB97FHKC16607677923892,11/26/2015,3319.72,100002,N,Credited,SAFARI,MOBILE,Cr,12:20:52,17:09:32,11/25/2020,17957878,502.89,6,"Sense system reach manager always accept product. Those long point into coach add heart.
Word necessary director. Inside never before bad from grow owner. Power mind apply citizen member popular.",15:17:31,CHEQUE
CXFY99245025482787,GB97FHKC16607677923892,11/26/2015,3822.61,100002,N,Credited,FF,PC,Cr,18:18:26,19:34:56,11/25/2020,30187528,502.89,2,"Sound already war put. Likely year have ground always. Ten mean own weight evening with.
Group a have including glass physical. Chair sort record learn.",18:56:17,IMPS
CXFY99245025482787,GB97FHKC16607677923892,11/26/2015,4231.98,100002,N,Credited,IE,POS,Cr,5:13:42,7:43:02,11/30/2020,16249912,409.37,5,"Big theory realize house fly woman. Decade dog thus without prepare opportunity even.
Week crime base card good many. Whom figure six.",7:02:07,CARDS
CXFY99245025482787,GB97FHKC16607677923892,11/26/2015,4641.35,100002,N,Credited,CHROME,PC,Cr,9:14:20,10:18:16,11/30/2020,91593283,409.37,2,"Face analysis generation writer customer record image dog. Majority ok before travel approach nice.
Protect new baby natural reach.",9:46:54,IMPS
CXFY99245025482787,GB97FHKC16607677923892,11/26/2015,5050.72,100002,N,Credited,OPERA,POS,Cr,16:52:58,19:53:27,11/30/2020,60842756,409.37,3,Better grow itself data daughter per. Toward spend condition enjoy interesting. Wish action focus be recently such. Us worker second act since ball sport film.,17:52:01,RTGS
CXFY99245025482787,GB97FHKC16607677923892,11/26/2015,4641.35,100002,Y,Dining,SAFARI,PC,Dr,21:40:20,24:45:12,11/30/2020,41812549,409.37,3,"Save matter improve state place. Prove positive seven study prepare.
Away center exist drive tough. Doctor know late at exactly pressure. Visit never material why day.",23:11:15,RTGS
CXFY99245025482787,GB97FHKC16607677923892,11/26/2015,3752.08,100002,Y,Personal Care,SAFARI,POS,Dr,9:04:33,13:43:07,12/6/2020,96373224,889.27,5,"Oil daughter look get no foreign spend camera. Everyone check spend black plan among.
Recognize lot practice door popular probably image. Security late baby. Phone fight position if him.",12:49:28,CARDS
CXFY99245025482787,GB97FHKC16607677923892,11/26/2015,4641.35,100002,N,Credited,IE,POS,Cr,18:25:31,22:02:49,12/6/2020,80192190,889.27,2,"Special go like understand prevent effort.
Boy also rule week stay dog yeah per. Water his these follow down himself our. With exist level. Sign discover sister field.",20:36:51,IMPS
CXFY99245025482787,GB97FHKC16607677923892,11/26/2015,6283.9,100002,N,Credited,SAFARI,MOBILE,Cr,6:59:29,10:02:51,12/9/2020,21002649,1642.55,6,"Not smile ball purpose. Quality investment west.
Tell their prove speech their. Table example process individual any piece.",8:39:39,CHEQUE
CXFY99245025482787,GB97FHKC16607677923892,11/26/2015,4641.35,100002,Y,Dining,SAFARI,PC,Dr,13:03:56,16:20:23,12/9/2020,73843467,1642.55,2,Article various shake inside prove positive social past. Base listen among although change international indeed tend. Talk herself serious purpose.,15:04:43,IMPS
CXFY99245025482787,GB97FHKC16607677923892,11/26/2015,2998.8,100002,Y,Transportation,EDGE,MOBILE,Dr,17:19:00,22:12:49,12/9/2020,12245697,1642.55,6,Father message blood bank. No light onto. Character cause since but sea popular. Ability market century knowledge drug effort.,20:12:25,CHEQUE
CXFY99245025482787,GB97FHKC16607677923892,11/26/2015,2339.17,100002,Y,Rent,IE,PC,Dr,18:12:48,28:07:19,12/13/2020,42690894,659.63,3,"Ready black site door pay less site. Public leader after than forward partner increase.
Offer turn pick surface great wide statement. Network southern evidence hope.",22:29:36,RTGS
CXFY99245025482787,GB97FHKC16607677923892,11/26/2015,2523.86,100002,N,Credited,CHROME,MOBILE,Cr,8:34:51,11:46:29,12/18/2020,69709029,184.69,4,Ball discover health try sit American. Wife while herself program sport rest.,10:17:32,UPI
CXFY99245025482787,GB97FHKC16607677923892,11/26/2015,2708.55,100002,N,Credited,MI,POS,Cr,10:43:20,15:19:59,12/18/2020,70966077,184.69,2,"Interest north possible leg no. Nothing more sure involve check. Military else force music.
Step toward ability. Today should foot police. Become wife your authority fish affect.",13:19:51,IMPS
CXFY99245025482787,GB97FHKC16607677923892,11/26/2015,2523.86,100002,Y,Medicals,FF,PC,Dr,17:20:30,20:14:41,12/18/2020,97789598,184.69,5,"Great treatment here task fire ask just. Skin mother interesting finish develop.
Fact physical summer million. Majority author consumer explain at whole. Easy trouble condition seek.",18:13:38,CARDS
CXFY99245025482787,GB97FHKC16607677923892,11/26/2015,3611.47,100002,N,Credited,OPERA,POS,Cr,17:11:45,23:40:05,12/25/2020,68277697,1087.61,6,"Recognize office girl good start near. Prove part it kitchen.
Weight wife institution eight recent chance couple. Service many thank chance. Glass environment once.",21:26:32,CHEQUE
CXFY99245025482787,GB97FHKC16607677923892,11/26/2015,2506.38,100002,Y,Household Consumables,CHROME,PC,Dr,5:15:00,7:11:08,12/26/2020,17404815,1105.09,5,Low probably serve home their soldier anything. Sea agree hotel language serve adult tough.,6:07:58,CARDS
CXFY99245025482787,GB97FHKC16607677923892,11/26/2015,1401.29,100002,Y,Medicals,EDGE,POS,Dr,7:29:54,8:45:57,12/26/2020,23096448,1105.09,5,"Herself meet recognize enter pick. Marriage land edge whatever moment commercial. Mouth might study hundred.
Off star adult put bar lead. Thank majority bit animal common.",8:06:42,CARDS
CXFY99245025482787,GB97FHKC16607677923892,11/26/2015,2506.38,100002,N,Credited,FF,MOBILE,Cr,14:57:39,17:12:23,12/26/2020,69699344,1105.09,3,"Minute he policy yourself his already development. Student follow leave appear third lay world more.
Gun deep actually science compare number. Your customer decide seem so our shoulder.",15:33:33,RTGS
CXFY99245025482787,GB97FHKC16607677923892,11/26/2015,3611.47,100002,N,Credited,IE,PC,Cr,18:59:37,20:20:50,12/26/2020,49154443,1105.09,5,"Begin force ball gas know analysis easy than. Office traditional money see. Civil success foot.
Trip follow recently. Available around fill. Stand voice national born actually.",19:31:54,CARDS
CXFY99245025482787,GB97FHKC16607677923892,11/26/2015,4716.56,100002,N,Credited,IE,POS,Cr,20:14:44,23:15:52,12/26/2020,31694384,1105.09,1,"Improve star world adult. Very let deal discussion century.
Nor develop check else wife participant move. No happy travel conference.",21:22:46,NEFT
CXFY99245025482787,GB97FHKC16607677923892,11/26/2015,5367.31,100002,N,Credited,SAFARI,MOBILE,Cr,7:15:21,8:49:46,1/5/2021,13211950,650.75,6,Word federal should thousand as sound meet. Song attention difference scientist weight never. Two over various capital.,7:51:06,CHEQUE
CXFY99245025482787,GB97FHKC16607677923892,11/26/2015,4716.56,100002,Y,Insurance,SAFARI,POS,Dr,11:19:02,14:28:38,1/5/2021,14844508,650.75,1,"Stock woman knowledge war. Back wide modern treatment peace. Business cell final.
Much of to job study. Performance organization develop yourself baby buy institution alone.",12:50:36,NEFT
CXFY99245025482787,GB97FHKC16607677923892,11/26/2015,4065.81,100002,Y,Medicals,MI,POS,Dr,13:22:31,17:27:59,1/5/2021,58897362,650.75,1,War worker station new stay again. Toward want section role over laugh. Those cup cut certain character take citizen.,15:17:06,NEFT
CXFY99245025482787,GB97FHKC16607677923892,11/26/2015,4716.56,100002,N,Credited,MI,POS,Cr,18:54:58,20:47:24,1/5/2021,61346192,650.75,3,"Memory think finally throughout rest cost clear.
Past authority recently fall. Set individual each effort difference choice.",19:57:23,RTGS
CXFY99245025482787,GB97FHKC16607677923892,11/26/2015,5115.84,100002,N,Credited,MI,POS,Cr,6:25:50,9:47:36,1/6/2021,19524566,399.28,2,"Watch owner million total artist place rest. Keep push attorney feeling majority set.
Necessary friend plant quality in. Vote generation suffer.
Nor give seem type clear. Ago stand more second.",7:52:20,IMPS
CXFY99245025482787,GB97FHKC16607677923892,11/26/2015,4716.56,100002,Y,Online Shopping,EDGE,POS,Dr,9:02:15,10:32:28,1/6/2021,27107140,399.28,4,"Tend plan help industry itself activity.
Be price present event. Girl result dark factor.",9:48:34,UPI
CXFY99245025482787,GB97FHKC16607677923892,11/26/2015,4317.28,100002,Y,Groceries,SAFARI,MOBILE,Dr,11:02:29,12:54:44,1/6/2021,16209510,399.28,5,"Grow begin enter. Budget value impact property. Art suffer nice foreign behind.
Tonight surface operation coach enough parent. Focus thing catch.",12:28:30,CARDS
CXFY99245025482787,GB97FHKC16607677923892,11/26/2015,4716.56,100002,N,Credited,IE,PC,Cr,14:22:21,17:16:05,1/6/2021,36269372,399.28,2,"Someone analysis future three. Time success run increase.
State fight ten inside cover. Safe indicate name good red mouth sort. Firm war film loss pay.",16:15:22,IMPS
CXFY99245025482787,GB97FHKC16607677923892,11/26/2015,5115.84,100002,N,Credited,MI,PC,Cr,22:23:56,24:37:16,1/6/2021,18968033,399.28,3,"Daughter now trouble begin reach. Street each attention social study wall.
General it finish unit draw.
Often answer ask energy make somebody agree themselves.",23:08:30,RTGS
CXFY99245025482787,GB97FHKC16607677923892,11/26/2015,5837.55,100002,N,Credited,SAFARI,POS,Cr,7:03:00,10:36:22,1/11/2021,77808028,721.71,7,Kind interview possible use teacher successful although we. Republican simple present several whose bring. Kind on here those policy. Should single training fill property majority.,8:13:58,DD
CXFY99245025482787,GB97FHKC16607677923892,11/26/2015,6559.26,100002,N,Credited,IE,MOBILE,Cr,10:44:52,15:02:14,1/11/2021,42666509,721.71,2,Parent increase participant reveal thus despite hot lawyer. Mission energy boy difficult food whether policy. Food interview someone nearly. Send common all general today natural.,12:47:20,IMPS
CXFY99245025482787,GB97FHKC16607677923892,11/26/2015,7280.97,100002,N,Credited,IE,PC,Cr,22:13:49,25:35:40,1/11/2021,45622359,721.71,2,Culture debate determine. Stage part respond catch various condition alone. Task house us officer player only.,23:16:24,IMPS
CXFY99245025482787,GB97FHKC16607677923892,11/26/2015,8015.31,100002,N,Credited,FF,PC,Cr,6:32:03,9:50:16,1/12/2021,67020713,734.34,7,"Third wrong food step organization vote race. Sit recently first follow ability question.
Ability out business citizen fast important. Purpose above ago fall thought.",8:30:51,DD
CXFY99245025482787,GB97FHKC16607677923892,11/26/2015,8749.65,100002,N,Credited,OPERA,PC,Cr,8:26:53,11:38:19,1/12/2021,22259646,734.34,7,Cost management lose back play shake front. May prove character left special party. Follow agency author pattern force tax speech.,10:27:10,DD
CXFY99245025482787,GB97FHKC16607677923892,11/26/2015,9483.99,100002,N,Credited,MI,POS,Cr,18:15:41,20:49:11,1/12/2021,52496622,734.34,7,"Fear give technology expect seek. History section fine.
Agreement back why. Current prepare style would strong.",19:04:53,DD
CXFY99245025482787,GB97FHKC16607677923892,11/26/2015,8749.65,100002,Y,Insurance,OPERA,MOBILE,Dr,22:50:41,25:55:08,1/12/2021,65188101,734.34,6,"Girl different likely talk. Game age way.
At politics quickly decision should possible how. Full should cost history party early. Fast center rule up.",23:57:07,CHEQUE
CXFY99245025482787,GB97FHKC16607677923892,11/26/2015,9205.93,100002,N,Credited,OPERA,POS,Cr,5:15:51,7:57:16,1/19/2021,60605924,456.28,7,"Understand production I team. Night learn want pretty face.
Born step place bed effect enjoy. Turn admit police maintain experience age central future. Miss four manager hand.",6:16:40,DD
CXFY99245025482787,GB97FHKC16607677923892,11/26/2015,8749.65,100002,Y,Household Consumables,FF,PC,Dr,6:14:49,9:59:58,1/19/2021,17348676,456.28,5,"Country single group. Seem maintain power.
Coach material type behind tough. Yeah theory position soon somebody. Current none group big.",8:05:51,CARDS
CXFY99245025482787,GB97FHKC16607677923892,11/26/2015,9205.93,100002,N,Credited,SAFARI,MOBILE,Cr,12:02:00,13:13:49,1/19/2021,22666413,456.28,2,"Represent interview create month course. Writer real sing visit environment.
Blood individual travel walk network because. Sign together action world pressure shake individual.",12:49:46,IMPS
CXFY99245025482787,GB97FHKC16607677923892,11/26/2015,9662.21,100002,N,Credited,EDGE,POS,Cr,17:05:26,19:26:03,1/19/2021,10069097,456.28,7,"Safe while firm process large. Raise leader card.
Sing level just room add direction stock. Difference face rise real television space. Leave room compare opportunity modern since.",18:46:36,DD
CXFY99245025482787,GB97FHKC16607677923892,11/26/2015,10118.49,100002,N,Credited,SAFARI,MOBILE,Cr,22:00:07,24:19:13,1/19/2021,69130090,456.28,5,"Fine decision voice seek us impact. Through of simple campaign hospital new often.
Teach safe even style. Foot population however reduce special focus modern.",22:34:30,CARDS
CXFY99245025482787,GB97FHKC16607677923892,11/26/2015,9823.71,100002,Y,Rent,SAFARI,PC,Dr,4:43:33,6:37:30,1/26/2021,28693147,294.78,1,"Ball though central scientist billion husband number. Act staff group garden cultural.
Have enjoy past. Ready officer building week arrive spend former. Carry staff myself street college.",5:30:43,NEFT
CXFY99245025482787,GB97FHKC16607677923892,11/26/2015,10118.49,100002,N,Credited,IE,POS,Cr,8:59:03,11:36:45,1/26/2021,68977191,294.78,6,"Guess choice focus serious subject between onto. One statement reason.
Herself must art would. Discover each this various. Usually ground bag.",10:11:45,CHEQUE
CXFY99245025482787,GB97FHKC16607677923892,11/26/2015,10413.27,100002,N,Credited,IE,POS,Cr,12:01:46,15:30:31,1/26/2021,15887443,294.78,1,Reality somebody college race job idea fish. Likely teach difference yes generation tree beyond.,13:54:12,NEFT
CXFY99245025482787,GB97FHKC16607677923892,11/26/2015,10708.05,100002,N,Credited,IE,POS,Cr,15:21:32,19:05:20,1/26/2021,66941095,294.78,1,"Realize write clear put light discover than. Organization machine bad go talk.
Sometimes bag his hour hope remain. Close space Congress shoulder.",17:11:04,NEFT
CXFY99245025482787,GB97FHKC16607677923892,11/26/2015,10413.27,100002,Y,Medicals,SAFARI,POS,Dr,19:33:42,21:38:05,1/26/2021,47598355,294.78,5,"Government law get defense. Age system ask key explain series difficult live.
Short player society music performance father. Either spend assume data Congress but position.",21:02:00,CARDS
CXFY99245025482787,GB97FHKC16607677923892,11/26/2015,8936.6,100002,Y,Rent,MI,MOBILE,Dr,6:23:11,9:20:28,2/15/2021,86629089,1476.67,7,"Ten thousand write. Outside heavy message them measure eye hope.
Increase large statement page. Music somebody effort tax. Recently month note perform senior. Use dog occur agreement start college.",7:47:32,DD
CXFY99245025482787,GB97FHKC16607677923892,11/26/2015,7459.93,100002,Y,Rent,IE,POS,Dr,10:54:41,13:27:31,2/15/2021,7103957,1476.67,3,"Shoulder candidate difficult west. Bag beautiful consider vote. Down high we early.
Environment so his speak record. Notice base campaign foreign beautiful. Type face relate call reduce.",11:41:19,RTGS
CXFY99245025482787,GB97FHKC16607677923892,11/26/2015,5983.26,100002,Y,Personal Care,EDGE,PC,Dr,13:55:29,15:21:30,2/15/2021,63536416,1476.67,2,"Respond position detail reason. Choose employee pull company. Image education could century professional family.
Technology especially different stock. Room understand mouth young.",14:52:54,IMPS
CXFY99245025482787,GB97FHKC16607677923892,11/26/2015,4506.59,100002,Y,Utilities,OPERA,POS,Dr,16:35:20,19:31:15,2/15/2021,71825335,1476.67,4,Art and yard get lawyer wife town. Service cost leave true morning the according. Throughout defense method myself.,18:32:26,UPI
CXFY99245025482787,GB97FHKC16607677923892,11/26/2015,3029.92,100002,Y,Insurance,IE,POS,Dr,20:46:14,23:14:46,2/15/2021,92712300,1476.67,7,Financial into assume rock moment specific program later. Movie environmental future eat time into toward.,21:43:12,DD
CXFY99245025482787,GB97FHKC16607677923892,11/26/2015,2418.45,100002,Y,Medicals,FF,POS,Dr,7:29:10,10:16:02,2/18/2021,13059477,611.47,2,"Research task much doctor. Special me much turn student note. Toward line memory public according on report.
Hold throw eye full game student bar. By finish some organization.",9:25:47,IMPS
CXFY99245025482787,GB97FHKC16607677923892,11/26/2015,1806.98,100002,Y,Rent,EDGE,PC,Dr,22:08:16,27:10:21,2/18/2021,3616314,611.47,7,"Never between employee treatment group camera middle. Parent compare become interest assume conference tend.
Chance report company lay. Culture later remain certainly care wear together director.",23:48:16,DD
CXFY99245025482787,GB97FHKC16607677923892,11/26/2015,3540.92,100002,N,Credited,IE,PC,Cr,7:01:55,9:52:48,2/19/2021,7894466,1733.94,1,Effort maintain position place human institution dark. West front these notice recognize. Policy wear south strategy look difference collection.,7:46:48,NEFT
CXFY99245025482787,GB97FHKC16607677923892,11/26/2015,1806.98,100002,Y,Online Shopping,MI,PC,Dr,11:47:05,14:25:29,2/19/2021,98606610,1733.94,7,Tax where but out arrive radio black quite. Almost whom star bill commercial. Make detail rule before job.,13:08:53,DD
CXFY99245025482787,GB97FHKC16607677923892,11/26/2015,73.04,100002,Y,Utilities,FF,MOBILE,Dr,17:52:55,19:40:07,2/19/2021,22154583,1733.94,4,"Deal different today sport.
South price statement action assume else just position. Control sort growth fine sure. Degree ago but best assume lot.",18:51:21,UPI
CXFY99245025482787,GB97FHKC16607677923892,11/26/2015,1172.24,100002,N,Credited,MI,POS,Cr,8:37:31,10:32:54,2/23/2021,10598825,1099.2,6,Heavy design compare perform speech system. Challenge situation vote how smile. Wait describe small score data base even. Adult read focus offer result economic.,10:03:14,CHEQUE
CXFY99245025482787,GB97FHKC16607677923892,11/26/2015,73.04,100002,Y,Groceries,CHROME,MOBILE,Dr,12:12:16,15:49:31,2/23/2021,97513834,1099.2,5,"Add defense seem culture glass reflect pattern. Region nor must pretty news face science.
Big father win idea. Office stop decision whose sit.",14:04:52,CARDS
CXFY99245025482787,GB97FHKC16607677923892,11/26/2015,1172.24,100002,N,Credited,MI,POS,Cr,19:12:25,22:00:28,2/23/2021,62498494,1099.2,2,"Point else expect although remain water house. Provide need teacher course final per feeling. View TV land able stay.
Staff why wear. Economy energy get.",20:39:13,IMPS
CXFY99245025482787,GB97FHKC16607677923892,11/26/2015,820.51,100002,Y,Household Consumables,EDGE,POS,Dr,2:40:51,4:37:17,3/5/2021,39870599,351.73,7,"Management history large. Start near door question follow deal way card.
Send as wide keep official. Mean reflect model understand. Quality among Mr bag opportunity everything woman.",4:08:18,DD
CXFY99245025482787,GB97FHKC16607677923892,11/26/2015,1172.24,100002,N,Credited,IE,POS,Cr,8:50:44,10:41:24,3/5/2021,26236179,351.73,7,"Lay voice professor because world medical to. Or high sure light prevent agency stay. Ago picture yes education really hospital price.
Perform west window outside several. Kid history life.",9:18:40,DD
CXFY99245025482787,GB97FHKC16607677923892,11/26/2015,820.51,100002,Y,Household Consumables,CHROME,MOBILE,Dr,13:04:03,15:36:30,3/5/2021,99057657,351.73,7,"Possible through politics score treatment. Goal detail recognize message American hospital some.
Page writer home matter short apply easy. Cultural worker fight these.",13:45:08,DD
CXFY99245025482787,GB97FHKC16607677923892,11/26/2015,468.78,100002,Y,Medicals,FF,PC,Dr,18:09:33,20:59:24,3/5/2021,60686879,351.73,2,New respond something difficult garden hope. Pressure without artist action. Chair individual debate body story sell individual.,19:21:38,IMPS
CXFY99245025482787,GB97FHKC16607677923892,11/26/2015,820.51,100002,N,Credited,FF,PC,Cr,21:38:06,24:20:23,3/5/2021,73521372,351.73,2,"Herself already you think. Tree avoid community nothing.
Young throw prove report leave behind generation. Person represent find American. Executive history early so deep occur.",23:37:50,IMPS
CXFY99245025482787,GB97FHKC16607677923892,11/26/2015,1928.56,100002,N,Credited,IE,PC,Cr,9:43:26,15:25:06,3/6/2021,34820766,1108.05,6,"Bank knowledge role front mind real. Newspaper heart let price support method property.
Professional bring civil yourself. Color whom even score. Guess cover person several.",12:22:01,CHEQUE
CXFY99245025482787,GB97FHKC16607677923892,11/26/2015,3036.61,100002,N,Credited,SAFARI,POS,Cr,13:57:15,21:14:00,3/6/2021,90572326,1108.05,3,"Be against collection several animal. Professional task reflect rule evening.
Like campaign like throw. Free pattern model the feeling story today.",17:37:49,RTGS
CXFY99245025482787,GB97FHKC16607677923892,11/26/2015,3428.93,100002,N,Credited,OPERA,MOBILE,Cr,7:02:21,9:50:46,3/13/2021,72654095,392.32,5,"Five edge dark along. Month back total name no around skin. Though practice them power opportunity success be.
Notice become book others vote age. Writer age over national.",9:14:14,CARDS
CXFY99245025482787,GB97FHKC16607677923892,11/26/2015,3036.61,100002,Y,Household Consumables,MI,PC,Dr,10:08:48,13:59:34,3/13/2021,31747103,392.32,4,"Once hard after risk. Real despite go benefit southern herself.
Sell discover important site game computer. Gas treatment company back able him much. Note prepare answer employee interest present.",12:00:13,UPI
CXFY99245025482787,GB97FHKC16607677923892,11/26/2015,3428.93,100002,N,Credited,CHROME,POS,Cr,18:46:14,21:38:51,3/13/2021,44312190,392.32,4,"Old usually stop front. Economic item where rise attention deal. Street for put of will early take.
Product bad sense simple add. Government try miss happen.",19:59:41,UPI
CXFY99245025482787,GB97FHKC16607677923892,11/26/2015,4056.99,100002,N,Credited,IE,PC,Cr,7:07:46,12:06:26,3/22/2021,73436201,628.06,3,"Free Democrat discuss mother either interesting age. Could where relate sometimes myself throw.
Team high certain play deep management too.",9:13:17,RTGS
CXFY99245025482787,GB97FHKC16607677923892,11/26/2015,4685.05,100002,N,Credited,SAFARI,MOBILE,Cr,14:35:03,17:45:55,3/22/2021,67651627,628.06,6,Herself medical should cold security throw expert. Society federal star car writer pattern. Small through can degree special player realize current.,15:14:35,CHEQUE
CXFY99245025482787,GB97FHKC16607677923892,11/26/2015,4056.99,100002,Y,Medicals,MI,PC,Dr,19:05:03,23:04:38,3/22/2021,31959803,628.06,4,"Treatment nearly look reason alone. Easy important spring beat much imagine. Card college responsibility even.
Star here prevent west three. Reach degree right kid lay within affect line.",21:23:30,UPI
CXFY99245025482787,GB97FHKC16607677923892,11/26/2015,2336.25,100002,Y,Rent,SAFARI,PC,Dr,3:05:32,5:24:36,3/23/2021,15107336,1720.74,2,"Money property federal policy clearly among outside themselves. Each son forward wonder onto professional.
Leg lay kid. Suddenly some through young. Left dark class kid girl.",4:22:53,IMPS
CXFY99245025482787,GB97FHKC16607677923892,11/26/2015,615.51,100002,Y,Entertainment,FF,POS,Dr,7:32:53,10:50:25,3/23/2021,13671068,1720.74,6,"Yes under result strong general. Break here street level country.
Work marriage Mr moment space. Suffer include total top other grow fast.",9:18:38,CHEQUE
CXFY99245025482787,GB97FHKC16607677923892,11/26/2015,2336.25,100002,N,Credited,OPERA,POS,Cr,11:57:18,15:02:01,3/23/2021,5349289,1720.74,3,"Next fight evening among. Like wide wide fight.
Bring sell big we better. Pm step defense film.
Imagine lawyer give make specific. Cause create under record whose way.",13:08:48,RTGS
CXFY99245025482787,GB97FHKC16607677923892,11/26/2015,4056.99,100002,N,Credited,FF,PC,Cr,17:28:54,19:28:25,3/23/2021,90373565,1720.74,4,Mrs nor reduce level hospital walk. Enter style few money discover. Worry various federal.,18:18:04,UPI
CXFY99245025482787,GB97FHKC16607677923892,11/26/2015,2336.25,100002,Y,Online Shopping,CHROME,MOBILE,Dr,22:41:01,25:07:08,3/23/2021,24294188,1720.74,1,Mouth home amount end see enjoy news measure. Economic hair off hotel establish leave. By organization front music coach.,23:15:12,NEFT
CXFY99245025482787,GB97FHKC16607677923892,11/26/2015,2701.14,100002,N,Credited,OPERA,POS,Cr,5:07:35,6:54:52,3/25/2021,10124307,364.89,5,"Little art see idea.
Ask tend bar wife friend hair rather land. Economy radio trial back teacher deep. Central agree oil behind reveal.",6:14:28,CARDS
CXFY99245025482787,GB97FHKC16607677923892,11/26/2015,3066.03,100002,N,Credited,FF,MOBILE,Cr,13:12:08,17:30:06,3/25/2021,66199236,364.89,7,Tell should outside already budget.,15:40:20,DD
CXFY99245025482787,GB97FHKC16607677923892,11/26/2015,2701.14,100002,Y,Groceries,SAFARI,MOBILE,Dr,20:11:09,25:06:28,3/25/2021,63688986,364.89,3,Top above teacher recently purpose member economy. Summer baby happen sure wife toward skin. Last everything necessary yourself minute community. Interview party hour type amount.,22:30:46,RTGS
CXFY99245025482787,GB97FHKC16607677923892,11/26/2015,994.4,100002,Y,Transportation,MI,MOBILE,Dr,8:50:40,19:17:31,3/28/2021,47892835,1706.74,7,"Citizen those thing table. Way certainly number truth play dark magazine.
Simple admit read marriage leg. Threat recognize understand music test out yet.",14:37:28,DD
CXFY99245025482787,GB97FHKC16607677923892,11/26/2015,1902.52,100002,N,Credited,OPERA,POS,Cr,20:54:54,26:54:24,4/1/2021,51606541,908.12,5,Difficult page notice question. True analysis civil model today write two decide. Break adult office similar professional form man Democrat.,22:41:59,CARDS
CXFY99245025482787,GB97FHKC16607677923892,11/26/2015,3671.9,100002,N,Credited,SAFARI,PC,Cr,11:03:23,22:16:44,4/3/2021,6004699,1769.38,5,"Change enjoy fight decade common. Hour know summer.
Moment spring experience. President arm word. Young staff reduce prove ball phone establish maintain.",17:02:01,CARDS
CXFY99245025482787,GB97FHKC16607677923892,11/26/2015,2738.86,100002,Y,Groceries,SAFARI,MOBILE,Dr,21:01:31,28:58:03,4/20/2021,19916712,933.04,1,"Point evidence another together among part Democrat they. Drive into star responsibility fish could.
Guy rule health dream black. Which spend no summer price billion.",23:55:36,NEFT
CXFY99245025482787,GB97FHKC16607677923892,11/26/2015,3043.77,100002,N,Credited,MI,MOBILE,Cr,5:51:11,8:08:25,5/2/2021,58053041,304.91,5,"Politics north exist street real toward. Pay charge many key money serve benefit.
Speak same middle create suddenly.
And shake read something. Rest world address someone enjoy weight.",7:26:22,CARDS
CXFY99245025482787,GB97FHKC16607677923892,11/26/2015,3348.68,100002,N,Credited,MI,POS,Cr,12:46:31,15:18:19,5/2/2021,58239995,304.91,7,Theory fast mean especially modern. Wall series ago night collection majority in. Memory occur true Congress several those lead.,14:19:50,DD
CXFY99245025482787,GB97FHKC16607677923892,11/26/2015,3653.59,100002,N,Credited,FF,MOBILE,Cr,17:01:32,18:44:15,5/2/2021,30662209,304.91,3,"Pretty poor forget produce weight. Government best campaign half. Read soon door year to on fire.
State quite bad floor experience money. Base head myself.",18:02:52,RTGS
CXFY99245025482787,GB97FHKC16607677923892,11/26/2015,3958.5,100002,N,Credited,IE,PC,Cr,20:25:35,23:41:44,5/2/2021,26778457,304.91,5,"People oil address environmental. None difference work account word involve.
Effect attack light issue rule. Bad value bad another decade.",21:24:30,CARDS
CXFY99245025482787,GB97FHKC16607677923892,11/26/2015,3171.86,100002,Y,Personal Care,MI,PC,Dr,12:00:47,18:29:11,5/12/2021,3877524,786.64,3,Husband training office. Crime bad anyone coach poor loss. No scene care part local.,14:31:24,RTGS
CXFY99245025482787,GB97FHKC16607677923892,11/26/2015,3958.5,100002,N,Credited,CHROME,PC,Cr,22:33:36,25:30:53,5/12/2021,81685622,786.64,7,"Star Democrat run region worry race.
Financial yourself the everyone. Stage yes player why some.
Top month rather. Must share might everything summer.",23:29:26,DD
CXFY99245025482787,GB97FHKC16607677923892,11/26/2015,5940.89,100002,N,Credited,EDGE,MOBILE,Cr,5:42:18,8:43:40,5/19/2021,85630024,1982.39,1,"Despite election report sound. Front responsibility it for.
Few country drive else. Something law reflect continue stock third of admit.",7:03:56,NEFT
CXFY99245025482787,GB97FHKC16607677923892,11/26/2015,3958.5,100002,Y,Transportation,CHROME,MOBILE,Dr,8:41:52,12:37:24,5/19/2021,39622587,1982.39,4,"Group information purpose PM community into top. Break up audience forward assume idea once. Senior health daughter and. Age necessary cup law shoulder each total.
Set door partner ten.",10:43:34,UPI
CXFY99245025482787,GB97FHKC16607677923892,11/26/2015,5940.89,100002,N,Credited,OPERA,POS,Cr,15:48:34,18:03:24,5/19/2021,2460819,1982.39,6,"Away hand trade often. Notice customer push section quite determine. Church vote represent maintain scene.
Power cause age. Memory of event improve big radio.",17:03:10,CHEQUE
CXFY99245025482787,GB97FHKC16607677923892,11/26/2015,3958.5,100002,Y,Rent,CHROME,PC,Dr,19:15:30,22:27:24,5/19/2021,35478492,1982.39,3,Series world kitchen point skill operation. Play board study argue. Material mind month for.,20:47:14,RTGS
CXFY99245025482787,GB97FHKC16607677923892,11/26/2015,2033.19,100002,Y,Rent,EDGE,MOBILE,Dr,6:51:31,16:47:20,5/27/2021,34515730,1925.31,7,Son talk against teach three. Write direction for speak feel see house alone. According news thank enough involve medical community.,12:17:58,DD
CXFY99245025482787,GB97FHKC16607677923892,11/26/2015,912.09,100002,Y,Entertainment,CHROME,MOBILE,Dr,13:46:59,19:27:05,6/5/2021,69618987,1121.1,4,"Music choose away give for son. Human identify cup including. Ago main financial part the.
Need trip way me. Baby glass senior phone consider. Nature goal of somebody century.",15:32:55,UPI
CXFY99245025482787,GB97FHKC16607677923892,11/26/2015,1398.11,100002,N,Credited,MI,MOBILE,Cr,10:19:57,16:07:00,6/8/2021,58147603,486.02,2,"Send admit military light. No Congress music treatment.
Edge for make a simple letter during. Spend help decade million move.
Someone a grow crime.",12:50:10,IMPS
CXFY99245025482787,GB97FHKC16607677923892,11/26/2015,1179.51,100002,Y,Utilities,FF,MOBILE,Dr,6:26:55,9:47:39,6/17/2021,36578696,218.6,2,"Or less national scientist. Because need action life just language. Part spend work power step share own.
Rate second most various study knowledge. Finish cup board about television tend service.",8:36:44,IMPS
CXFY99245025482787,GB97FHKC16607677923892,11/26/2015,960.91,100002,Y,Insurance,OPERA,MOBILE,Dr,10:38:48,14:18:31,6/17/2021,98323456,218.6,5,"Management visit risk high any exist course. Husband partner speak easy sign wind huge on.
History notice address resource charge. Past similar create second. Far language wish others always hotel.",12:53:13,CARDS
CXFY99245025482787,GB97FHKC16607677923892,11/26/2015,1179.51,100002,N,Credited,EDGE,POS,Cr,14:30:35,17:05:28,6/17/2021,3633007,218.6,6,"Also phone set box late leg home. Perform decide TV reality.
Partner away point here early discover some. Table in themselves none field service. Dinner hot including buy.",15:12:52,CHEQUE
CXFY99245025482787,GB97FHKC16607677923892,11/26/2015,960.91,100002,Y,Insurance,EDGE,POS,Dr,20:55:18,24:53:05,6/17/2021,59563556,218.6,1,Tv seem discussion kind. List return treat crime would understand opportunity. West wait store.,23:14:25,NEFT
CXFY99245025482787,GB97FHKC16607677923892,11/26/2015,1409.28,100002,N,Credited,OPERA,PC,Cr,9:14:33,12:33:49,6/26/2021,45221057,448.37,4,Son new magazine everyone them event say number. Event time choose accept can goal.,11:03:45,UPI
CXFY99245025482787,GB97FHKC16607677923892,11/26/2015,960.91,100002,Y,Online Shopping,EDGE,MOBILE,Dr,15:28:16,20:36:00,6/26/2021,62438889,448.37,2,"Hotel approach the sell without we member tax. Senior away gun ball month. Responsibility begin almost stop pattern note.
Prepare arm out stand meet table. Nearly eight production.",17:55:52,IMPS
CXFY99245025482787,GB97FHKC16607677923892,11/26/2015,512.54,100002,Y,Online Shopping,SAFARI,PC,Dr,19:31:15,23:55:36,6/26/2021,65053539,448.37,2,Chance however traditional agent conference establish ten. Popular plant address president. Manager gas energy certain together million debate list.,21:31:06,IMPS
CXFY99245025482787,GB97FHKC16607677923892,11/26/2015,1211.44,100002,N,Credited,CHROME,PC,Cr,10:08:02,19:14:06,7/3/2021,67084005,698.9,7,Current appear turn during attack sometimes point impact. Generation prevent alone Mr role environment.,15:17:35,DD
CXFY99245025482787,GB97FHKC16607677923892,11/26/2015,2924.77,100002,N,Credited,SAFARI,MOBILE,Cr,9:25:40,12:00:47,7/6/2021,88713205,1713.33,4,"Fund recently without security bag friend word. Senior factor nation check.
Including interview fill. Trouble notice air benefit describe situation talk.",10:39:16,UPI
CXFY99245025482787,GB97FHKC16607677923892,11/26/2015,4638.1,100002,N,Credited,CHROME,MOBILE,Cr,14:39:00,17:41:35,7/6/2021,53578402,1713.33,2,Write build may type. Thousand benefit east become fight anything. One recognize recently plant level.,16:55:14,IMPS
CXFY99245025482787,GB97FHKC16607677923892,11/26/2015,6351.43,100002,N,Credited,FF,PC,Cr,19:39:40,22:44:31,7/6/2021,83603426,1713.33,1,"Traditional drug able. Remain what measure. Happen choose add.
Instead degree no position high vote. Bring modern Democrat green fall it.",21:48:57,NEFT
CXFY99245025482787,GB97FHKC16607677923892,11/26/2015,5315.45,100002,Y,Rent,FF,MOBILE,Dr,9:01:21,13:02:12,7/8/2021,5991099,1035.98,6,She parent adult specific decide statement. Get beautiful still concern benefit. Service interesting involve necessary wall throw.,11:09:39,CHEQUE
CXFY99245025482787,GB97FHKC16607677923892,11/26/2015,6351.43,100002,N,Credited,FF,MOBILE,Cr,12:25:33,18:50:44,7/8/2021,91406712,1035.98,1,Benefit resource good light treatment sort. Expect we suddenly mother.,16:16:22,NEFT
CXFY99245025482787,GB97FHKC16607677923892,11/26/2015,6710.92,100002,N,Credited,CHROME,POS,Cr,4:24:35,9:23:33,7/16/2021,19971865,359.49,4,Option assume front brother throw room say. Employee back management medical matter agreement lot. My paper quickly.,6:24:14,UPI
CXFY99245025482787,GB97FHKC16607677923892,11/26/2015,6351.43,100002,Y,Online Shopping,EDGE,POS,Dr,13:44:29,17:28:30,7/16/2021,94194999,359.49,4,"Learn wife event. The subject economy write consumer increase trip. Between authority job possible result factor.
Magazine affect what everybody. Treatment evening increase major lay.",15:36:19,UPI
CXFY99245025482787,GB97FHKC16607677923892,11/26/2015,5991.94,100002,Y,Insurance,MI,POS,Dr,19:33:54,23:19:01,7/16/2021,40183213,359.49,2,"New everyone board take opportunity fly make. Owner administration face my southern black city.
Education show grow skill this. Call present care yeah drug nearly student myself.",21:27:30,IMPS
CXFY99245025482787,GB97FHKC16607677923892,11/26/2015,4972.63,100002,Y,Entertainment,FF,POS,Dr,8:33:29,19:14:00,7/24/2021,27450574,1019.31,5,Hair begin ten over bed. Whose catch we fire trade beyond positive.,13:28:22,CARDS
CXFY99245025482787,GB97FHKC16607677923892,11/26/2015,5534.57,100002,N,Credited,IE,POS,Cr,6:53:20,8:02:28,7/25/2021,15393395,561.94,1,Morning hotel family environment. Serious space specific approach issue challenge big. Position recent allow recognize kitchen.,7:25:38,NEFT
CXFY99245025482787,GB97FHKC16607677923892,11/26/2015,4972.63,100002,Y,Insurance,CHROME,POS,Dr,6:32:49,9:02:06,7/25/2021,22519573,561.94,3,"Interesting better participant before. Evidence bar record right quickly how.
Ok choose ability instead along begin. Day strong body marriage must.",8:22:42,RTGS
CXFY99245025482787,GB97FHKC16607677923892,11/26/2015,5534.57,100002,N,Credited,EDGE,MOBILE,Cr,14:29:54,16:09:06,7/25/2021,17710435,561.94,1,"Through plant less see share picture.
Down station certainly kitchen skill father. Every growth occur instead. Main ground these now similar want.",15:15:28,NEFT
CXFY99245025482787,GB97FHKC16607677923892,11/26/2015,6096.51,100002,N,Credited,SAFARI,POS,Cr,14:53:43,17:30:30,7/25/2021,88990439,561.94,5,"Allow seven exist find respond also interest thus. Single particular join plan good son business.
Century so western figure wide level.",16:16:07,CARDS
CXFY99245025482787,GB97FHKC16607677923892,11/26/2015,5534.57,100002,Y,Online Shopping,SAFARI,POS,Dr,22:19:36,25:03:57,7/25/2021,40864129,561.94,6,Trouble lay be finish certainly and. Themselves around here responsibility but we.,23:44:18,CHEQUE
CXFY99245025482787,GB97FHKC16607677923892,11/26/2015,4775.01,100002,Y,Online Shopping,SAFARI,MOBILE,Dr,9:33:32,12:44:52,7/30/2021,1308006,759.56,3,"Plant degree everyone view turn finish.
Cultural hot miss whom together provide though. Each my growth item agree during source. Kitchen modern senior pattern.",10:41:40,RTGS
CXFY99245025482787,GB97FHKC16607677923892,11/26/2015,5534.57,100002,N,Credited,IE,PC,Cr,11:08:14,15:29:12,7/30/2021,62312561,759.56,2,"Site beyond similar sea certain son month. Land especially far politics risk nice. Ahead range grow up child day have.
Foreign choice amount both throughout some. Short event great camera cultural.",13:44:24,IMPS
CXFY99245025482787,GB97FHKC16607677923892,11/26/2015,6294.13,100002,N,Credited,FF,MOBILE,Cr,16:58:56,22:09:41,7/30/2021,37520786,759.56,5,"Task news care world important. One less always.
Then score science down. Word any size citizen.",19:15:49,CARDS
CXFY99245025482787,GB97FHKC16607677923892,11/26/2015,6989.08,100002,N,Credited,SAFARI,PC,Cr,5:52:45,9:40:35,8/7/2021,36016020,694.95,7,"Enough common Republican not measure grow. Remain building night listen bag treatment.
Into catch year time reduce parent line floor. Front whatever success service middle turn.",8:09:34,DD
CXFY99245025482787,GB97FHKC16607677923892,11/26/2015,7684.03,100002,N,Credited,FF,PC,Cr,11:41:56,14:35:02,8/7/2021,66466741,694.95,2,Lose nothing degree effect investment him. Protect risk lead manager treat leg federal. Only yard shoulder too knowledge yard though.,12:57:07,IMPS
CXFY99245025482787,GB97FHKC16607677923892,11/26/2015,6989.08,100002,Y,Transportation,FF,POS,Dr,18:01:16,20:31:24,8/7/2021,47165144,694.95,6,"Area customer event few owner whom. Break staff guy officer.
Ready season form sure. Pattern strategy agency thus step gun environmental.",18:33:40,CHEQUE
CXFY99245025482787,GB97FHKC16607677923892,11/26/2015,7684.03,100002,N,Credited,MI,POS,Cr,23:04:15,24:15:18,8/7/2021,74562411,694.95,4,Three film seat kitchen speech. Move occur here often sport everything kitchen. Member up central surface base foreign. Executive imagine charge mind speak north.,23:46:30,UPI
CXFY99245025482787,GB97FHKC16607677923892,11/26/2015,5945.94,100002,Y,Rent,SAFARI,PC,Dr,8:03:33,10:54:06,8/13/2021,14860577,1738.09,4,Degree keep product tree main last. Feeling animal administration lead hold kid huge. Kid laugh last protect morning never structure.,9:34:58,UPI
CXFY99245025482787,GB97FHKC16607677923892,11/26/2015,7684.03,100002,N,Credited,MI,PC,Cr,10:38:09,12:28:58,8/13/2021,64450636,1738.09,6,Camera laugh hot contain. Rich tend else area cost probably happy just. Fill maybe performance charge compare early would.,11:08:24,CHEQUE
CXFY99245025482787,GB97FHKC16607677923892,11/26/2015,5945.94,100002,Y,Rent,OPERA,MOBILE,Dr,15:07:10,17:02:05,8/13/2021,39102126,1738.09,5,Number still tend high red. Job discuss here high outside hard. Act dark situation case hot. Give too suffer drug send red.,16:01:07,CARDS
CXFY99245025482787,GB97FHKC16607677923892,11/26/2015,7684.03,100002,N,Credited,SAFARI,POS,Cr,18:36:37,21:05:16,8/13/2021,96377277,1738.09,2,"Indeed alone story article look role state. Teach fall thus major decide. Wait couple speak simply.
City situation treat concern subject walk dinner. City heart camera.",19:23:19,IMPS
CXFY99245025482787,GB97FHKC16607677923892,11/26/2015,7641.99,100002,Y,Online Shopping,OPERA,POS,Dr,8:39:36,12:43:40,8/15/2021,11606406,42.04,1,"Nature vote TV section travel scene. Cold product through happen accept hot.
Daughter relate box rather. Interview them technology seek today. Experience success respond miss.",11:01:13,NEFT
CXFY99245025482787,GB97FHKC16607677923892,11/26/2015,7599.95,100002,Y,Entertainment,IE,PC,Dr,13:31:43,16:54:08,8/15/2021,12659784,42.04,6,Someone much teacher practice forget moment issue night. Occur brother already democratic. Forward product baby room. Wife south first successful buy by address.,14:11:31,CHEQUE
CXFY99245025482787,GB97FHKC16607677923892,11/26/2015,7641.99,100002,N,Credited,FF,PC,Cr,18:15:18,20:20:22,8/15/2021,41320365,42.04,7,"Four up certainly question same learn.
Tv explain billion tree. Up central most appear.
Nearly scientist relate spend. Mean indeed attorney focus cell.",19:40:14,DD
CXFY99245025482787,GB97FHKC16607677923892,11/26/2015,6581.1,100002,Y,Groceries,EDGE,MOBILE,Dr,7:21:38,10:43:51,8/17/2021,58355022,1060.89,2,"Cause appear learn machine yes.
Nice year most north. One third region often both. Action hour these word.",8:18:11,IMPS
CXFY99245025482787,GB97FHKC16607677923892,11/26/2015,5520.21,100002,Y,Rent,CHROME,MOBILE,Dr,12:33:06,16:25:25,8/17/2021,3686171,1060.89,2,Energy very live shake different life responsibility. Congress opportunity parent. Cup outside past teacher usually sense leg from.,15:03:51,IMPS
CXFY99245025482787,GB97FHKC16607677923892,11/26/2015,6581.1,100002,N,Credited,CHROME,POS,Cr,19:11:35,22:45:13,8/17/2021,57161884,1060.89,1,"Bring religious claim nothing character. Card team success. Official main effort wall summer create consumer.
Where marriage eight election. Physical from catch show. Economy capital lay capital.",20:15:55,NEFT
CXFY99245025482787,GB97FHKC16607677923892,11/26/2015,8412.93,100002,N,Credited,FF,MOBILE,Cr,6:23:36,8:03:53,8/21/2021,71277912,1831.83,2,"List today view cup.
Most game image a development worry pull. Major certainly safe former wear probably remember whom.",7:05:57,IMPS
CXFY99245025482787,GB97FHKC16607677923892,11/26/2015,6581.1,100002,Y,Groceries,EDGE,PC,Dr,7:58:06,12:23:26,8/21/2021,28626435,1831.83,1,Establish subject hand certain. Oil require key production several human western audience.,10:05:38,NEFT
CXFY99245025482787,GB97FHKC16607677923892,11/26/2015,8412.93,100002,N,Credited,SAFARI,PC,Cr,15:51:50,18:07:01,8/21/2021,13376536,1831.83,3,Sing prevent or staff worker necessary goal. Brother artist receive me.,16:59:02,RTGS
CXFY99245025482787,GB97FHKC16607677923892,11/26/2015,6581.1,100002,Y,Insurance,MI,PC,Dr,18:02:04,21:21:03,8/21/2021,93527262,1831.83,3,"Majority method left catch. How forget different career light huge no should.
Reflect so house stage world. Animal else film their stock.",19:44:50,RTGS
CXFY99245025482787,GB97FHKC16607677923892,11/26/2015,4988.17,100002,Y,Household Consumables,IE,PC,Dr,16:40:46,23:00:44,8/25/2021,57204413,1592.93,1,"Know attack million address book short. Share customer account big mean party phone hundred. While city top.
Special official fly town guess explain. Become become cultural say dream.",19:30:21,NEFT
CXFY99245025482787,GB97FHKC16607677923892,11/26/2015,4934.18,100002,Y,Personal Care,SAFARI,PC,Dr,2:44:36,5:08:51,8/29/2021,56251807,53.99,4,"Bag before benefit most. Call cold especially hair. Increase true idea because increase east strong. Stand choose author bad.
Community tree keep word create culture. Capital film herself consumer.",4:00:40,UPI
CXFY99245025482787,GB97FHKC16607677923892,11/26/2015,4880.19,100002,Y,Insurance,EDGE,POS,Dr,9:01:12,10:33:50,8/29/2021,21004513,53.99,7,"Your allow carry two cultural. Garden central cause today picture watch. Sell stage action turn single.
Indicate set push century. Reflect seem challenge between.",10:03:04,DD
CXFY99245025482787,GB97FHKC16607677923892,11/26/2015,4826.2,100002,Y,Dining,MI,PC,Dr,10:57:54,14:15:24,8/29/2021,73381280,53.99,6,Fish more detail opportunity operation. Painting everybody wall send. Hit performance wide possible able. Develop visit born.,12:19:51,CHEQUE
CXFY99245025482787,GB97FHKC16607677923892,11/26/2015,4880.19,100002,N,Credited,FF,PC,Cr,17:32:09,18:58:12,8/29/2021,13192785,53.99,5,"Spend follow final during leave anyone.
Simple open body up drug force positive. Place water across number international be next. Walk idea me house news laugh.",18:09:51,CARDS
CXFY99245025482787,GB97FHKC16607677923892,11/26/2015,4826.2,100002,Y,Transportation,FF,POS,Dr,20:59:51,24:01:49,8/29/2021,20666071,53.99,3,"Picture series center. For time evening receive lot toward.
Eye pick effect region simply. Figure finally surface carry try whose service strategy.",22:16:34,RTGS
CXFY99245025482787,GB97FHKC16607677923892,11/26/2015,2846.98,100002,Y,Household Consumables,CHROME,POS,Dr,11:18:17,17:23:50,9/3/2021,15578945,1979.22,7,"Born sell third where what work admit. Hear leave gun. Bed single especially forget itself.
Charge character positive between born create. Late from say individual star not.",15:16:37,DD
CXFY99245025482787,GB97FHKC16607677923892,11/26/2015,1107.51,100002,Y,Rent,MI,PC,Dr,10:54:52,14:42:43,9/12/2021,14183546,1739.47,7,"Unit let nearly instead. Up main fish because chance performance full. Difference probably particular little year attack success.
Central pull bar third. Ago consider nor sure market mission gas.",11:49:37,DD
CXFY99245025482787,GB97FHKC16607677923892,11/26/2015,2846.98,100002,N,Credited,SAFARI,MOBILE,Cr,12:42:54,14:46:53,9/12/2021,59533504,1739.47,5,"Research camera fast time. Easy probably during cup produce fact mother. Property get computer say wind human.
Region you person production each maintain yes. President wide article music.",13:27:41,CARDS
CXFY99245025482787,GB97FHKC16607677923892,11/26/2015,4586.45,100002,N,Credited,CHROME,PC,Cr,15:32:12,18:41:37,9/12/2021,61939721,1739.47,7,"Fear same now age ability.
Couple policy than a. None wish difference memory success.
Sort final identify ago surface make. Similar majority body theory.",18:05:33,DD
CXFY99245025482787,GB97FHKC16607677923892,11/26/2015,3457.21,100002,Y,Utilities,OPERA,POS,Dr,7:45:27,14:01:02,9/14/2021,24892322,1129.24,4,"Candidate system light point.
Drug analysis design clearly major network popular. House role large customer. Hard strong employee mind.",10:14:57,UPI
CXFY99245025482787,GB97FHKC16607677923892,11/26/2015,4586.45,100002,N,Credited,OPERA,PC,Cr,20:07:58,23:53:44,9/14/2021,98386055,1129.24,3,"Family young position nearly. Own world while case parent forget. First small order.
Among politics family attack. Fear difficult president. My answer else because election race.",21:47:35,RTGS
CXFY99245025482787,GB97FHKC16607677923892,11/26/2015,6496.74,100002,N,Credited,CHROME,POS,Cr,4:17:45,6:46:39,9/28/2021,60695291,1910.29,7,"Course education happen put she agreement man individual. Drug phone direction space some heavy.
Result call say nature we team news. Catch then foot actually magazine.",5:46:19,DD
CXFY99245025482787,GB97FHKC16607677923892,11/26/2015,4586.45,100002,Y,Personal Care,FF,POS,Dr,10:57:13,13:05:50,9/28/2021,11169666,1910.29,4,Note group south for. Avoid message surface watch happen data century wall. Discuss chair yourself film quickly.,12:26:49,UPI
CXFY99245025482787,GB97FHKC16607677923892,11/26/2015,2676.16,100002,Y,Dining,MI,PC,Dr,17:42:38,19:25:53,9/28/2021,67566082,1910.29,3,"Scientist author do seat look image challenge teacher. Right cover and newspaper hot opportunity. Treatment high actually think consider party.
Market thus hotel fund fast. Cold beat the yourself.",18:48:05,RTGS
CXFY99245025482787,GB97FHKC16607677923892,11/26/2015,765.87,100002,Y,Household Consumables,IE,MOBILE,Dr,18:27:25,21:40:48,9/28/2021,7059209,1910.29,4,"Part compare focus deep. White number matter of guy computer.
Once whose dark cost. Beyond check lose threat.",19:54:35,UPI
CXFY99245025482787,GB97FHKC16607677923892,11/26/2015,1681.87,100002,N,Credited,MI,PC,Cr,6:55:15,9:06:26,10/10/2021,87236637,916,7,"Finally message late own. You process perhaps good without.
Red street fast with our film local marriage. Follow science might perform force. Reach democratic machine each.",7:50:35,DD
CXFY99245025482787,GB97FHKC16607677923892,11/26/2015,765.87,100002,Y,Online Shopping,MI,PC,Dr,10:45:58,12:50:42,10/10/2021,95222165,916,1,"Ten each car heart. Daughter blue out southern.
Minute avoid financial low. Rule dinner hold value finally yourself.",11:18:17,NEFT
CXFY99245025482787,GB97FHKC16607677923892,11/26/2015,1681.87,100002,N,Credited,OPERA,MOBILE,Cr,12:01:16,14:00:16,10/10/2021,6329211,916,4,Apply result a respond well girl least. Share happy for national already group. Important sort recent those.,12:32:47,UPI
CXFY99245025482787,GB97FHKC16607677923892,11/26/2015,2597.87,100002,N,Credited,MI,MOBILE,Cr,18:28:25,20:38:53,10/10/2021,8169556,916,7,"Present because officer amount.
Enough call radio effort. Sometimes air opportunity crime wish factor.
Stock difference catch dark. Relate someone role carry analysis yourself.",19:56:09,DD
CXFY99245025482787,GB97FHKC16607677923892,11/26/2015,1681.87,100002,Y,Personal Care,MI,POS,Dr,20:28:57,22:54:50,10/10/2021,88495224,916,5,Agent apply research company. Tend floor south white item policy building. Low head business picture traditional.,22:03:57,CARDS
CXFY99245025482787,GB97FHKC16607677923892,11/26/2015,2307.84,100002,N,Credited,OPERA,PC,Cr,5:19:09,9:26:24,10/14/2021,20813550,625.97,5,"Everyone water majority national. Put image believe spring.
May kitchen two happen at.
Page think suffer lay air stand charge chance.",7:33:19,CARDS
CXFY99245025482787,GB97FHKC16607677923892,11/26/2015,2933.81,100002,N,Credited,SAFARI,PC,Cr,12:17:47,16:29:54,10/14/2021,48685368,625.97,5,Least story bank tell team glass somebody. Return ball down heavy.,14:43:38,CARDS
CXFY99245025482787,GB97FHKC16607677923892,11/26/2015,3559.78,100002,N,Credited,IE,MOBILE,Cr,20:14:57,24:28:55,10/14/2021,22519252,625.97,1,"Each space country. Necessary appear almost next discussion this. Fall human practice soon.
Deal artist first area check.",21:53:48,NEFT
YZPK79958559760714,GB20RWFE52559459549428,12/8/2019,2541.59,100002,Y,Insurance,IE,PC,Dr,5:06:34,7:46:21,12/8/2019,8803306,961.17,6,Decision take color class agent now pick. Character member so turn mission.,6:52:04,CHEQUE
YZPK79958559760714,GB20RWFE52559459549428,12/8/2019,1580.42,100002,Y,Personal Care,FF,POS,Dr,8:50:22,11:20:02,12/8/2019,190701,961.17,5,"Pattern base tend race pull subject next. Only add present pressure per. Budget cause assume daughter environment figure actually.
Will organization whatever democratic discover.",9:36:03,CARDS
YZPK79958559760714,GB20RWFE52559459549428,12/8/2019,619.25,100002,Y,Utilities,EDGE,POS,Dr,14:19:08,16:29:34,12/8/2019,27481455,961.17,4,Build themselves military dream into. Gas science affect require suggest finish.,15:26:26,UPI
YZPK79958559760714,GB20RWFE52559459549428,12/8/2019,749.1,100002,N,Credited,SAFARI,PC,Cr,9:51:33,12:17:57,12/10/2019,83391187,129.85,5,"Not activity every senior than. Wrong knowledge two TV end.
Ahead physical think member. Where hundred everybody save difference different economic music.",11:06:35,CARDS
YZPK79958559760714,GB20RWFE52559459549428,12/8/2019,878.95,100002,N,Credited,EDGE,PC,Cr,16:42:02,22:47:43,12/10/2019,23377806,129.85,6,"Above into stuff number take computer. Save most money campaign east.
Your also section. Surface because support call investment. Again even eye east stand. Surface newspaper his type.",20:01:20,CHEQUE
YZPK79958559760714,GB20RWFE52559459549428,12/8/2019,1113.61,100002,N,Credited,CHROME,MOBILE,Cr,6:35:43,8:50:05,12/11/2019,25770506,234.66,3,Base business push argue small suggest less he. Together organization worker focus. Exist police front peace power.,7:57:43,RTGS
YZPK79958559760714,GB20RWFE52559459549428,12/8/2019,1348.27,100002,N,Credited,EDGE,POS,Cr,12:44:26,14:43:47,12/11/2019,7939341,234.66,5,Position because Democrat both talk father hear. Each part available picture opportunity. Practice move remain international alone thank.,13:19:10,CARDS
YZPK79958559760714,GB20RWFE52559459549428,12/8/2019,1582.93,100002,N,Credited,FF,MOBILE,Cr,15:45:57,19:24:02,12/11/2019,75226299,234.66,5,"Later another discover hear. Treatment I energy state per future store. Meeting office role TV.
Also area campaign whether myself Democrat rest. Toward meeting mean director where movement.",17:48:26,CARDS
YZPK79958559760714,GB20RWFE52559459549428,12/8/2019,1817.59,100002,N,Credited,SAFARI,MOBILE,Cr,22:30:05,24:26:39,12/11/2019,25357516,234.66,1,"Suddenly glass option college sure. Break hour cell quite.
Quality available state hour capital produce prevent. Wife yes figure me.",23:31:31,NEFT
YZPK79958559760714,GB20RWFE52559459549428,12/8/2019,1074.95,100002,Y,Utilities,OPERA,MOBILE,Dr,11:50:40,20:42:43,12/15/2019,66691594,742.64,2,"Window law against high. Mouth community agreement serious along fly drive.
Onto apply child federal. Floor position many.",16:24:54,IMPS
YZPK79958559760714,GB20RWFE52559459549428,12/8/2019,2445.47,100002,N,Credited,SAFARI,POS,Cr,5:39:06,8:25:33,12/16/2019,54317239,1370.52,1,"Wrong heart fly. Yeah music few land see join probably fill.
Which happen government. Cause look begin call gun official hit. Stage official seek accept hair.",7:24:14,NEFT
YZPK79958559760714,GB20RWFE52559459549428,12/8/2019,1074.95,100002,Y,Groceries,OPERA,POS,Dr,11:25:25,16:42:08,12/16/2019,67441082,1370.52,2,"House expert reduce particular TV fly. Her put possible agree performance.
Budget everyone candidate popular. Rate by center they forward player. Accept sign but also.",14:14:06,IMPS
YZPK79958559760714,GB20RWFE52559459549428,12/8/2019,1657.34,100002,N,Credited,SAFARI,MOBILE,Cr,10:42:39,12:35:52,12/26/2019,80686552,582.39,6,"Onto whose eye other accept. Bed theory foreign between nothing card. Again reach thing employee.
Reduce structure watch condition book probably.",11:38:31,CHEQUE
YZPK79958559760714,GB20RWFE52559459549428,12/8/2019,2239.73,100002,N,Credited,CHROME,PC,Cr,14:35:33,18:09:08,12/26/2019,50386383,582.39,4,"Tax ability safe program sort. Four forward back actually too democratic organization whether.
Have in size money ask. Consumer hair city feel ten single notice clearly.",15:47:40,UPI
YZPK79958559760714,GB20RWFE52559459549428,12/8/2019,2822.12,100002,N,Credited,SAFARI,POS,Cr,18:25:56,21:02:08,12/26/2019,57914541,582.39,1,"Southern weight mouth hold by activity if.
Relate administration offer each certain eight reflect. Soldier more rock inside sing.",19:43:14,NEFT
YZPK79958559760714,GB20RWFE52559459549428,12/8/2019,2712.75,100002,Y,Entertainment,IE,POS,Dr,17:58:45,26:21:03,1/5/2020,37486891,109.37,5,Give team despite laugh between either week. Behind alone performance difficult. Discuss push forget they be.,21:25:54,CARDS
YZPK79958559760714,GB20RWFE52559459549428,12/8/2019,4684.73,100002,N,Credited,IE,MOBILE,Cr,7:31:24,10:10:36,1/7/2020,37845438,1971.98,6,"Both student account it tree. Spend area season do book manager. Kind finish central again change.
Picture finish despite power. Indeed office mention large. Enter deal show from.",9:33:28,CHEQUE
YZPK79958559760714,GB20RWFE52559459549428,12/8/2019,2712.75,100002,Y,Utilities,SAFARI,MOBILE,Dr,10:39:03,12:22:26,1/7/2020,90415975,1971.98,7,Candidate wife dog national western heart office find. Most recognize around perform easy.,11:40:11,DD
YZPK79958559760714,GB20RWFE52559459549428,12/8/2019,740.77,100002,Y,Medicals,SAFARI,PC,Dr,14:04:37,15:48:41,1/7/2020,77584984,1971.98,4,"Exactly do life page. Or apply believe floor senior world positive.
Once fine natural fish. Outside according here end court. Religious get decade take once take.",14:34:55,UPI
YZPK79958559760714,GB20RWFE52559459549428,12/8/2019,1238.42,100002,N,Credited,OPERA,MOBILE,Cr,5:37:19,9:02:25,1/8/2020,34125106,497.65,1,Determine six official police mouth. Could effect chance answer black need. Mrs feel discuss.,7:17:19,NEFT
YZPK79958559760714,GB20RWFE52559459549428,12/8/2019,1736.07,100002,N,Credited,CHROME,POS,Cr,8:10:27,10:09:29,1/8/2020,90671487,497.65,6,Enter nor should including institution deal deep nor. Stock task hope forward Congress again.,9:15:38,CHEQUE
YZPK79958559760714,GB20RWFE52559459549428,12/8/2019,1238.42,100002,Y,Personal Care,SAFARI,POS,Dr,13:24:09,16:00:13,1/8/2020,23989306,497.65,3,"Chair market along hour energy bed. Clear firm better challenge.
Argue find particularly again. Fight high section executive TV computer.",14:59:35,RTGS
YZPK79958559760714,GB20RWFE52559459549428,12/8/2019,740.77,100002,Y,Entertainment,MI,POS,Dr,15:29:26,18:43:02,1/8/2020,4001157,497.65,5,"Follow provide author street. Best impact free agent.
Close physical training real. Five TV yet society north say fly.",17:21:56,CARDS
YZPK79958559760714,GB20RWFE52559459549428,12/8/2019,1238.42,100002,N,Credited,FF,POS,Cr,20:21:15,23:47:24,1/8/2020,2041438,497.65,4,"Drop south laugh painting bad.
Full father teacher I visit. So argue grow election start my. Weight enjoy national exactly program visit art hotel.",22:05:30,UPI
YZPK79958559760714,GB20RWFE52559459549428,12/8/2019,2428.99,100002,N,Credited,MI,MOBILE,Cr,10:28:42,17:06:47,1/18/2020,8352323,1190.57,7,"Point price different around foreign much be. Cup radio doctor possible economic common will.
Politics yourself stay arrive tax check. Sister down ten save happy college indeed.",14:59:25,DD
YZPK79958559760714,GB20RWFE52559459549428,12/8/2019,3027.69,100002,N,Credited,IE,PC,Cr,5:51:27,8:57:32,1/23/2020,56504866,598.7,1,"Evening own himself. Example finally Mr political free. Another part for some cover again.
Child sure challenge measure though run although. Method better thus child sort vote.",7:20:25,NEFT
YZPK79958559760714,GB20RWFE52559459549428,12/8/2019,3626.39,100002,N,Credited,FF,MOBILE,Cr,8:03:20,9:51:21,1/23/2020,73326465,598.7,1,"Room operation special knowledge national factor. Visit time should song agency.
Us base treatment gas charge create base notice. Few receive then despite. And toward see bad thank stock risk.",8:53:27,NEFT
YZPK79958559760714,GB20RWFE52559459549428,12/8/2019,4225.09,100002,N,Credited,IE,POS,Cr,13:23:08,16:54:13,1/23/2020,33435756,598.7,7,"South reach military. Consumer scene happen seem.
Suggest style value method. Sort management attorney type fact stay mother kid.
They give son top newspaper. System reduce that among.",15:08:49,DD
YZPK79958559760714,GB20RWFE52559459549428,12/8/2019,3626.39,100002,Y,Utilities,OPERA,MOBILE,Dr,16:01:59,17:52:45,1/23/2020,66082422,598.7,3,"Experience health among garden air manage who. Involve degree alone Mrs ok. Week tend finish.
Threat support identify produce cost. Toward material pull none. Our part rock somebody accept method.",17:21:30,RTGS
YZPK79958559760714,GB20RWFE52559459549428,12/8/2019,4225.09,100002,N,Credited,EDGE,MOBILE,Cr,21:24:13,23:40:38,1/23/2020,95655604,598.7,4,"Exactly major home direction. Major next real company. Federal important nice nation.
Religious part free standard travel. Resource change television lead.",23:12:35,UPI
YZPK79958559760714,GB20RWFE52559459549428,12/8/2019,3070.18,100002,Y,Entertainment,IE,POS,Dr,9:39:26,13:01:29,1/27/2020,35357858,1154.91,1,"Open group by type page. Mother common people change lot. Collection language wife cell player manage open.
Very particularly fish half exactly. Area civil can feel instead.",11:15:27,NEFT
YZPK79958559760714,GB20RWFE52559459549428,12/8/2019,4225.09,100002,N,Credited,IE,PC,Cr,16:14:17,19:00:48,1/27/2020,12573486,1154.91,5,"Before important traditional PM officer. Manager charge position skin.
At pressure college how must official. Success continue arm morning indicate hope group name.",17:15:26,CARDS
YZPK79958559760714,GB20RWFE52559459549428,12/8/2019,5380,100002,N,Credited,FF,POS,Cr,16:21:40,19:39:26,1/27/2020,42227229,1154.91,2,"Stand style history fly drop. Perhaps remain professional almost oil pick.
Study fine themselves. Hit institution agree coach. Mission big religious own recently.",18:34:46,IMPS
YZPK79958559760714,GB20RWFE52559459549428,12/8/2019,3425.21,100002,Y,Utilities,FF,MOBILE,Dr,10:23:43,16:40:02,2/6/2020,44653118,1954.79,4,Impact energy series performance word behind matter right. Her toward teach our remain first say education. Behavior chair adult art reduce.,13:59:18,UPI
YZPK79958559760714,GB20RWFE52559459549428,12/8/2019,1470.42,100002,Y,Online Shopping,IE,PC,Dr,17:19:02,21:35:59,2/6/2020,77377548,1954.79,4,"Data focus region all. Teacher certainly once much not dark task.
Resource source choose first. Where hand cultural during itself per various look.",19:15:35,UPI
YZPK79958559760714,GB20RWFE52559459549428,12/8/2019,2985.49,100002,N,Credited,FF,POS,Cr,22:29:07,24:49:49,2/16/2020,31273893,1515.07,3,Buy station level behavior although security court hundred. Left kitchen those force car process real. Wish ready eye professor big.,23:20:21,RTGS
YZPK79958559760714,GB20RWFE52559459549428,12/8/2019,1214.91,100002,Y,Medicals,IE,MOBILE,Dr,6:29:27,9:27:44,2/20/2020,48308687,1770.58,6,Office weight late conference central. Wall control Mrs five rise chair. Prove side policy should day what.,7:30:54,CHEQUE
YZPK79958559760714,GB20RWFE52559459549428,12/8/2019,2985.49,100002,N,Credited,EDGE,PC,Cr,11:33:56,13:39:28,2/20/2020,20251703,1770.58,2,Born who on light. Evidence capital myself gun cover offer. As success second certainly.,12:23:02,IMPS
YZPK79958559760714,GB20RWFE52559459549428,12/8/2019,4756.07,100002,N,Credited,SAFARI,MOBILE,Cr,15:26:32,16:30:47,2/20/2020,35896159,1770.58,4,"Well big student later side safe half. With fact into part. Majority recent sell some. Wonder suffer wife including.
Including throughout next decade case finally. Religious bad kitchen.",16:01:38,UPI
YZPK79958559760714,GB20RWFE52559459549428,12/8/2019,6526.65,100002,N,Credited,CHROME,PC,Cr,22:16:21,25:16:15,2/20/2020,68507404,1770.58,4,"Base dinner new spring.
Weight voice never return. Expert use these both over. Local item couple investment group yet.",23:36:18,UPI
YZPK79958559760714,GB20RWFE52559459549428,12/8/2019,6612.9,100002,N,Credited,FF,MOBILE,Cr,7:54:34,10:55:27,2/23/2020,80638988,86.25,3,"Leader Democrat its reach. Worker others situation. What represent artist race color choice yourself.
Kitchen game garden show local also face history. Against federal west.",8:36:35,RTGS
YZPK79958559760714,GB20RWFE52559459549428,12/8/2019,6526.65,100002,Y,Medicals,EDGE,MOBILE,Dr,7:19:10,11:54:17,2/23/2020,84248893,86.25,7,Way road Democrat myself now summer. Home this recently. Today live wait Mrs word organization.,9:37:19,DD
YZPK79958559760714,GB20RWFE52559459549428,12/8/2019,6440.4,100002,Y,Entertainment,MI,PC,Dr,14:02:01,15:41:53,2/23/2020,32707700,86.25,7,"Center partner magazine or drug. Successful catch level subject.
Need matter product nearly smile rate. Former too like century.",14:33:18,DD
YZPK79958559760714,GB20RWFE52559459549428,12/8/2019,6354.15,100002,Y,Insurance,IE,MOBILE,Dr,20:45:53,25:22:16,2/23/2020,43594498,86.25,5,"Bar add market their activity. If leave amount live. Remain between focus born according find.
Administration hour order figure moment. Control modern just pass. Arm interest effect case safe.",23:02:48,CARDS
YZPK79958559760714,GB20RWFE52559459549428,12/8/2019,7304.5,100002,N,Credited,MI,PC,Cr,14:36:12,18:49:10,2/27/2020,5978335,950.35,7,Movie buy other. Instead top challenge argue reason character. Charge send throw lead all experience sound. Generation very campaign baby pretty about.,15:34:27,DD
YZPK79958559760714,GB20RWFE52559459549428,12/8/2019,8254.85,100002,N,Credited,SAFARI,MOBILE,Cr,19:51:58,25:47:41,2/27/2020,35586432,950.35,3,Wish mention determine treat understand able report. Everyone shake agent program everybody easy. Seat discuss which stage plan care.,23:47:45,RTGS
YZPK79958559760714,GB20RWFE52559459549428,12/8/2019,6292.15,100002,Y,Dining,EDGE,MOBILE,Dr,6:31:34,12:13:28,3/2/2020,33176758,1962.7,1,National prove strategy adult suffer against task. Door wife away forward year present. Minute much either available movement.,9:17:51,NEFT
YZPK79958559760714,GB20RWFE52559459549428,12/8/2019,4329.45,100002,Y,Medicals,EDGE,MOBILE,Dr,14:50:31,17:38:02,3/2/2020,12770205,1962.7,7,"Wife think notice probably. Well century high.
Class project its because. Involve through reduce face today response seven.",16:44:00,DD
YZPK79958559760714,GB20RWFE52559459549428,12/8/2019,6292.15,100002,N,Credited,EDGE,PC,Cr,18:51:40,21:07:26,3/2/2020,50323869,1962.7,3,"Care then image push government person minute. Special back central away easy.
Result or well society cell newspaper owner. Real arrive shoulder become couple. Win into attack.",20:30:33,RTGS
YZPK79958559760714,GB20RWFE52559459549428,12/8/2019,6191.18,100002,Y,Entertainment,EDGE,MOBILE,Dr,12:37:37,19:55:33,3/11/2020,49490619,100.97,7,Administration staff likely leader heavy suffer. Off series what song.,18:10:39,DD
YZPK79958559760714,GB20RWFE52559459549428,12/8/2019,4786.71,100002,Y,Personal Care,FF,PC,Dr,8:06:30,11:37:00,3/16/2020,37984274,1404.47,4,Determine include eat eye point. Race figure win former start. Here heavy before light court.,9:19:28,UPI
YZPK79958559760714,GB20RWFE52559459549428,12/8/2019,3382.24,100002,Y,Personal Care,IE,POS,Dr,9:55:50,15:33:42,3/16/2020,53794109,1404.47,6,"Safe under current room compare per senior. Yes together culture sometimes sure half school after.
Arm rock push final. Keep describe minute he attorney. At agency citizen floor.",12:42:45,CHEQUE
YZPK79958559760714,GB20RWFE52559459549428,12/8/2019,1977.77,100002,Y,Rent,CHROME,MOBILE,Dr,18:46:30,23:54:16,3/16/2020,98439911,1404.47,4,Evidence teacher expert act that outside man. Difference operation may important present kitchen drive.,21:10:10,UPI
YZPK79958559760714,GB20RWFE52559459549428,12/8/2019,1409.23,100002,Y,Groceries,SAFARI,PC,Dr,6:39:59,8:39:29,3/20/2020,72768075,568.54,6,Doctor old throw while bit lead sound. Prepare must section any investment. Machine past but those significant company production.,7:19:11,CHEQUE
YZPK79958559760714,GB20RWFE52559459549428,12/8/2019,840.69,100002,Y,Dining,MI,MOBILE,Dr,17:14:18,20:02:02,3/20/2020,66001461,568.54,4,"Charge social receive phone nearly per such. Ground quickly whose difference by office.
Someone into support life teach control. Spring listen daughter still will.",17:54:42,UPI
YZPK79958559760714,GB20RWFE52559459549428,12/8/2019,1409.23,100002,N,Credited,SAFARI,MOBILE,Cr,17:04:55,20:58:41,3/20/2020,49694017,568.54,1,Sit take audience out line. Reason house yard record level offer. Mouth with believe car drug stuff most.,19:28:03,NEFT
YZPK79958559760714,GB20RWFE52559459549428,12/8/2019,2105.57,100002,N,Credited,MI,MOBILE,Cr,8:16:22,18:30:18,3/21/2020,99540067,696.34,4,Like including line culture move yet sort cultural. Despite speech provide company travel level term pretty.,13:49:09,UPI
YZPK79958559760714,GB20RWFE52559459549428,12/8/2019,996.84,100002,Y,Transportation,EDGE,MOBILE,Dr,17:46:02,25:14:15,4/5/2020,19593623,1108.73,4,College middle big suggest energy hit message. Put mother ten no change have. Upon he property pick various identify ok. Finally or whom color purpose product.,20:31:36,UPI
YZPK79958559760714,GB20RWFE52559459549428,12/8/2019,669.5,100002,Y,Medicals,FF,MOBILE,Dr,7:34:20,12:35:39,4/11/2020,61218802,327.34,2,"Person small project account no. Apply country foreign scientist discover else. Oil eat serve nothing especially yeah.
Hit defense then economic senior. Force not understand like main.",9:37:47,IMPS
YZPK79958559760714,GB20RWFE52559459549428,12/8/2019,996.84,100002,N,Credited,IE,MOBILE,Cr,13:31:26,17:14:06,4/11/2020,4844655,327.34,3,"Small adult spring individual man despite. Officer action pressure piece eye mouth mission.
Arrive black purpose indicate. Cost unit understand base both. Build into evening rest.",14:59:03,RTGS
YZPK79958559760714,GB20RWFE52559459549428,12/8/2019,1324.18,100002,N,Credited,OPERA,POS,Cr,21:53:28,25:39:07,4/11/2020,84471475,327.34,7,"Fly hour peace leave room increase. Instead fact attack single beat agree. Trial third professor floor war information.
Drug play plant himself. General fish wish middle.",23:01:21,DD
YZPK79958559760714,GB20RWFE52559459549428,12/8/2019,2091.44,100002,N,Credited,IE,POS,Cr,5:07:26,7:16:36,4/12/2020,35781653,767.26,6,"Movement true language only while happen. Environment call almost else record.
Born face its hand piece head. Month manager decide record activity.",5:43:01,CHEQUE
YZPK79958559760714,GB20RWFE52559459549428,12/8/2019,1324.18,100002,Y,Entertainment,CHROME,MOBILE,Dr,10:51:46,13:32:26,4/12/2020,1763584,767.26,1,"Either reduce behind resource. Toward interesting stay provide action themselves.
Term lead baby quality. Expert candidate guy pay night worry peace.",11:38:30,NEFT
YZPK79958559760714,GB20RWFE52559459549428,12/8/2019,556.92,100002,Y,Medicals,CHROME,POS,Dr,11:34:27,13:48:16,4/12/2020,8838452,767.26,6,"Piece we bank investment citizen run. Data fill human religious seem film.
Future money sort remember item glass. Ground enough whatever mother building. Daughter mother full recently.",12:31:34,CHEQUE
YZPK79958559760714,GB20RWFE52559459549428,12/8/2019,1324.18,100002,N,Credited,EDGE,POS,Cr,22:10:20,23:39:28,4/12/2020,74647767,767.26,1,"Upon heart article argue yes like service address. Different leave above sure.
Always manage community to thus service laugh. Edge ready town even. Perform worry purpose thank security region.",23:07:36,NEFT
YZPK79958559760714,GB20RWFE52559459549428,12/8/2019,3140.13,100002,N,Credited,EDGE,POS,Cr,15:51:04,21:43:54,4/27/2020,64227351,1815.95,7,"Modern indeed kind sing phone. Television poor test range say great. Its property still.
Other could himself cold. Contain skin use dream coach thank more.",18:38:08,DD
YZPK79958559760714,GB20RWFE52559459549428,12/8/2019,3696.49,100002,N,Credited,MI,MOBILE,Cr,8:23:03,16:30:40,5/1/2020,17208550,556.36,3,"Whatever young with ever age truth natural.
Shake according activity yeah join inside. Whole worker region. Write nation others walk billion cut. Family gun tell.",13:52:07,RTGS
YZPK79958559760714,GB20RWFE52559459549428,12/8/2019,4423.4,100002,N,Credited,EDGE,POS,Cr,7:35:45,9:38:07,5/2/2020,32344165,726.91,1,"Rather realize reality kid. Impact analysis between lead behind. Just fish out customer.
Dog morning ball apply shoulder. Hear later six sure personal down speech.
Enjoy see case yard fly best put.",8:31:54,NEFT
YZPK79958559760714,GB20RWFE52559459549428,12/8/2019,3696.49,100002,Y,Insurance,OPERA,MOBILE,Dr,13:27:55,15:58:36,5/2/2020,5454839,726.91,2,"Investment so film. Tv why over free trouble media here. Through bank until six.
Scene compare blood dream even make natural.",14:01:27,IMPS
YZPK79958559760714,GB20RWFE52559459549428,12/8/2019,4423.4,100002,N,Credited,EDGE,PC,Cr,15:52:20,18:51:40,5/2/2020,20608606,726.91,1,"Fly this second short serve site also. Speech nearly can boy management use.
Board up many city best animal record. Project including pick fast research actually people raise.",17:58:30,NEFT
YZPK79958559760714,GB20RWFE52559459549428,12/8/2019,5150.31,100002,N,Credited,MI,MOBILE,Cr,18:13:43,21:37:18,5/2/2020,28644293,726.91,2,Free force point capital ball. To until relationship social democratic kitchen mouth. On here dream amount west when. Customer responsibility far financial.,19:47:15,IMPS
YZPK79958559760714,GB20RWFE52559459549428,12/8/2019,4868.29,100002,Y,Utilities,SAFARI,MOBILE,Dr,7:23:56,8:48:52,5/4/2020,16075856,282.02,5,Threat step consider chance less. Model suddenly last there form. Seem finish my even sea analysis operation media.,7:59:46,CARDS
YZPK79958559760714,GB20RWFE52559459549428,12/8/2019,5150.31,100002,N,Credited,SAFARI,MOBILE,Cr,8:16:17,10:48:38,5/4/2020,76720215,282.02,4,"Same how plant low security nor. Onto perform move stock space population.
Away management bad her hand such. List head hit then.",9:00:34,UPI
YZPK79958559760714,GB20RWFE52559459549428,12/8/2019,4868.29,100002,Y,Utilities,MI,MOBILE,Dr,12:08:02,14:08:04,5/4/2020,34240632,282.02,2,"Play against perform foot. Order person fine view tax make room culture. Process take author quickly sing.
His job executive job. Resource interest event teach player. Against green garden entire.",13:03:22,IMPS
YZPK79958559760714,GB20RWFE52559459549428,12/8/2019,5150.31,100002,N,Credited,CHROME,PC,Cr,16:46:59,17:59:37,5/4/2020,99089146,282.02,7,Involve lot add change fly. Decision official speak agree discussion television. Identify approach forward range single skill. Sea green explain television.,17:26:54,DD
YZPK79958559760714,GB20RWFE52559459549428,12/8/2019,5432.33,100002,N,Credited,SAFARI,MOBILE,Cr,22:10:39,24:29:11,5/4/2020,15652447,282.02,6,Soldier key begin add fish authority. International anything chair blood. Let dinner agent. Building stage thing crime race continue whom.,23:18:07,CHEQUE
YZPK79958559760714,GB20RWFE52559459549428,12/8/2019,4031.04,100002,Y,Household Consumables,IE,MOBILE,Dr,14:59:12,22:41:37,5/7/2020,62732901,1401.29,7,"Environmental turn west difference movement truth. Finally part business but.
Easy spend lot quite we mean. Spring board voice hour. Police see main spend fire born.",20:39:08,DD
YZPK79958559760714,GB20RWFE52559459549428,12/8/2019,3229.56,100002,Y,Transportation,EDGE,POS,Dr,5:03:51,7:14:09,5/14/2020,30832275,801.48,6,Concern between lawyer week. Rather forward especially maintain friend admit recognize. Success agreement possible recent resource thing live fish.,6:27:18,CHEQUE
YZPK79958559760714,GB20RWFE52559459549428,12/8/2019,4031.04,100002,N,Credited,EDGE,PC,Cr,11:57:26,15:03:21,5/14/2020,22376305,801.48,6,Maybe figure news reduce pattern. Debate health just front paper play. Thus collection American class.,13:33:28,CHEQUE
YZPK79958559760714,GB20RWFE52559459549428,12/8/2019,3229.56,100002,Y,Groceries,IE,POS,Dr,15:37:50,18:13:02,5/14/2020,76395291,801.48,2,Effort camera throw. Learn me thousand law. Well sound fact surface yeah. Hold heavy particularly benefit religious scene bring foot.,16:13:42,IMPS
YZPK79958559760714,GB20RWFE52559459549428,12/8/2019,4031.04,100002,N,Credited,EDGE,MOBILE,Cr,18:22:18,21:37:56,5/14/2020,10330210,801.48,6,"While two drive sing really blood. Cost whatever side item common less far. Live west rich usually hold.
Organization measure public. Figure risk red these develop.",19:56:14,CHEQUE
YZPK79958559760714,GB20RWFE52559459549428,12/8/2019,3688.11,100002,Y,Transportation,OPERA,PC,Dr,4:00:37,7:00:24,5/18/2020,61116993,342.93,3,"Give little nature use. Article film rise tree. Development me break discover law.
Official hair well camera. Single artist four cut street development relationship. President style floor turn.",5:58:34,RTGS
YZPK79958559760714,GB20RWFE52559459549428,12/8/2019,4031.04,100002,N,Credited,MI,MOBILE,Cr,11:46:54,15:19:30,5/18/2020,385565,342.93,1,"Government visit place church fast. About teacher once commercial six thank there. Seek throughout situation upon stand start they.
Young series certain prove certain special face.",13:09:24,NEFT
YZPK79958559760714,GB20RWFE52559459549428,12/8/2019,4373.97,100002,N,Credited,MI,MOBILE,Cr,16:55:58,21:08:34,5/18/2020,61351707,342.93,7,Last wear figure current let product guess. Near sport tax thought natural energy serve. North cup hospital avoid fall business hit knowledge.,18:46:46,DD
YZPK79958559760714,GB20RWFE52559459549428,12/8/2019,4031.04,100002,Y,Dining,CHROME,MOBILE,Dr,21:00:13,23:41:54,5/18/2020,19339320,342.93,1,"Theory now everybody economic support provide. Key vote test vote its anyone line.
International support fight four describe performance statement. Thus dark raise.",22:02:18,NEFT
YZPK79958559760714,GB20RWFE52559459549428,12/8/2019,5122.08,100002,N,Credited,MI,POS,Cr,3:36:12,6:36:26,5/22/2020,14146855,1091.04,2,"Media along explain more company new. Recognize agree issue consider. Bring rise how girl.
Audience moment plant only. Expect image market. Letter produce exist hard really end benefit.",5:31:48,IMPS
YZPK79958559760714,GB20RWFE52559459549428,12/8/2019,6213.12,100002,N,Credited,MI,MOBILE,Cr,10:21:05,12:28:02,5/22/2020,21677373,1091.04,3,"City realize our answer. Interview standard way compare here wrong.
Operation television politics finally. Hard reduce board.
Wish side north anyone environment style author.",11:42:55,RTGS
YZPK79958559760714,GB20RWFE52559459549428,12/8/2019,5122.08,100002,Y,Dining,SAFARI,MOBILE,Dr,11:53:19,14:43:22,5/22/2020,80343554,1091.04,2,Seven structure commercial son order. Film whose certainly song paper quality position must. Him never long growth including letter air.,12:49:14,IMPS
YZPK79958559760714,GB20RWFE52559459549428,12/8/2019,4031.04,100002,Y,Rent,CHROME,PC,Dr,17:23:33,20:06:30,5/22/2020,11227335,1091.04,6,"Behavior I statement fight manager. Thought break down keep. Support ball real deep wind until character.
Consumer anything economic off last. Protect most money either pretty.",18:37:50,CHEQUE
YZPK79958559760714,GB20RWFE52559459549428,12/8/2019,5122.08,100002,N,Credited,OPERA,PC,Cr,21:12:12,23:14:40,5/22/2020,87921069,1091.04,1,"Again standard hundred figure anything vote campaign. Able arrive course carry wife.
Remember how factor bar line live attack. Anyone simply still nearly determine most.",22:43:59,NEFT
YZPK79958559760714,GB20RWFE52559459549428,12/8/2019,5224.77,100002,N,Credited,MI,PC,Cr,20:21:45,24:59:50,5/24/2020,12485932,102.69,6,Dog no single operation soldier mission. Against line concern trip third voice less.,23:00:22,CHEQUE
YZPK79958559760714,GB20RWFE52559459549428,12/8/2019,3388.91,100002,Y,Personal Care,EDGE,POS,Dr,7:21:36,10:17:56,5/27/2020,6130817,1835.86,7,Field floor home cup. Bag which share. Its account mouth identify participant option hair.,8:35:00,DD
YZPK79958559760714,GB20RWFE52559459549428,12/8/2019,5224.77,100002,N,Credited,FF,POS,Cr,14:22:19,16:56:55,5/27/2020,27007648,1835.86,6,"Foot right degree so last.
Behind either government leg. Policy doctor people speech according happen. Teach foreign strong Mrs side team good too.",15:58:33,CHEQUE
YZPK79958559760714,GB20RWFE52559459549428,12/8/2019,3388.91,100002,Y,Dining,CHROME,MOBILE,Dr,15:36:20,19:13:09,5/27/2020,39276315,1835.86,2,Toward of writer out let. Right real sport close too. True wonder I white.,18:16:10,IMPS
YZPK79958559760714,GB20RWFE52559459549428,12/8/2019,3306.3,100002,Y,Entertainment,SAFARI,MOBILE,Dr,6:51:30,9:07:27,6/3/2020,32413168,82.61,6,Involve down writer same present group. Live green term rock feel notice institution.,7:19:21,CHEQUE
YZPK79958559760714,GB20RWFE52559459549428,12/8/2019,3223.69,100002,Y,Personal Care,MI,PC,Dr,9:47:07,11:29:21,6/3/2020,66386728,82.61,2,"Wear approach work in. Buy attention change because family kind process. Partner rather myself difficult can.
Stand say provide soon with place positive. Another send camera nearly point.",10:23:40,IMPS
YZPK79958559760714,GB20RWFE52559459549428,12/8/2019,3306.3,100002,N,Credited,IE,MOBILE,Cr,12:30:54,15:24:07,6/3/2020,50109234,82.61,5,"Himself student never forget center. Doctor me feeling.
Low result view left record term. Always Mrs traditional. Among true imagine agency down.",13:55:05,CARDS
YZPK79958559760714,GB20RWFE52559459549428,12/8/2019,3388.91,100002,N,Credited,FF,POS,Cr,15:57:19,17:54:08,6/3/2020,14644832,82.61,6,Chance add manage analysis deep yard section. Large worker chair score provide water. General majority church they customer something.,16:45:46,CHEQUE
YZPK79958559760714,GB20RWFE52559459549428,12/8/2019,3306.3,100002,Y,Groceries,FF,MOBILE,Dr,21:58:43,25:07:53,6/3/2020,98211784,82.61,1,"Window civil time physical take hair. Market son international. Get body budget.
Chair event always wish local issue. Color six look feel yard project.",23:20:47,NEFT
YZPK79958559760714,GB20RWFE52559459549428,12/8/2019,3957.09,100002,N,Credited,EDGE,POS,Cr,10:29:54,15:09:03,6/6/2020,17886543,650.79,3,Into relate fast expert example ground. A case thing rule game. Response network move despite. And situation religious spring.,13:13:35,RTGS
YZPK79958559760714,GB20RWFE52559459549428,12/8/2019,3306.3,100002,Y,Insurance,FF,POS,Dr,20:33:07,24:19:13,6/6/2020,23524415,650.79,2,Call know measure strategy require argue home. Prepare finish national land. Arrive resource next old happy girl show.,22:08:38,IMPS
YZPK79958559760714,GB20RWFE52559459549428,12/8/2019,2048.16,100002,Y,Personal Care,OPERA,PC,Dr,3:30:26,5:40:07,6/19/2020,18313703,1258.14,1,"Police nearly discussion benefit. Will reflect sense support fight. Hair something point must here work animal.
Value game member marriage possible news. Least important war.",4:55:50,NEFT
YZPK79958559760714,GB20RWFE52559459549428,12/8/2019,790.02,100002,Y,Rent,CHROME,MOBILE,Dr,8:18:08,10:33:45,6/19/2020,28704676,1258.14,1,"Movement site big commercial clearly test. Would bad yet born. Challenge fast model pretty back not.
You decision season ok management stop eight. Short choose wait focus receive.",10:02:32,NEFT
YZPK79958559760714,GB20RWFE52559459549428,12/8/2019,2048.16,100002,N,Credited,SAFARI,PC,Cr,12:42:16,15:03:54,6/19/2020,10333921,1258.14,3,Coach should really who indeed thought office. Send agree hair do smile film although. Thousand business experience behind board.,13:44:37,RTGS
YZPK79958559760714,GB20RWFE52559459549428,12/8/2019,3306.3,100002,N,Credited,EDGE,PC,Cr,14:26:06,18:09:57,6/19/2020,47892859,1258.14,5,"Common always money quickly style concern up. Tend local region large door worry. Occur record friend best.
Risk out free believe. Firm account society fight. Imagine ground down she fund.",16:14:45,CARDS
YZPK79958559760714,GB20RWFE52559459549428,12/8/2019,4564.44,100002,N,Credited,MI,MOBILE,Cr,19:38:49,21:21:05,6/19/2020,25596359,1258.14,3,"Quickly senior behind. Detail attention care trip someone.
Country know born allow page section political. Perform good mean performance interest impact similar.",20:55:17,RTGS
YZPK79958559760714,GB20RWFE52559459549428,12/8/2019,6002.17,100002,N,Credited,IE,MOBILE,Cr,8:11:38,10:49:08,7/2/2020,14007095,1437.73,7,"Tell paper next likely manage eat. Five there study southern boy.
Create own tell rock final current. Article require number seven last glass boy. Him threat physical offer his standard.",8:58:29,DD
YZPK79958559760714,GB20RWFE52559459549428,12/8/2019,4564.44,100002,Y,Medicals,SAFARI,POS,Dr,12:34:53,16:14:13,7/2/2020,13204501,1437.73,4,"Machine many notice white sell today. Away opportunity stand study science catch.
World more fight state. Past change side message fear.
Detail traditional challenge.",14:05:04,UPI
YZPK79958559760714,GB20RWFE52559459549428,12/8/2019,3126.71,100002,Y,Household Consumables,IE,PC,Dr,16:08:09,19:03:35,7/2/2020,20727208,1437.73,3,Term measure us information watch. Arrive wall relationship place. Base check officer bank speak.,18:30:26,RTGS
YZPK79958559760714,GB20RWFE52559459549428,12/8/2019,1688.98,100002,Y,Medicals,SAFARI,POS,Dr,20:08:22,22:40:12,7/2/2020,80359043,1437.73,7,"Space college must know its beyond seem politics. Team air which heart bit office develop.
Management street it single network. Man true goal left war program.",21:07:23,DD
YZPK79958559760714,GB20RWFE52559459549428,12/8/2019,48.6,100002,Y,Medicals,SAFARI,MOBILE,Dr,12:47:07,16:10:51,7/3/2020,41671719,1640.38,4,"Language draw tonight six reason. Cell smile determine light summer.
Treatment stay state address computer next leg. Forget local movement heavy. Daughter industry future thing want toward look.",14:57:21,UPI
YZPK79958559760714,GB20RWFE52559459549428,12/8/2019,1688.98,100002,N,Credited,CHROME,MOBILE,Cr,14:51:51,20:53:12,7/3/2020,80364689,1640.38,4,"Because manage away choice. Cup economy ground less human. Book page stuff international rock everything.
Sea between others treat stand. By home interest send century.",18:03:26,UPI
YZPK79958559760714,GB20RWFE52559459549428,12/8/2019,2263.19,100002,N,Credited,EDGE,POS,Cr,13:37:43,24:02:32,7/4/2020,71050782,574.21,1,"Material who prove before consumer religious. Part together cold pick arm. Culture money realize explain beautiful Mrs.
Article hold season expect space.",19:35:06,NEFT
YZPK79958559760714,GB20RWFE52559459549428,12/8/2019,1343.27,100002,Y,Transportation,SAFARI,POS,Dr,10:22:08,17:24:44,7/12/2020,50113460,919.92,6,Easy herself purpose firm note nice avoid on. Other from light safe human may. Base find page happen industry realize.,13:39:25,CHEQUE
YZPK79958559760714,GB20RWFE52559459549428,12/8/2019,2263.19,100002,N,Credited,EDGE,PC,Cr,21:05:16,24:58:24,7/12/2020,34613917,919.92,7,"Push page without ball.
Medical walk who house enter image far. Tree put indeed situation. Situation by article human.",22:33:42,DD
YZPK79958559760714,GB20RWFE52559459549428,12/8/2019,2584.01,100002,N,Credited,SAFARI,MOBILE,Cr,4:47:00,9:16:11,7/15/2020,83510908,320.82,4,"Matter to child among fall cover bank. Manage spend different image.
This make opportunity. Employee fear your camera room assume small. Usually concern box push not.",6:20:12,UPI
YZPK79958559760714,GB20RWFE52559459549428,12/8/2019,2263.19,100002,Y,Utilities,SAFARI,POS,Dr,13:33:32,15:50:27,7/15/2020,21188336,320.82,4,"Why return break have audience single. Standard bed meeting fish knowledge. Baby sport most account everybody explain.
Top from push speech. Customer tend middle clearly.",14:53:07,UPI
YZPK79958559760714,GB20RWFE52559459549428,12/8/2019,1942.37,100002,Y,Personal Care,FF,POS,Dr,21:08:29,26:44:22,7/15/2020,69137914,320.82,5,Mind center clearly water stand authority staff. Picture avoid television question beyond word common chance. Fly significant east form. Change effect level suggest several.,23:52:44,CARDS
YZPK79958559760714,GB20RWFE52559459549428,12/8/2019,2909.39,100002,N,Credited,OPERA,POS,Cr,5:32:26,7:29:38,8/9/2020,38615177,967.02,1,Defense society ball drive. Gas population happen fast really two. Evening sport suggest hit identify international cover.,6:51:25,NEFT
YZPK79958559760714,GB20RWFE52559459549428,12/8/2019,1942.37,100002,Y,Groceries,SAFARI,MOBILE,Dr,7:54:16,11:07:46,8/9/2020,29224081,967.02,5,"Position simple system direction man budget whom structure. Daughter now operation similar treatment.
Firm pressure although. Hold rest any protect.",9:26:57,CARDS
YZPK79958559760714,GB20RWFE52559459549428,12/8/2019,975.35,100002,Y,Household Consumables,FF,POS,Dr,11:54:14,13:32:24,8/9/2020,22488220,967.02,7,"What amount continue. Charge unit value consider stop skill. Human financial build view. Instead full benefit heart who.
Citizen pattern still matter series.",12:58:14,DD
YZPK79958559760714,GB20RWFE52559459549428,12/8/2019,8.33,100002,Y,Household Consumables,IE,POS,Dr,17:16:13,19:32:00,8/9/2020,44612016,967.02,6,"Born store myself moment both finish picture. Industry culture without run.
Picture study whom wind cup speak. Finish someone rise life seat well wrong. Laugh eye speech five.",17:56:58,CHEQUE
YZPK79958559760714,GB20RWFE52559459549428,12/8/2019,875.05,100002,N,Credited,CHROME,MOBILE,Cr,12:42:33,14:33:52,8/25/2020,98467761,866.72,5,"Share say response fast newspaper anyone understand. Figure reflect debate nothing training point.
Serious life player set new.",13:43:49,CARDS
YZPK79958559760714,GB20RWFE52559459549428,12/8/2019,1741.77,100002,N,Credited,MI,PC,Cr,20:08:47,22:19:29,8/25/2020,66943631,866.72,3,Top value pick you reach once several including. Space hundred there report series. Even also issue improve unit well.,21:28:39,RTGS
YZPK79958559760714,GB20RWFE52559459549428,12/8/2019,177.39,100002,Y,Medicals,SAFARI,MOBILE,Dr,12:20:28,21:05:18,9/7/2020,44957285,1564.38,4,"Ahead dark price will concern. Believe someone protect sit development size.
Include behavior light detail cold stay base. Quickly happen or then onto.",17:43:28,UPI
YZPK79958559760714,GB20RWFE52559459549428,12/8/2019,1680.45,100002,N,Credited,FF,POS,Cr,20:10:36,25:59:12,9/16/2020,19746975,1503.06,6,"Near special itself serious imagine affect. Lay black teach nor no song.
Nor their particular clearly investment involve hundred. By but anyone.",22:26:07,CHEQUE
YZPK79958559760714,GB20RWFE52559459549428,12/8/2019,1480.29,100002,Y,Personal Care,MI,PC,Dr,4:28:49,6:45:59,10/10/2020,6664367,200.16,3,Over win painting risk concern. Process break fine truth approach. Line third level number whole care.,5:48:27,RTGS
YZPK79958559760714,GB20RWFE52559459549428,12/8/2019,1280.13,100002,Y,Groceries,IE,POS,Dr,8:37:56,12:56:27,10/10/2020,98993840,200.16,4,"Style probably let rise join hour section their. Trip culture point Congress model.
Send through quite few watch. Inside office may inside Democrat wife.",10:49:49,UPI
YZPK79958559760714,GB20RWFE52559459549428,12/8/2019,1480.29,100002,N,Credited,FF,MOBILE,Cr,13:35:46,16:01:06,10/10/2020,44723088,200.16,2,Bar party do question. Media base statement office report anything. Form bag big owner heavy tonight once.,14:24:52,IMPS
YZPK79958559760714,GB20RWFE52559459549428,12/8/2019,1280.13,100002,Y,Online Shopping,FF,PC,Dr,21:49:41,23:52:02,10/10/2020,61796287,200.16,4,"Yourself executive ahead history simple standard according less. Account yourself as car offer charge.
Least though high dog hour subject improve. May heart director none customer Democrat.",23:06:14,UPI
YZPK79958559760714,GB20RWFE52559459549428,12/8/2019,1534.06,100002,N,Credited,EDGE,POS,Cr,9:12:56,13:25:55,10/14/2020,64658711,253.93,2,"Here we find focus stage lay. Increase maybe experience learn hard her attention.
May discuss agree teacher billion. Return foot picture.",10:52:12,IMPS
YZPK79958559760714,GB20RWFE52559459549428,12/8/2019,1787.99,100002,N,Credited,EDGE,PC,Cr,15:33:14,19:30:09,10/14/2020,5371730,253.93,5,"Major suggest federal simple put many rise herself. Myself forget large case speech. Wrong TV what election lot while resource.
Leave easy and face. Store such ball event.",16:48:05,CARDS
YZPK79958559760714,GB20RWFE52559459549428,12/8/2019,1534.06,100002,Y,Transportation,IE,PC,Dr,20:46:02,24:10:32,10/14/2020,47699700,253.93,2,Technology executive else mention else one administration. Nation century ground animal color. Economy business key agreement to address those. Foreign thought cause whose.,22:43:04,IMPS
YZPK79958559760714,GB20RWFE52559459549428,12/8/2019,2873,100002,N,Credited,OPERA,PC,Cr,3:17:57,6:07:34,11/7/2020,63176162,1338.94,6,"Lose where help character walk usually. Fly behavior key thus couple. Suffer all very technology put live.
Source activity late write.",5:07:00,CHEQUE
YZPK79958559760714,GB20RWFE52559459549428,12/8/2019,4211.94,100002,N,Credited,FF,PC,Cr,11:32:48,14:09:41,11/7/2020,52021541,1338.94,2,"Himself enter response free back mouth way. Either subject face. Anyone boy record.
Dream least figure option apply then. Anyone argue east serious poor. Important take later civil offer fine rather.",12:40:43,IMPS
YZPK79958559760714,GB20RWFE52559459549428,12/8/2019,2873,100002,Y,Groceries,EDGE,MOBILE,Dr,15:35:10,19:11:40,11/7/2020,90490866,1338.94,6,"Cup hair break us once. Drug possible Democrat our among. Whole like side never own.
Want performance probably back. Finish include type team.",16:59:14,CHEQUE
YZPK79958559760714,GB20RWFE52559459549428,12/8/2019,4211.94,100002,N,Credited,OPERA,PC,Cr,18:33:10,21:43:38,11/7/2020,17392235,1338.94,4,"Out will defense day significant war.
Approach me stay push. Wall produce old low price.
Plan bring edge partner once. Its yes cell suddenly father treatment partner. Question run enter.",19:36:36,UPI
YZPK79958559760714,GB20RWFE52559459549428,12/8/2019,4668.74,100002,N,Credited,CHROME,POS,Cr,3:25:59,7:11:53,11/11/2020,29769933,456.8,7,Parent account message new gas others baby. Her term them agent lot. We shoulder realize budget.,5:41:15,DD
YZPK79958559760714,GB20RWFE52559459549428,12/8/2019,5125.54,100002,N,Credited,IE,MOBILE,Cr,9:30:28,11:33:58,11/11/2020,67825523,456.8,6,Pattern current result street section member body. Discussion until Mr. Present fight happen pull keep. Present treatment last what than agency would lose.,11:02:51,CHEQUE
YZPK79958559760714,GB20RWFE52559459549428,12/8/2019,4668.74,100002,Y,Personal Care,MI,PC,Dr,16:22:27,18:46:03,11/11/2020,26233444,456.8,7,Scene talk prevent participant. Case common modern summer thing father across heart.,17:06:53,DD
YZPK79958559760714,GB20RWFE52559459549428,12/8/2019,5125.54,100002,N,Credited,CHROME,PC,Cr,19:06:12,20:15:12,11/11/2020,43323951,456.8,6,Outside themselves course game long. Difficult investment country poor. Even able water a him happen their.,19:44:44,CHEQUE
YZPK79958559760714,GB20RWFE52559459549428,12/8/2019,6907.32,100002,N,Credited,IE,MOBILE,Cr,14:36:29,20:09:46,11/13/2020,54349292,1781.78,6,Item out ahead boy. Economic lose event. Art receive only still still upon she.,18:16:56,CHEQUE
YZPK79958559760714,GB20RWFE52559459549428,12/8/2019,5879.8,100002,Y,Transportation,SAFARI,PC,Dr,5:30:00,6:42:56,11/24/2020,36352357,1027.52,3,"Phone however arrive Democrat tend though choice. Million suddenly make stay modern name. Table different research reveal executive. Thus summer industry human.
Physical thank force dark smile.",5:54:08,RTGS
YZPK79958559760714,GB20RWFE52559459549428,12/8/2019,6907.32,100002,N,Credited,OPERA,POS,Cr,8:58:22,10:55:03,11/24/2020,24935425,1027.52,4,"Kind third necessary result. Accept price after hear popular site yourself.
Condition face medical approach enjoy stuff back.",10:23:22,UPI
YZPK79958559760714,GB20RWFE52559459549428,12/8/2019,7934.84,100002,N,Credited,OPERA,POS,Cr,10:54:29,13:56:20,11/24/2020,87815566,1027.52,5,"Practice they born social support office five sea. Thus page form research camera. Whole several notice place end fear.
Character network several production meeting.",12:30:34,CARDS
YZPK79958559760714,GB20RWFE52559459549428,12/8/2019,8962.36,100002,N,Credited,IE,MOBILE,Cr,17:35:07,20:51:49,11/24/2020,7099120,1027.52,1,"Piece cause interview letter. Doctor major pressure.
Involve right miss under husband name recent. Attention finish check different. Bring meet meeting building.",19:33:21,NEFT
YZPK79958559760714,GB20RWFE52559459549428,12/8/2019,7934.84,100002,Y,Personal Care,MI,PC,Dr,19:37:03,21:16:48,11/24/2020,56922301,1027.52,2,Senior appear weight beat later then. Thought finally standard into something with. Above base participant day later believe.,20:52:39,IMPS
YZPK79958559760714,GB20RWFE52559459549428,12/8/2019,6712,100002,Y,Dining,FF,PC,Dr,5:06:36,9:04:30,12/1/2020,31549622,1222.84,7,"Play song assume owner. Paper a relate. Thing lose hit middle front black expert.
Factor land none speak doctor again soldier. Myself service world after special realize.",7:17:21,DD
YZPK79958559760714,GB20RWFE52559459549428,12/8/2019,7934.84,100002,N,Credited,CHROME,POS,Cr,12:49:22,16:31:33,12/1/2020,14606274,1222.84,3,Understand must describe man perform series least close. Garden sister performance hold include understand now room.,14:13:35,RTGS
YZPK79958559760714,GB20RWFE52559459549428,12/8/2019,6712,100002,Y,Rent,MI,POS,Dr,22:22:37,25:30:03,12/1/2020,76760228,1222.84,2,"Idea him PM process realize meeting. Total down story institution executive nor establish raise. Have almost church.
Process up agent future fund. Town deep level.",23:15:41,IMPS
YZPK79958559760714,GB20RWFE52559459549428,12/8/2019,7351.99,100002,N,Credited,FF,MOBILE,Cr,10:04:25,15:46:49,12/15/2020,56668834,639.99,3,Full machine would decade edge whatever six. Race maybe government kid.,12:41:58,RTGS
YZPK79958559760714,GB20RWFE52559459549428,12/8/2019,7991.98,100002,N,Credited,MI,PC,Cr,20:17:07,23:46:08,12/15/2020,60511300,639.99,5,Fill people summer analysis form certainly bank officer. Experience not far through up doctor miss. Throughout benefit long ahead only.,22:06:27,CARDS
YZPK79958559760714,GB20RWFE52559459549428,12/8/2019,7887.88,100002,Y,Insurance,IE,POS,Dr,8:55:03,14:09:44,12/18/2020,10708125,104.1,7,"Important on south care line skill. Six ability election measure law gun capital learn.
National wide next seven kind.",12:47:59,DD
YZPK79958559760714,GB20RWFE52559459549428,12/8/2019,7991.98,100002,N,Credited,CHROME,POS,Cr,17:15:04,22:12:22,12/18/2020,28532118,104.1,7,"One important Republican could. Mean adult pressure. Important citizen long true.
Area factor buy author there ready. Eye decade herself someone along choice per.",20:35:36,DD
YZPK79958559760714,GB20RWFE52559459549428,12/8/2019,9405.36,100002,N,Credited,OPERA,POS,Cr,4:52:04,7:59:22,12/27/2020,22730053,1413.38,1,Sell many night something. Son statement sort long life hand describe or. Language growth must piece young yourself she write.,6:34:07,NEFT
YZPK79958559760714,GB20RWFE52559459549428,12/8/2019,7991.98,100002,Y,Groceries,FF,POS,Dr,6:39:51,9:08:08,12/27/2020,54311114,1413.38,2,My sense kitchen leave west. Would structure present expect once watch. Writer various treat including set.,8:34:58,IMPS
YZPK79958559760714,GB20RWFE52559459549428,12/8/2019,6578.6,100002,Y,Online Shopping,IE,POS,Dr,10:47:41,13:24:04,12/27/2020,76236686,1413.38,3,"Find central popular event understand example deal. Rather this teach future prove modern.
Stock design training manage particularly. Board close all land heavy.
Value some adult yes beat.",12:33:03,RTGS
YZPK79958559760714,GB20RWFE52559459549428,12/8/2019,5165.22,100002,Y,Utilities,FF,POS,Dr,17:40:54,19:15:26,12/27/2020,89221181,1413.38,6,"Become marriage technology. Accept many role threat seat nice.
Must ten community perform total more your. Table finally Mr may hold here. Production improve yeah sometimes wrong newspaper night.",18:36:24,CHEQUE
YZPK79958559760714,GB20RWFE52559459549428,12/8/2019,3751.84,100002,Y,Utilities,IE,POS,Dr,19:20:08,22:41:43,12/27/2020,40283210,1413.38,5,"Hospital history guy lawyer end would research. Parent trade office real Mrs scene.
Late art purpose student benefit probably economic he. Left simply son.",21:06:21,CARDS
YZPK79958559760714,GB20RWFE52559459549428,12/8/2019,4127.03,100002,N,Credited,OPERA,PC,Cr,10:50:55,13:44:23,12/30/2020,57248776,375.19,3,Kid himself answer teacher group feeling activity. Range this measure get expect experience evidence manage. Movement professor place deal.,12:23:25,RTGS
YZPK79958559760714,GB20RWFE52559459549428,12/8/2019,3751.84,100002,Y,Entertainment,SAFARI,PC,Dr,19:14:53,22:50:28,12/30/2020,8766397,375.19,6,"Agent purpose tough. Five small politics itself season because late across.
Candidate brother ok energy. Price size great design cold network.",21:44:42,CHEQUE
YZPK79958559760714,GB20RWFE52559459549428,12/8/2019,4785.89,100002,N,Credited,CHROME,PC,Cr,2:53:10,4:58:26,12/31/2020,65244043,1034.05,6,"Building fish space trial. Tax all present action large personal. Company compare sister tree.
Town protect sister account. Quality career news cut group sort. Two window size.",4:27:02,CHEQUE
YZPK79958559760714,GB20RWFE52559459549428,12/8/2019,3751.84,100002,Y,Personal Care,CHROME,POS,Dr,10:16:15,12:41:02,12/31/2020,67435388,1034.05,5,Ground although add partner television size term. Set great citizen green service. Turn draw where theory store national tonight.,11:03:30,CARDS
YZPK79958559760714,GB20RWFE52559459549428,12/8/2019,2717.79,100002,Y,Medicals,MI,PC,Dr,13:32:16,15:15:58,12/31/2020,80120018,1034.05,1,"Road concern dark western. Identify film similar sure would.
Stuff sign alone. Herself above stay. Create well car sort through.",14:10:48,NEFT
YZPK79958559760714,GB20RWFE52559459549428,12/8/2019,3751.84,100002,N,Credited,OPERA,MOBILE,Cr,18:41:03,19:57:08,12/31/2020,77237064,1034.05,6,Almost newspaper stuff guy president later trial. Where hard again somebody local.,19:19:06,CHEQUE
YZPK79958559760714,GB20RWFE52559459549428,12/8/2019,2717.79,100002,Y,Utilities,SAFARI,PC,Dr,19:17:04,21:27:10,12/31/2020,66240495,1034.05,2,"Bag history let month. Test thing low increase.
Data sense side single future hit. Common big radio both ahead. Choose red operation owner give so. Strategy leave thus size.",20:24:43,IMPS
YZPK79958559760714,GB20RWFE52559459549428,12/8/2019,1915.94,100002,Y,Entertainment,MI,PC,Dr,8:30:25,17:13:34,1/5/2021,31065252,801.85,6,"Yourself field tell us. Finish best wait. Stop friend always information father suffer message.
Discover trouble society through day picture until.",12:28:14,CHEQUE
YZPK79958559760714,GB20RWFE52559459549428,12/8/2019,3140.96,100002,N,Credited,OPERA,PC,Cr,7:33:17,10:55:38,1/10/2021,75081355,1225.02,2,"Figure economy knowledge film out enjoy south other. Plan particularly article the Republican.
Risk walk evening course education.",8:28:12,IMPS
YZPK79958559760714,GB20RWFE52559459549428,12/8/2019,1915.94,100002,Y,Personal Care,IE,PC,Dr,13:07:31,17:21:26,1/10/2021,5562374,1225.02,2,"Right man someone exist. Speech arm loss dark detail film guy. Both later clearly difference since.
South person phone now energy likely eye. Fund old production on our job.",14:58:19,IMPS
YZPK79958559760714,GB20RWFE52559459549428,12/8/2019,3140.96,100002,N,Credited,IE,POS,Cr,17:05:52,22:05:05,1/10/2021,598996,1225.02,3,"Region including why tough various their. People into unit view her away.
Difficult choose everybody account. Pull weight head. Want full century for officer full.",19:26:58,RTGS
YZPK79958559760714,GB20RWFE52559459549428,12/8/2019,4458.17,100002,N,Credited,SAFARI,PC,Cr,3:06:48,7:23:12,1/15/2021,76419454,1317.21,4,"Number together fly guy. Daughter turn road visit car meet result. Kid sister add loss truth.
But picture probably book goal. Strategy worry admit south they mean fear.",4:59:32,UPI
YZPK79958559760714,GB20RWFE52559459549428,12/8/2019,5775.38,100002,N,Credited,EDGE,PC,Cr,9:55:34,14:05:16,1/15/2021,9298415,1317.21,2,"Study agree hold attention she rate. Perform for edge both. Expect sign study democratic room worker.
Plant commercial threat moment. Bad let everybody white.",11:42:35,IMPS
YZPK79958559760714,GB20RWFE52559459549428,12/8/2019,4458.17,100002,Y,Household Consumables,FF,PC,Dr,16:25:11,19:43:16,1/15/2021,92356610,1317.21,7,"Within weight ago per. Policy avoid put structure contain pull follow cover.
How may low company hot base. Total stop board but keep new professional. Trip though inside tell on mind will compare.",17:29:42,DD
YZPK79958559760714,GB20RWFE52559459549428,12/8/2019,5775.38,100002,N,Credited,SAFARI,PC,Cr,18:12:25,22:10:11,1/15/2021,40779744,1317.21,1,Herself stage take director receive seek but. Wrong notice time assume activity true whom. Hear production study list finish let money.,20:34:04,NEFT
YZPK79958559760714,GB20RWFE52559459549428,12/8/2019,7070.87,100002,N,Credited,FF,POS,Cr,3:46:16,8:35:20,1/16/2021,66588511,1295.49,6,"Seem whose cost entire ok she make. Start street may kid force. Yet work sell hear pass yes seven. Lot set let no husband.
Once sometimes child few class red every.",6:07:33,CHEQUE
YZPK79958559760714,GB20RWFE52559459549428,12/8/2019,5775.38,100002,Y,Medicals,IE,POS,Dr,15:17:29,18:49:47,1/16/2021,20004811,1295.49,6,"Serious station common child church break. Black year any.
Participant phone name five task shake. Green your material wish. In begin develop whole.",16:02:26,CHEQUE
YZPK79958559760714,GB20RWFE52559459549428,12/8/2019,4479.89,100002,Y,Transportation,SAFARI,PC,Dr,18:26:07,22:24:32,1/16/2021,12861507,1295.49,4,"Former structure check anyone shoulder. Never major with many perform.
Future society service those artist fire citizen. Ever dinner present tough special space wind last.",19:38:52,UPI
YZPK79958559760714,GB20RWFE52559459549428,12/8/2019,5967.88,100002,N,Credited,IE,POS,Cr,4:29:09,7:31:17,1/28/2021,50217113,1487.99,3,"Hot skill character let understand son responsibility anyone. Between strong recent prove nor yet.
Yet go class create statement security energy. Sea benefit catch lose citizen local.",5:32:59,RTGS
YZPK79958559760714,GB20RWFE52559459549428,12/8/2019,4479.89,100002,Y,Personal Care,OPERA,PC,Dr,8:10:40,11:37:15,1/28/2021,69874505,1487.99,2,"Although finish health offer develop edge bring. Land physical pay each out eye for.
Defense along consider let. Yes by receive go.",10:08:28,IMPS
YZPK79958559760714,GB20RWFE52559459549428,12/8/2019,5967.88,100002,N,Credited,CHROME,PC,Cr,17:04:48,19:13:26,1/28/2021,4160694,1487.99,1,Fast expect position animal cause scientist. Argue window customer mind business blood film. Often leader civil know animal oil.,18:31:06,NEFT
YZPK79958559760714,GB20RWFE52559459549428,12/8/2019,7455.87,100002,N,Credited,FF,MOBILE,Cr,21:13:39,23:58:20,1/28/2021,28461333,1487.99,4,"Few behind score behind serious. National car stop industry bad. Might organization happy.
Already black sing.",21:48:13,UPI
YZPK79958559760714,GB20RWFE52559459549428,12/8/2019,7462.77,100002,N,Credited,SAFARI,PC,Cr,3:14:40,5:01:28,2/7/2021,49108743,6.9,1,Garden unit service shake financial information reflect. Have picture want ten. Political future home.,4:19:18,NEFT
YZPK79958559760714,GB20RWFE52559459549428,12/8/2019,7455.87,100002,Y,Utilities,MI,PC,Dr,9:02:31,12:08:39,2/7/2021,12901876,6.9,6,Serious bit toward put everything especially. Teach wait matter Mrs region measure recognize explain. Court avoid measure.,10:41:12,CHEQUE
YZPK79958559760714,GB20RWFE52559459549428,12/8/2019,7462.77,100002,N,Credited,CHROME,POS,Cr,11:53:10,14:12:46,2/7/2021,79509213,6.9,6,"Organization keep head condition there argue he. Value shoulder indeed attention eight great.
Hope almost onto. Find game story task until cost. Player relationship seven sister.",13:39:15,CHEQUE
YZPK79958559760714,GB20RWFE52559459549428,12/8/2019,7469.67,100002,N,Credited,EDGE,POS,Cr,16:02:46,18:21:41,2/7/2021,68796747,6.9,7,"Hard career debate provide someone shake.
Fall window family. Enjoy kind even herself million set employee. Only level office interview soldier.",17:45:24,DD
YZPK79958559760714,GB20RWFE52559459549428,12/8/2019,7462.77,100002,Y,Entertainment,EDGE,MOBILE,Dr,19:08:19,21:48:18,2/7/2021,70612097,6.9,7,"Process and public case.
Water morning glass politics. Site security produce. Large deal or through fly draw wait significant.",20:14:43,DD
YZPK79958559760714,GB20RWFE52559459549428,12/8/2019,8460.4,100002,N,Credited,CHROME,POS,Cr,4:38:00,7:24:06,2/10/2021,92171688,997.63,4,"Rather send happy. Herself cultural business.
Tough letter movie bar ahead factor. Which smile bag another PM. Body nothing line her. Rich effort believe person defense quickly.",5:24:48,UPI
YZPK79958559760714,GB20RWFE52559459549428,12/8/2019,9458.03,100002,N,Credited,CHROME,MOBILE,Cr,10:49:36,13:39:19,2/10/2021,45730320,997.63,6,"Hundred understand exactly head. Result deal experience medical option best change game. Information after in case next onto along sea.
Add likely idea agent pass. Radio yard decide.",12:16:06,CHEQUE
YZPK79958559760714,GB20RWFE52559459549428,12/8/2019,10455.66,100002,N,Credited,IE,MOBILE,Cr,15:16:52,17:24:23,2/10/2021,88615325,997.63,3,"Form sometimes those moment Republican star she. Subject success practice wall.
Commercial trouble two five debate house account animal. And fire adult fund.",16:12:57,RTGS
YZPK79958559760714,GB20RWFE52559459549428,12/8/2019,9458.03,100002,Y,Insurance,IE,POS,Dr,17:41:59,21:02:48,2/10/2021,88949437,997.63,4,"Economy people concern put these full. Production forget move fact not call visit. Camera raise high.
Oil eat service better knowledge yes. Society sell save key quite city.",19:57:28,UPI
YZPK79958559760714,GB20RWFE52559459549428,12/8/2019,9998.66,100002,N,Credited,SAFARI,PC,Cr,14:11:54,17:32:31,2/12/2021,712101,540.63,5,"Machine each financial let this. Until able fill run.
Him let forget. Matter fund new require early own support.
Spring red provide thus sign thus. Tree bring quite.",15:29:05,CARDS
YZPK79958559760714,GB20RWFE52559459549428,12/8/2019,9458.03,100002,Y,Dining,IE,MOBILE,Dr,14:46:38,19:30:03,2/12/2021,29750856,540.63,5,Billion far official political store significant. Those dinner material through study. Actually manage draw easy trip option development. Voice two moment idea remain.,17:14:00,CARDS
YZPK79958559760714,GB20RWFE52559459549428,12/8/2019,9549.57,100002,N,Credited,EDGE,MOBILE,Cr,11:05:46,19:50:08,2/15/2021,83574061,91.54,5,"Class door take really hotel ten as. Kind here begin approach.
Significant a however cup clearly side. Coach deal task use.",16:19:50,CARDS
YZPK79958559760714,GB20RWFE52559459549428,12/8/2019,9073.99,100002,Y,Transportation,CHROME,POS,Dr,6:20:54,10:00:19,2/17/2021,33758800,475.58,1,Than study land kid certainly become though few. Far rule name we campaign low boy crime. Rather life peace instead sound also nearly.,8:19:20,NEFT
YZPK79958559760714,GB20RWFE52559459549428,12/8/2019,9549.57,100002,N,Credited,SAFARI,PC,Cr,8:45:47,10:40:42,2/17/2021,27064054,475.58,7,Thing local us machine remember administration moment. Month walk response behind listen many.,9:54:49,DD
YZPK79958559760714,GB20RWFE52559459549428,12/8/2019,9073.99,100002,Y,Utilities,IE,MOBILE,Dr,12:42:41,15:59:49,2/17/2021,63465266,475.58,1,Recently science both plant industry ask possible truth. Big sing ok be side sing.,14:52:47,NEFT
YZPK79958559760714,GB20RWFE52559459549428,12/8/2019,9549.57,100002,N,Credited,FF,POS,Cr,18:41:29,20:37:52,2/17/2021,22366931,475.58,5,"Upon leave election race loss. Use you spring wonder.
Wonder resource together throw source.
Responsibility such old. Set staff under focus around.
Look respond drug pretty page. Tv ball he building.",19:14:35,CARDS
YZPK79958559760714,GB20RWFE52559459549428,12/8/2019,10319.33,100002,N,Credited,SAFARI,MOBILE,Cr,4:09:01,5:26:43,2/21/2021,33925639,769.76,2,"Whether concern particular. Everything air put candidate artist.
Point though news player. Prove reflect win this week rich bar. Million hotel land watch turn cup.",4:56:57,IMPS
YZPK79958559760714,GB20RWFE52559459549428,12/8/2019,11089.09,100002,N,Credited,IE,PC,Cr,9:04:12,13:29:15,2/21/2021,70423617,769.76,6,Across throw sure property. Head probably itself she we art phone. Interview add down design great.,11:21:48,CHEQUE
YZPK79958559760714,GB20RWFE52559459549428,12/8/2019,10319.33,100002,Y,Personal Care,OPERA,MOBILE,Dr,16:37:01,19:26:10,2/21/2021,68279585,769.76,4,Away across protect protect financial never. Visit everyone key political program company. Late majority quite citizen company training thousand.,18:50:59,UPI
YZPK79958559760714,GB20RWFE52559459549428,12/8/2019,9549.57,100002,Y,Online Shopping,IE,MOBILE,Dr,17:38:56,21:55:24,2/21/2021,86689106,769.76,5,"Where officer into economy dream dark kind. Old song with education author between hair. Line move model tonight answer significant simple.
Black forget seem six professor few set.",19:51:38,CARDS
YZPK79958559760714,GB20RWFE52559459549428,12/8/2019,10907.32,100002,N,Credited,SAFARI,MOBILE,Cr,10:25:19,17:50:49,2/25/2021,96370414,1357.75,7,Pull brother admit simple particularly within. Tonight its in reason. Cost media hard career cost day.,14:14:20,DD
YZPK79958559760714,GB20RWFE52559459549428,12/8/2019,12265.07,100002,N,Credited,EDGE,MOBILE,Cr,18:03:06,24:54:29,2/25/2021,20098780,1357.75,5,"Research night since themselves figure.
Raise design include guess group again model. Adult focus travel part cost.",21:10:12,CARDS
YZPK79958559760714,GB20RWFE52559459549428,12/8/2019,11518.83,100002,Y,Household Consumables,FF,POS,Dr,3:26:17,6:26:16,3/5/2021,51958671,746.24,7,"Authority road worker society. American public big how hospital important.
Add many together. Major possible here value artist member.",5:10:57,DD
YZPK79958559760714,GB20RWFE52559459549428,12/8/2019,10772.59,100002,Y,Utilities,OPERA,PC,Dr,10:16:43,12:05:35,3/5/2021,6022136,746.24,6,Grow deal win challenge western audience. East may home exist attention.,11:21:57,CHEQUE
YZPK79958559760714,GB20RWFE52559459549428,12/8/2019,11518.83,100002,N,Credited,CHROME,MOBILE,Cr,18:09:52,19:11:39,3/5/2021,49482522,746.24,4,"It available material fight wonder boy. Religious staff any name each dream own.
Career car goal history walk side. Actually note drug point interest. East push we sure sure really job.",18:42:40,UPI
YZPK79958559760714,GB20RWFE52559459549428,12/8/2019,10772.59,100002,Y,Dining,EDGE,PC,Dr,17:54:02,21:53:21,3/5/2021,40979885,746.24,7,"Street you north start. Stay inside close member. Safe machine necessary party plant alone travel.
Huge daughter after help wind father positive. Heavy whom magazine treatment.",19:57:22,DD
YZPK79958559760714,GB20RWFE52559459549428,12/8/2019,9383.42,100002,Y,Utilities,MI,MOBILE,Dr,8:45:29,12:38:20,3/8/2021,42321750,1389.17,6,Voice difficult financial ahead themselves may green much. Develop make mention he election record. Within form long join seem choice trade.,10:18:12,CHEQUE
YZPK79958559760714,GB20RWFE52559459549428,12/8/2019,7994.25,100002,Y,Rent,OPERA,POS,Dr,14:33:39,17:37:01,3/8/2021,20269760,1389.17,6,Still born significant here address specific by. Easy skill attention loss section effort house.,16:41:44,CHEQUE
YZPK79958559760714,GB20RWFE52559459549428,12/8/2019,9777.35,100002,N,Credited,EDGE,POS,Cr,13:32:38,24:15:07,3/14/2021,22960726,1783.1,2,"Along dream laugh owner class. Will hour candidate west reduce six indicate.
Bank staff chance site talk. Next only message.
Plant require movement floor really. Eye could floor whether bill where.",19:24:54,IMPS
YZPK79958559760714,GB20RWFE52559459549428,12/8/2019,10527.85,100002,N,Credited,OPERA,POS,Cr,9:21:11,12:27:47,3/16/2021,9553507,750.5,7,"Simply minute notice. Necessary identify yet certainly college. First husband scene situation weight instead painting.
Board those can executive. Candidate ground green strategy name.",11:29:16,DD
YZPK79958559760714,GB20RWFE52559459549428,12/8/2019,9777.35,100002,Y,Insurance,EDGE,PC,Dr,11:04:37,13:35:02,3/16/2021,29901241,750.5,1,"After election mean country analysis forget method. And to measure. Type pull person beautiful.
Method economic difficult stock fund. Morning else word. Model general thank.",12:37:46,NEFT
YZPK79958559760714,GB20RWFE52559459549428,12/8/2019,9026.85,100002,Y,Personal Care,IE,POS,Dr,17:57:26,21:01:11,3/16/2021,97624141,750.5,3,Main time easy sit fish society laugh capital. Approach education need fear hit exist. Light happy perform.,18:50:27,RTGS
YZPK79958559760714,GB20RWFE52559459549428,12/8/2019,9554.86,100002,N,Credited,IE,POS,Cr,5:57:22,9:33:10,3/18/2021,16714106,528.01,5,"School community pass total necessary will. Become back business. Bit final tonight model.
Machine show than police. Mr suffer any worry book party account. Remember organization stock bad.",6:46:00,CARDS
YZPK79958559760714,GB20RWFE52559459549428,12/8/2019,10082.87,100002,N,Credited,FF,POS,Cr,15:39:53,19:21:50,3/18/2021,45323553,528.01,7,Instead mind there small low carry just. Grow time history. Issue the design president safe its.,16:51:48,DD
YZPK79958559760714,GB20RWFE52559459549428,12/8/2019,9554.86,100002,Y,Insurance,IE,PC,Dr,21:35:40,25:17:39,3/18/2021,83479168,528.01,4,Attorney five TV able board traditional our everybody. Performance level fine camera. Plan care cost realize fear type ready.,22:53:09,UPI
YZPK79958559760714,GB20RWFE52559459549428,12/8/2019,10446.1,100002,N,Credited,EDGE,MOBILE,Cr,5:57:45,7:38:07,4/1/2021,38580390,891.24,6,"Fly drug project impact above employee. Beautiful without cold no score.
Cell special watch medical. Few share partner for prepare choice rate approach. End do second friend once song build.",6:40:17,CHEQUE
YZPK79958559760714,GB20RWFE52559459549428,12/8/2019,9554.86,100002,Y,Entertainment,SAFARI,MOBILE,Dr,8:11:57,9:35:35,4/1/2021,87003475,891.24,4,Either bill today much on above reflect. See admit news situation series. Into discover way charge nearly. Source history price throw Democrat PM.,8:44:37,UPI
YZPK79958559760714,GB20RWFE52559459549428,12/8/2019,8663.62,100002,Y,Dining,MI,MOBILE,Dr,11:55:25,13:49:22,4/1/2021,24591478,891.24,6,Write shake than church machine attorney. But threat everybody change bar this increase. General sit body they.,13:25:06,CHEQUE
YZPK79958559760714,GB20RWFE52559459549428,12/8/2019,9554.86,100002,N,Credited,SAFARI,MOBILE,Cr,15:51:46,19:26:20,4/1/2021,82195397,891.24,3,Huge interview guy direction read cold. Behavior provide skill receive. Wish down national green country coach.,17:38:14,RTGS
YZPK79958559760714,GB20RWFE52559459549428,12/8/2019,8663.62,100002,Y,Entertainment,EDGE,MOBILE,Dr,20:54:37,23:48:45,4/1/2021,67035359,891.24,2,"Response employee action during imagine. Public detail risk bill management stand sure.
Place clearly own describe least nice. Event play capital same address.",21:57:55,IMPS
YZPK79958559760714,GB20RWFE52559459549428,12/8/2019,6993.98,100002,Y,Dining,IE,MOBILE,Dr,8:22:35,11:06:00,4/9/2021,39030917,1669.64,4,"Just lawyer yourself bar drop exactly price. Know improve member increase. Parent land six but watch.
Similar sport instead.",9:18:05,UPI
YZPK79958559760714,GB20RWFE52559459549428,12/8/2019,8663.62,100002,N,Credited,IE,POS,Cr,8:34:30,11:17:11,4/9/2021,18271829,1669.64,2,Also guess western develop. Money reduce knowledge two protect challenge outside personal. Strong address else professor staff agent dream call.,10:04:24,IMPS
YZPK79958559760714,GB20RWFE52559459549428,12/8/2019,6993.98,100002,Y,Groceries,SAFARI,MOBILE,Dr,15:22:28,18:04:37,4/9/2021,49135435,1669.64,7,"Part decision level ask. Civil visit cost. Pressure want offer speak. Military anything store even.
Husband star interest work someone. Upon example car peace grow stock.",17:18:22,DD
YZPK79958559760714,GB20RWFE52559459549428,12/8/2019,8663.62,100002,N,Credited,FF,PC,Cr,20:42:15,25:03:30,4/9/2021,99634483,1669.64,5,"Your use partner old almost back provide leader. Start question important eight instead believe voice.
Section thing trial. Another camera suggest result best item hospital.",22:51:18,CARDS
YZPK79958559760714,GB20RWFE52559459549428,12/8/2019,7218.52,100002,Y,Groceries,OPERA,POS,Dr,16:17:03,26:58:28,4/20/2021,75909611,1445.1,5,Design responsibility build voice picture just once whether. Best public daughter system born upon. Better seven week garden.,21:10:13,CARDS
YZPK79958559760714,GB20RWFE52559459549428,12/8/2019,8248.71,100002,N,Credited,MI,PC,Cr,5:30:18,10:30:08,4/22/2021,88731001,1030.19,6,"Social far serve easy. Difficult hit husband thousand. Before throw give space.
See recently small consumer special. Everyone increase market. Investment drop own specific.",8:16:16,CHEQUE
YZPK79958559760714,GB20RWFE52559459549428,12/8/2019,9278.9,100002,N,Credited,IE,PC,Cr,12:11:17,17:23:58,4/22/2021,99820510,1030.19,7,"Expect consumer drive within state. Four itself side group record.
Wear sure defense best. Account need late street. Dinner hospital fill nor character.",14:43:03,DD
YZPK79958559760714,GB20RWFE52559459549428,12/8/2019,8248.71,100002,Y,Insurance,CHROME,PC,Dr,17:21:44,21:20:03,4/22/2021,17289184,1030.19,6,"Interesting miss five size.
I product on building such. Make soon free fly involve thus.
Social hard major blue professor yard result receive. Law authority single as movie.",19:51:11,CHEQUE
YZPK79958559760714,GB20RWFE52559459549428,12/8/2019,9138.28,100002,N,Credited,MI,POS,Cr,7:15:34,9:30:13,5/2/2021,85491526,889.57,5,"Discussion clearly learn happen challenge drug key much. Decade suddenly live share couple. It family rule adult turn.
What article discuss size relate risk. Late set minute away provide.",8:21:10,CARDS
YZPK79958559760714,GB20RWFE52559459549428,12/8/2019,10027.85,100002,N,Credited,IE,PC,Cr,14:53:23,20:37:36,5/2/2021,27625866,889.57,4,"Kid paper wide respond. Maintain big interest traditional.
Realize public air body model report sister child. Practice offer effect finish.",18:30:31,UPI
YZPK79958559760714,GB20RWFE52559459549428,12/8/2019,8913.71,100002,Y,Online Shopping,CHROME,PC,Dr,4:52:23,6:38:55,5/3/2021,34389041,1114.14,3,"Avoid probably receive employee candidate.
Visit improve study perhaps team drop. High force agency to.",6:06:47,RTGS
YZPK79958559760714,GB20RWFE52559459549428,12/8/2019,10027.85,100002,N,Credited,IE,PC,Cr,8:12:47,11:02:19,5/3/2021,95912899,1114.14,7,"Suddenly they last ball third story. Movement per notice order heart. Seven change figure like student.
Too institution keep mission. Resource occur right field. Recently name watch thank.",9:27:29,DD
YZPK79958559760714,GB20RWFE52559459549428,12/8/2019,11141.99,100002,N,Credited,IE,PC,Cr,11:36:10,14:33:28,5/3/2021,9612907,1114.14,7,"Organization among story generation. Class account several still with imagine. Information drop suffer.
Stop model small yourself role worry but rather. Support about just season.",12:46:32,DD
YZPK79958559760714,GB20RWFE52559459549428,12/8/2019,12256.13,100002,N,Credited,MI,MOBILE,Cr,17:26:09,20:33:37,5/3/2021,76481147,1114.14,4,"Quite deep deal represent that sign only rock. Anyone including card pick four.
Fly government responsibility court throw effort. Born suggest themselves sense film wind.",19:07:53,UPI
YZPK79958559760714,GB20RWFE52559459549428,12/8/2019,11141.99,100002,Y,Dining,FF,PC,Dr,20:24:24,23:01:55,5/3/2021,773133,1114.14,2,"Election fall fish garden improve. School fast after. Throw plan away machine about early local.
Not successful clear majority Congress southern official dark. Too fly day adult various.",21:52:45,IMPS
YZPK79958559760714,GB20RWFE52559459549428,12/8/2019,9383.84,100002,Y,Dining,EDGE,MOBILE,Dr,17:59:05,25:55:27,5/9/2021,96053362,1758.15,2,"Likely network firm eye head. About citizen stand effort technology.
Model various ask sport start glass think. Interesting various society to song sit. Newspaper week once onto everything.",21:44:41,IMPS
YZPK79958559760714,GB20RWFE52559459549428,12/8/2019,9237.12,100002,Y,Household Consumables,MI,MOBILE,Dr,4:33:16,8:31:07,5/10/2021,67510603,146.72,2,"Fund top investment health. Toward popular member actually PM. Ever since sister nothing fire. Light hot skin story study.
Indeed page product east health dinner. Like next probably woman set task.",6:05:56,IMPS
YZPK79958559760714,GB20RWFE52559459549428,12/8/2019,9383.84,100002,N,Credited,MI,MOBILE,Cr,12:46:27,14:40:37,5/10/2021,18737813,146.72,2,"Six statement song continue.
Past need perhaps city democratic daughter. From if order if ball. Current follow meeting seven side.",13:26:19,IMPS
YZPK79958559760714,GB20RWFE52559459549428,12/8/2019,9530.56,100002,N,Credited,IE,PC,Cr,17:27:54,21:02:35,5/10/2021,72020746,146.72,1,"Force foot lead. Save knowledge enter follow. Describe machine city reality.
Order what visit eight this.
Consumer friend nature all. Talk be citizen agree for candidate.",19:59:24,NEFT
YZPK79958559760714,GB20RWFE52559459549428,12/8/2019,8767.34,100002,Y,Entertainment,CHROME,MOBILE,Dr,11:42:58,15:39:46,5/13/2021,13498283,763.22,2,Modern wish ten hour kind here floor. Course particularly support southern parent miss. Picture product meet.,12:45:19,IMPS
YZPK79958559760714,GB20RWFE52559459549428,12/8/2019,9530.56,100002,N,Credited,OPERA,PC,Cr,19:49:31,25:30:10,5/13/2021,86913300,763.22,2,"Represent prevent establish teach. Later letter top drug Congress drug job.
Father direction even them trip. American memory onto environment Republican must.",23:34:32,IMPS
YZPK79958559760714,GB20RWFE52559459549428,12/8/2019,7759.68,100002,Y,Groceries,MI,MOBILE,Dr,7:42:54,13:00:36,5/25/2021,73760443,1770.88,7,"Commercial sell court large yourself. Court fast management maintain do serve candidate. Pretty production marriage.
Question would could free listen. Thought same down kind get.",10:34:22,DD
YZPK79958559760714,GB20RWFE52559459549428,12/8/2019,9530.56,100002,N,Credited,CHROME,POS,Cr,14:54:24,18:54:22,5/25/2021,62899529,1770.88,6,"Truth policy sign resource act positive hear. Money difference job window phone. Your left over question.
Start market that purpose west project. Threat opportunity happen likely everybody stop.",16:32:15,CHEQUE
YZPK79958559760714,GB20RWFE52559459549428,12/8/2019,11301.44,100002,N,Credited,IE,MOBILE,Cr,21:17:33,24:59:13,5/25/2021,41000083,1770.88,6,"Federal free her. Money including hour fine message.
Skill simply less budget kid vote magazine. Often trouble with maintain keep.
Loss professional arm.
Tough hit push hospital gas fight daughter.",22:40:51,CHEQUE
YZPK79958559760714,GB20RWFE52559459549428,12/8/2019,10132.43,100002,Y,Dining,IE,PC,Dr,4:56:23,6:30:56,5/27/2021,93404471,1169.01,1,"Lawyer new sign travel there send eye friend.
Hospital talk nature any chance quite them represent. Heavy suddenly know career enjoy live. Maintain themselves job far able success.",6:01:28,NEFT
YZPK79958559760714,GB20RWFE52559459549428,12/8/2019,8963.42,100002,Y,Personal Care,EDGE,MOBILE,Dr,8:02:28,11:45:04,5/27/2021,63286540,1169.01,7,"Capital dark level ready. Time this tell. Response other plant type them society resource.
Reality language concern article response the teacher. Government television science discover professor.",9:48:10,DD
YZPK79958559760714,GB20RWFE52559459549428,12/8/2019,10132.43,100002,N,Credited,CHROME,MOBILE,Cr,14:01:33,18:18:56,5/27/2021,40343099,1169.01,7,Available within maintain now tell likely successful. Room reason financial. To just majority test suffer.,16:08:59,DD
YZPK79958559760714,GB20RWFE52559459549428,12/8/2019,11301.44,100002,N,Credited,SAFARI,POS,Cr,17:50:45,20:50:17,5/27/2021,96626597,1169.01,5,Build ago subject thought really decade. Her give western detail include dream about.,19:14:41,CARDS
YZPK79958559760714,GB20RWFE52559459549428,12/8/2019,9373.23,100002,Y,Utilities,CHROME,POS,Dr,9:33:54,12:43:33,6/1/2021,29762910,1928.21,7,"Central yeah accept some tax line morning. Page soon personal discuss eight. Take simple recent hour one ahead business.
Join weight affect true. Turn once tonight player reach race than.",11:58:47,DD
YZPK79958559760714,GB20RWFE52559459549428,12/8/2019,11301.44,100002,N,Credited,FF,PC,Cr,13:52:24,18:56:36,6/1/2021,35735731,1928.21,3,"Its determine they cut base another. Stay Republican data also. Yes strong baby bit ahead middle.
Ready staff push. Record raise audience air customer.",16:38:46,RTGS
YZPK79958559760714,GB20RWFE52559459549428,12/8/2019,13229.65,100002,N,Credited,MI,PC,Cr,20:46:53,22:46:08,6/1/2021,31574730,1928.21,2,"Woman executive apply until fear. Music seven PM another.
East however side under.
Money after understand simply share bed. Itself machine matter song natural. Speech note imagine break.",21:57:40,IMPS
YZPK79958559760714,GB20RWFE52559459549428,12/8/2019,14870.09,100002,N,Credited,FF,POS,Cr,4:13:32,7:10:40,6/5/2021,96746073,1640.44,4,Check back nice. Onto part general month fear. Soldier reflect about single floor listen customer.,6:14:42,UPI
YZPK79958559760714,GB20RWFE52559459549428,12/8/2019,16510.53,100002,N,Credited,OPERA,PC,Cr,12:17:55,13:49:38,6/5/2021,1046137,1640.44,4,"Party attorney rate low never machine body. Scientist focus also young discussion your us.
Congress show plant impact.
Black security sort have maintain impact marriage.",12:48:07,UPI
YZPK79958559760714,GB20RWFE52559459549428,12/8/2019,14870.09,100002,Y,Insurance,FF,PC,Dr,14:54:16,16:38:31,6/5/2021,43293148,1640.44,3,Environmental must public drop consumer tend situation. Room support laugh position near husband usually. Former watch according take executive religious time. Factor gas know.,15:40:06,RTGS
YZPK79958559760714,GB20RWFE52559459549428,12/8/2019,16510.53,100002,N,Credited,OPERA,PC,Cr,22:53:28,25:14:08,6/5/2021,97957782,1640.44,4,Design realize candidate. Including body tough certainly argue. Nothing pretty attention material late hand box. National air himself assume.,23:58:33,UPI
YZPK79958559760714,GB20RWFE52559459549428,12/8/2019,14807.35,100002,Y,Entertainment,EDGE,PC,Dr,6:50:56,12:42:23,6/11/2021,26690674,1703.18,5,Health door admit best seven activity there cup. Suffer interview see time parent oil.,9:46:03,CARDS
YZPK79958559760714,GB20RWFE52559459549428,12/8/2019,13104.17,100002,Y,Online Shopping,EDGE,POS,Dr,13:10:36,16:38:42,6/11/2021,58905166,1703.18,7,Lay wish four nature parent company his. Order natural argue study pattern radio rest. Bank speak wall. Executive rest different half.,14:37:47,DD
YZPK79958559760714,GB20RWFE52559459549428,12/8/2019,11400.99,100002,Y,Household Consumables,CHROME,PC,Dr,20:10:45,24:07:14,6/11/2021,20244057,1703.18,7,"Hit mind nearly tough. Necessary challenge put son.
Such minute strategy very young born. Agent nor bad individual social hot fund. Edge stop manager heart must than.",21:26:17,DD
YZPK79958559760714,GB20RWFE52559459549428,12/8/2019,10748.69,100002,Y,Online Shopping,EDGE,MOBILE,Dr,4:22:21,5:40:33,6/15/2021,37753702,652.3,5,"Over great myself relate operation power few. Speech drive word.
Surface movie firm machine west quickly large. Official act spend sense. Tend claim science couple.",5:11:41,CARDS
YZPK79958559760714,GB20RWFE52559459549428,12/8/2019,10096.39,100002,Y,Transportation,CHROME,PC,Dr,7:01:01,8:56:33,6/15/2021,97017660,652.3,6,"There theory girl responsibility. Industry material skill mention manager.
Give book appear necessary specific. Book mention into record almost middle. Drug short action baby environmental.",8:20:02,CHEQUE
YZPK79958559760714,GB20RWFE52559459549428,12/8/2019,10748.69,100002,N,Credited,OPERA,POS,Cr,12:31:46,15:25:02,6/15/2021,81376032,652.3,2,"Raise thought economy order. Major collection watch special pattern.
Hard success whole that agency. Smile imagine while born throw.",13:59:33,IMPS
YZPK79958559760714,GB20RWFE52559459549428,12/8/2019,10096.39,100002,Y,Insurance,OPERA,PC,Dr,15:22:01,16:49:24,6/15/2021,21174254,652.3,1,"Unit stop our visit summer soon. Hair exist including staff never.
Common room wrong Republican show energy. Class movement clearly near else still technology. Develop only so door home.",16:03:24,NEFT
YZPK79958559760714,GB20RWFE52559459549428,12/8/2019,10748.69,100002,N,Credited,CHROME,POS,Cr,19:18:40,21:11:30,6/15/2021,36188888,652.3,6,"Often campaign eye room foot. Sport trip fire miss place anything.
Once store society public. Worry compare sometimes speak send likely. Modern your rock look manager pull those.",20:16:59,CHEQUE
YZPK79958559760714,GB20RWFE52559459549428,12/8/2019,9729.22,100002,Y,Transportation,MI,POS,Dr,5:36:49,7:23:22,6/17/2021,13446673,1019.47,3,Might chance boy music ten vote thank. System east offer training investment job.,6:14:27,RTGS
YZPK79958559760714,GB20RWFE52559459549428,12/8/2019,10748.69,100002,N,Credited,OPERA,PC,Cr,7:37:51,9:57:41,6/17/2021,10452127,1019.47,6,"Move eye education official short suddenly. Factor allow start cup. Pretty with door production.
Bad begin city budget third type Mrs life. Follow street lawyer fear media character song.",8:46:28,CHEQUE
YZPK79958559760714,GB20RWFE52559459549428,12/8/2019,9729.22,100002,Y,Entertainment,EDGE,PC,Dr,13:41:51,16:36:55,6/17/2021,44913748,1019.47,6,Great also truth name condition talk move. City different time after face unit.,15:34:27,CHEQUE
YZPK79958559760714,GB20RWFE52559459549428,12/8/2019,8709.75,100002,Y,Transportation,EDGE,PC,Dr,14:30:02,16:58:16,6/17/2021,37965051,1019.47,1,Protect author newspaper face pattern. While significant television report short hundred. Event PM play strong.,16:07:05,NEFT
YZPK79958559760714,GB20RWFE52559459549428,12/8/2019,9729.22,100002,N,Credited,FF,POS,Cr,20:17:35,22:56:57,6/17/2021,52874451,1019.47,2,Hand American your friend. Fact walk already around radio. Easy our card offer catch sound.,21:33:49,IMPS
YZPK79958559760714,GB20RWFE52559459549428,12/8/2019,7738.7,100002,Y,Rent,FF,POS,Dr,5:20:18,7:06:41,6/18/2021,36591206,1990.52,4,"Each consumer sell first. Manager inside land challenge. Partner personal husband.
Safe cell value speech easy.",6:06:07,UPI
YZPK79958559760714,GB20RWFE52559459549428,12/8/2019,5748.18,100002,Y,Household Consumables,SAFARI,POS,Dr,11:12:06,14:40:26,6/18/2021,51104207,1990.52,4,"So measure material reality reach human former. Cold organization audience billion quickly condition issue clear. Explain world think.
Voice similar scientist result resource.",12:34:21,UPI
YZPK79958559760714,GB20RWFE52559459549428,12/8/2019,7738.7,100002,N,Credited,IE,MOBILE,Cr,15:47:44,18:35:53,6/18/2021,59661658,1990.52,3,Executive card order reflect effort manager. Politics bar offer allow more over store.,17:57:59,RTGS
YZPK79958559760714,GB20RWFE52559459549428,12/8/2019,5748.18,100002,Y,Online Shopping,IE,PC,Dr,18:29:22,21:03:44,6/18/2021,1430172,1990.52,4,Present could PM away where. Suddenly general say such appear main. Final hit else score.,19:53:19,UPI
YZPK79958559760714,GB20RWFE52559459549428,12/8/2019,4987.93,100002,Y,Entertainment,EDGE,MOBILE,Dr,4:49:31,6:56:03,6/21/2021,70034806,760.25,7,"Nothing specific each city guy poor father. Through fall room father remain out voice.
Buy north perform power us open. West onto positive yet.
Loss anyone ground light hand low rock.",5:35:22,DD
YZPK79958559760714,GB20RWFE52559459549428,12/8/2019,5748.18,100002,N,Credited,IE,MOBILE,Cr,10:52:11,14:02:08,6/21/2021,31811958,760.25,1,"Throughout color view age build figure late pass. Environment cut great without politics family.
Physical late might dinner their. Us imagine gas fear walk to yard.",11:54:19,NEFT
YZPK79958559760714,GB20RWFE52559459549428,12/8/2019,6508.43,100002,N,Credited,FF,MOBILE,Cr,15:14:08,18:17:13,6/21/2021,34440131,760.25,1,"Inside party green write early. Yes stage they parent.
Close so yourself short. Result staff nature north popular. That minute have tend total several.",17:08:07,NEFT
YZPK79958559760714,GB20RWFE52559459549428,12/8/2019,7268.68,100002,N,Credited,SAFARI,MOBILE,Cr,21:08:47,23:18:02,6/21/2021,84984609,760.25,3,"Natural cold maybe degree. Still body vote receive although sound. Summer would than task.
Skin make rise feel town. Medical movie job course.",21:48:47,RTGS
YZPK79958559760714,GB20RWFE52559459549428,12/8/2019,7505.49,100002,N,Credited,MI,PC,Cr,6:28:33,7:38:25,7/6/2021,9698673,236.81,7,Hot move yet wonder pull woman number. Everybody talk doctor visit quality fact contain. Director month follow expert red artist.,7:02:10,DD
YZPK79958559760714,GB20RWFE52559459549428,12/8/2019,7268.68,100002,Y,Groceries,EDGE,PC,Dr,10:37:40,12:43:18,7/6/2021,5094431,236.81,1,"At receive hot serve newspaper. Like wind media office read write.
Choose between mother only matter. Should tonight notice. Night task detail color less.",11:14:01,NEFT
YZPK79958559760714,GB20RWFE52559459549428,12/8/2019,7505.49,100002,N,Credited,CHROME,MOBILE,Cr,14:44:04,16:56:06,7/6/2021,46182142,236.81,6,Home less education body assume. Senior able listen. Strong may position kid. Whom his serve some.,15:21:45,CHEQUE
YZPK79958559760714,GB20RWFE52559459549428,12/8/2019,7268.68,100002,Y,Household Consumables,EDGE,PC,Dr,16:49:44,19:03:43,7/6/2021,54261167,236.81,1,Try thing professional show. Happen when member difficult cup everything.,17:53:00,NEFT
YZPK79958559760714,GB20RWFE52559459549428,12/8/2019,7505.49,100002,N,Credited,IE,PC,Cr,21:59:50,25:19:18,7/6/2021,965194,236.81,6,Mission data tend those put maintain. Across impact pull bank walk. Sort born power professor whole factor save.,23:24:38,CHEQUE
YZPK79958559760714,GB20RWFE52559459549428,12/8/2019,5912.39,100002,Y,Household Consumables,EDGE,PC,Dr,4:54:00,8:48:29,7/8/2021,33141947,1593.1,4,Leg easy single I offer. Physical security foreign. Put special trip statement individual compare. Boy without century wide after let draw catch.,6:31:24,UPI
YZPK79958559760714,GB20RWFE52559459549428,12/8/2019,7505.49,100002,N,Credited,IE,MOBILE,Cr,11:59:00,13:45:29,7/8/2021,98503933,1593.1,4,"Mouth life pattern player. Agree lay Congress green.
Him strong force girl that hospital which. My special owner report deep. Local leader water instead play pattern bag.",13:10:13,UPI
YZPK79958559760714,GB20RWFE52559459549428,12/8/2019,5912.39,100002,Y,Insurance,FF,MOBILE,Dr,18:08:48,20:23:50,7/8/2021,21238963,1593.1,2,"Condition design environmental treatment certain. Option often try each.
Upon so section. Owner trial top throw. Store last painting true phone course.",18:39:12,IMPS
YZPK79958559760714,GB20RWFE52559459549428,12/8/2019,4319.29,100002,Y,Utilities,FF,POS,Dr,21:33:24,24:03:31,7/8/2021,77597380,1593.1,1,"Example forget move wrong peace. Building fact carry capital lay behind.
Minute key its girl lose practice two it.",22:26:41,NEFT
YZPK79958559760714,GB20RWFE52559459549428,12/8/2019,4132.7,100002,Y,Groceries,FF,PC,Dr,9:15:15,14:37:35,7/12/2021,98472611,186.59,2,"Enough security however. Stock already edge at kid church. Away offer discover discuss sit.
Myself anything edge response walk personal. Response rock back large.",11:19:40,IMPS
YZPK79958559760714,GB20RWFE52559459549428,12/8/2019,4319.29,100002,N,Credited,MI,PC,Cr,14:18:23,20:04:51,7/12/2021,66396031,186.59,4,"Value heavy understand bag hour choose of. Hour three late phone have analysis result. Structure house never help figure environmental computer recently.
Traditional model bed.",17:42:01,UPI
YZPK79958559760714,GB20RWFE52559459549428,12/8/2019,3072.14,100002,Y,Medicals,SAFARI,MOBILE,Dr,16:17:01,22:27:44,7/28/2021,90402111,1247.15,4,Edge red have ground still manager true. Relationship whose perhaps. Just western though. Mr will themselves bank.,18:38:18,UPI
YZPK79958559760714,GB20RWFE52559459549428,12/8/2019,2513.07,100002,Y,Rent,SAFARI,MOBILE,Dr,7:37:26,9:38:14,8/2/2021,32309379,559.07,7,"Hundred top goal line two. Move past candidate consumer door plan.
Approach month whom evening ask. Keep within whatever old with pick customer. Likely current real week expert throw seek.",8:34:51,DD
YZPK79958559760714,GB20RWFE52559459549428,12/8/2019,1954,100002,Y,Medicals,CHROME,POS,Dr,13:16:58,18:07:13,8/2/2021,70485578,559.07,6,Gas alone doctor tell hope data she boy. Away education these performance walk adult. Spring point safe ball wind as. Top nearly state measure production yes.,15:11:01,CHEQUE
YZPK79958559760714,GB20RWFE52559459549428,12/8/2019,2513.07,100002,N,Credited,SAFARI,PC,Cr,19:09:43,22:11:39,8/2/2021,12457762,559.07,3,"Detail true suggest anyone newspaper foot exactly.
Bit college remember in military price he. Daughter health particular guess fund month modern positive.",21:09:01,RTGS
YZPK79958559760714,GB20RWFE52559459549428,12/8/2019,881.27,100002,Y,Medicals,MI,PC,Dr,4:22:57,7:30:31,8/6/2021,27363744,1631.8,5,"Show growth world as decade real. Seek lead person method claim some or.
I defense statement turn out remain each. Outside notice media executive. Campaign standard investment.",6:43:26,CARDS
YZPK79958559760714,GB20RWFE52559459549428,12/8/2019,2513.07,100002,N,Credited,OPERA,MOBILE,Cr,15:02:36,18:23:17,8/6/2021,12920242,1631.8,6,"National fine couple power. Type owner war.
According decision simply baby. Most fight line court reason factor. Main south should method event.",17:24:43,CHEQUE
YZPK79958559760714,GB20RWFE52559459549428,12/8/2019,4144.87,100002,N,Credited,IE,MOBILE,Cr,17:46:56,19:48:53,8/6/2021,18134919,1631.8,7,"Result ready teach most. Available either medical camera star.
One shake collection although to scene. Suffer imagine black maybe scene.
Pass customer analysis market. Participant star fund owner.",18:56:59,DD
YZPK79958559760714,GB20RWFE52559459549428,12/8/2019,3189.12,100002,Y,Online Shopping,OPERA,POS,Dr,5:27:31,6:57:21,8/9/2021,8352712,955.75,1,Close section writer toward theory reduce report hold. Increase energy them realize hear walk two. Them space store huge difference can article.,6:09:16,NEFT
YZPK79958559760714,GB20RWFE52559459549428,12/8/2019,4144.87,100002,N,Credited,EDGE,POS,Cr,14:45:37,19:19:57,8/9/2021,8496096,955.75,3,"Quickly know southern final place continue. Position rate anything manager agree.
Only live property prepare. Gun action individual meeting occur effect.",16:54:47,RTGS
YZPK79958559760714,GB20RWFE52559459549428,12/8/2019,3189.12,100002,Y,Entertainment,FF,POS,Dr,18:55:13,22:17:13,8/9/2021,84555977,955.75,2,"White why medical year themselves offer garden possible.
Commercial worry realize crime reveal skin. Really those purpose natural.",19:58:22,IMPS
YZPK79958559760714,GB20RWFE52559459549428,12/8/2019,4227.76,100002,N,Credited,CHROME,POS,Cr,4:01:28,6:29:45,8/20/2021,25116427,1038.64,5,Mr risk growth leader those language study. High home model total parent. Any information feel less. Far traditional evening feeling main.,4:34:35,CARDS
YZPK79958559760714,GB20RWFE52559459549428,12/8/2019,5266.4,100002,N,Credited,MI,PC,Cr,7:55:00,10:51:28,8/20/2021,24992053,1038.64,6,"Appear purpose star first thing. Include kind certain pass consider speak. Popular notice laugh school bill health.
Always get decade safe traditional song. Moment hold color town spend.",9:04:48,CHEQUE
YZPK79958559760714,GB20RWFE52559459549428,12/8/2019,6305.04,100002,N,Credited,IE,PC,Cr,14:19:45,16:03:24,8/20/2021,73030140,1038.64,6,"Live same her specific onto walk. Wide task opportunity degree. Not century what benefit onto what.
Worker right paper national. Vote method history get song.",14:50:38,CHEQUE
YZPK79958559760714,GB20RWFE52559459549428,12/8/2019,7343.68,100002,N,Credited,SAFARI,MOBILE,Cr,18:15:02,20:10:02,8/20/2021,57822662,1038.64,1,Throw season current reflect. Our Democrat or board federal speak attention. Loss anyone senior arrive bar.,19:29:10,NEFT
YZPK79958559760714,GB20RWFE52559459549428,12/8/2019,8382.32,100002,N,Credited,CHROME,POS,Cr,21:49:13,23:49:27,8/20/2021,3034910,1038.64,4,Good east wide expect hair child. Glass quite stuff identify. Less those into past become while within. People result bill action else during push.,22:47:47,UPI
YZPK79958559760714,GB20RWFE52559459549428,12/8/2019,6480.98,100002,Y,Groceries,EDGE,MOBILE,Dr,21:08:59,29:06:52,8/22/2021,16729681,1901.34,7,Night million none vote act majority yeah. Call protect teacher various bar positive. Side student admit series executive join.,23:38:23,DD
YZPK79958559760714,GB20RWFE52559459549428,12/8/2019,4818.76,100002,Y,Rent,FF,MOBILE,Dr,5:40:11,7:43:19,9/8/2021,38092268,1662.22,2,"Week coach firm.
Way account each.
People any cold best phone both. Strategy account onto free once.",6:30:14,IMPS
YZPK79958559760714,GB20RWFE52559459549428,12/8/2019,3156.54,100002,Y,Household Consumables,FF,PC,Dr,11:56:47,13:41:38,9/8/2021,98651948,1662.22,4,"Organization prepare year hold teach cost strong. Car candidate ground support cause model role each.
Letter office trip. Job Congress detail main expert.",12:59:03,UPI
YZPK79958559760714,GB20RWFE52559459549428,12/8/2019,4818.76,100002,N,Credited,EDGE,MOBILE,Cr,17:22:10,20:08:31,9/8/2021,49638059,1662.22,5,"Debate near letter read successful because deep concern. Several music environment third.
Reason employee culture continue create sport court.",18:10:26,CARDS
YZPK79958559760714,GB20RWFE52559459549428,12/8/2019,3156.54,100002,Y,Entertainment,MI,POS,Dr,19:06:17,22:04:36,9/8/2021,79885898,1662.22,6,"All respond trip under player set. Value of economy sign good.
Before law himself another reduce. Find speech visit employee least hundred.
Mrs money such. Raise behind space edge part.",20:22:31,CHEQUE
YZPK79958559760714,GB20RWFE52559459549428,12/8/2019,3434.66,100002,N,Credited,CHROME,PC,Cr,3:14:20,8:52:45,9/10/2021,16723382,278.12,2,Accept because between close bad scene. Once inside building then charge television. Watch watch even throughout always threat reveal.,6:03:58,IMPS
YZPK79958559760714,GB20RWFE52559459549428,12/8/2019,3712.78,100002,N,Credited,FF,PC,Cr,13:57:28,16:30:46,9/10/2021,48707886,278.12,5,"Model will meeting beyond.
Win tonight defense two especially window perhaps. Eye call once finish specific per remain.",15:39:03,CARDS
YZPK79958559760714,GB20RWFE52559459549428,12/8/2019,3434.66,100002,Y,Personal Care,FF,PC,Dr,21:47:15,25:08:59,9/10/2021,6393663,278.12,7,"Letter discuss pay else pattern traditional. Able these land college billion. Keep region Mrs glass ten best nation modern.
Give live wrong employee large grow. Light color show month any make.",22:44:47,DD
YZPK79958559760714,GB20RWFE52559459549428,12/8/2019,2881.16,100002,Y,Entertainment,MI,MOBILE,Dr,7:24:00,10:17:22,9/19/2021,69852701,553.5,7,"Figure parent ok. Along alone position home book night.
Design seat wear hope young allow condition. Car cell that collection place source growth. Break work tell I.",9:32:51,DD
YZPK79958559760714,GB20RWFE52559459549428,12/8/2019,2327.66,100002,Y,Medicals,OPERA,POS,Dr,12:01:15,15:10:03,9/19/2021,67342969,553.5,5,"Fly feeling federal compare than. Finally his early. Scientist next customer especially none.
Create whatever wall marriage. Late act teach key act including.",13:26:25,CARDS
YZPK79958559760714,GB20RWFE52559459549428,12/8/2019,2881.16,100002,N,Credited,FF,MOBILE,Cr,14:27:57,17:48:06,9/19/2021,93870887,553.5,5,"Relate analysis others less health. Care probably pass bring rest. You pick term dinner marriage huge former.
Weight everybody around conference student. Add figure quality accept word.",16:00:04,CARDS
YZPK79958559760714,GB20RWFE52559459549428,12/8/2019,2327.66,100002,Y,Dining,MI,POS,Dr,18:28:12,21:28:11,9/19/2021,66338352,553.5,5,"Upon garden art anything member which. Write seek take upon agree possible.
Meet magazine section light morning case body form. Simply seven north talk.",19:51:12,CARDS
YZPK79958559760714,GB20RWFE52559459549428,12/8/2019,1794.28,100002,Y,Insurance,IE,MOBILE,Dr,10:58:04,17:47:47,9/26/2021,55304023,533.38,5,"My who apply despite street.
Civil they show training. Crime young join goal significant themselves bring. Major suffer despite.",15:34:54,CARDS
YZPK79958559760714,GB20RWFE52559459549428,12/8/2019,604.1,100002,Y,Insurance,MI,MOBILE,Dr,5:40:28,6:58:42,10/1/2021,34636497,1190.18,6,"Serve none south along black figure mean financial. Most when difficult television thing above large.
Among course environment consider. Mind center per employee dinner.",6:15:12,CHEQUE
YZPK79958559760714,GB20RWFE52559459549428,12/8/2019,1794.28,100002,N,Credited,EDGE,PC,Cr,16:02:54,17:16:20,10/1/2021,42397212,1190.18,5,"With still especially deep free industry. Travel threat per democratic necessary up word.
On stop Mr knowledge among star area. Interesting month me sometimes. Eat vote lead doctor.",16:39:21,CARDS
YZPK79958559760714,GB20RWFE52559459549428,12/8/2019,2984.46,100002,N,Credited,SAFARI,PC,Cr,21:44:12,24:32:34,10/1/2021,21009402,1190.18,4,"Central guess friend imagine. West get Republican reason affect find. Deep stay guy word.
Station attorney actually house music response line. Health soldier herself mean individual movement.",23:01:58,UPI
YZPK79958559760714,GB20RWFE52559459549428,12/8/2019,4137.06,100002,N,Credited,CHROME,MOBILE,Cr,10:28:10,13:38:25,10/3/2021,96316047,1152.6,5,"Positive past else impact. Find provide bring city pretty.
Fire official inside never. First seek on from program.",11:51:35,CARDS
YZPK79958559760714,GB20RWFE52559459549428,12/8/2019,5289.66,100002,N,Credited,EDGE,POS,Cr,15:45:57,19:57:26,10/3/2021,87550627,1152.6,6,"Between marriage may medical attention forget real. Tough site fact card official individual. Couple wait leg.
He office turn might message himself reach. Line push rule become few several town.",17:07:44,CHEQUE
YZPK79958559760714,GB20RWFE52559459549428,12/8/2019,4137.06,100002,Y,Groceries,MI,MOBILE,Dr,17:06:17,20:24:50,10/3/2021,51607579,1152.6,2,"Entire budget fly approach compare he. Beyond development fact.
Popular through character performance collection relate quality simple. Relationship kid run relationship.",19:18:15,IMPS
YZPK79958559760714,GB20RWFE52559459549428,12/8/2019,4416,100002,N,Credited,EDGE,POS,Cr,6:05:14,10:43:28,10/10/2021,71949802,278.94,7,"Discussion energy shoulder lose find feeling partner. Part her big learn open suddenly.
Kind win simply stand. Street fund until several.",9:35:56,DD
YZPK79958559760714,GB20RWFE52559459549428,12/8/2019,4694.94,100002,N,Credited,IE,PC,Cr,20:04:01,25:53:38,10/10/2021,54286733,278.94,5,"Particular finish point hot prevent. Anything call kind somebody want beyond. Same visit shake read.
List statement choose. Me choice public. Mention charge gas several yet similar note.",22:17:46,CARDS
CUHL01704932377151,GB91DITZ74834780737967,4/4/2017,6016.38,100002,N,Credited,SAFARI,MOBILE,Cr,10:33:01,16:22:14,4/15/2017,31392051,1334.64,6,"Language couple walk each record parent sister. Believe short later he baby idea.
Mind attack with as. Serve choose indicate some throw partner issue.",13:52:15,CHEQUE
CUHL01704932377151,GB91DITZ74834780737967,4/4/2017,4681.74,100002,Y,Transportation,FF,MOBILE,Dr,15:38:04,20:16:33,4/15/2017,84122810,1334.64,1,"Per to six former product. Phone time teacher then recognize reason effect.
Among forget seem over low pass after. Attack there degree spend write. Power grow such.",17:34:52,NEFT
CUHL01704932377151,GB91DITZ74834780737967,4/4/2017,4828.79,100002,N,Credited,EDGE,MOBILE,Cr,3:55:28,7:50:32,4/23/2017,51168834,147.05,4,"Situation read early step. Somebody scene such wear billion beautiful.
Voice create close foreign second suffer maybe. Everybody eat middle while business life.",6:01:31,UPI
CUHL01704932377151,GB91DITZ74834780737967,4/4/2017,4681.74,100002,Y,Medicals,MI,POS,Dr,9:38:25,13:51:23,4/23/2017,27398777,147.05,3,Fear born often service individual have really. Answer hear production south various door paper.,12:04:56,RTGS
CUHL01704932377151,GB91DITZ74834780737967,4/4/2017,4534.69,100002,Y,Personal Care,FF,PC,Dr,16:05:47,20:01:07,4/23/2017,26400532,147.05,3,Court general energy national improve player. Shake free standard number particular media Republican. Senior media gas career.,18:11:53,RTGS
CUHL01704932377151,GB91DITZ74834780737967,4/4/2017,3860.28,100002,Y,Entertainment,OPERA,PC,Dr,12:18:20,17:27:39,4/25/2017,72385210,674.41,6,"Already five born direction. Place act cover activity since customer travel.
Measure task would per painting method example people. Our support management no case. Follow center building mean.",13:47:50,CHEQUE
CUHL01704932377151,GB91DITZ74834780737967,4/4/2017,3185.87,100002,Y,Online Shopping,FF,POS,Dr,16:04:41,21:31:32,4/25/2017,49162578,674.41,1,"Section fire area. Star me reveal sing. Final goal right foot.
Task blood budget difference size. Strategy certain growth reduce memory.",19:01:42,NEFT
CUHL01704932377151,GB91DITZ74834780737967,4/4/2017,2366.14,100002,Y,Transportation,EDGE,PC,Dr,4:40:25,7:58:31,5/5/2017,65124307,819.73,6,"Member million long behavior after. Professional bill state quickly or.
Space run similar generation wonder president hear past. Imagine enjoy lead. Side partner church by.",7:00:36,CHEQUE
CUHL01704932377151,GB91DITZ74834780737967,4/4/2017,1546.41,100002,Y,Rent,FF,MOBILE,Dr,12:28:38,15:54:48,5/5/2017,48001564,819.73,1,Enough window tough rather play able. Structure mind while also across. Suffer appear effort carry.,13:47:16,NEFT
CUHL01704932377151,GB91DITZ74834780737967,4/4/2017,2366.14,100002,N,Credited,OPERA,PC,Cr,14:57:09,18:54:36,5/5/2017,77578150,819.73,1,"Then crime skill front car. Tough mind Democrat report. Receive often computer ever condition.
Data body second despite last standard. Choice son speech letter material draw. Glass offer poor use.",16:39:25,NEFT
CUHL01704932377151,GB91DITZ74834780737967,4/4/2017,1546.41,100002,Y,Utilities,SAFARI,PC,Dr,21:48:59,24:46:38,5/5/2017,65903988,819.73,5,"Popular service try school dinner fight goal. Should mother increase expert mention.
Room treatment fire. Police good finish strategy week reflect crime deep. Well citizen unit.",23:52:20,CARDS
CUHL01704932377151,GB91DITZ74834780737967,4/4/2017,287.76,100002,Y,Insurance,SAFARI,POS,Dr,3:34:32,6:16:59,5/26/2017,6513467,1258.65,3,"Stuff site argue west.
Consider provide respond decision number talk speech. Require it they station car.
Kid example parent movement trip of. May level professional.",5:46:16,RTGS
CUHL01704932377151,GB91DITZ74834780737967,4/4/2017,1546.41,100002,N,Credited,MI,PC,Cr,11:10:40,15:41:39,5/26/2017,92408357,1258.65,3,"Hotel forward force important her. Right act option defense fast.
You teacher wife look would could. Thus care officer major.
Hold pattern wish sell artist. Situation bit clear former.",13:24:58,RTGS
CUHL01704932377151,GB91DITZ74834780737967,4/4/2017,2805.06,100002,N,Credited,CHROME,PC,Cr,16:40:03,19:15:19,5/26/2017,66483380,1258.65,4,"Management author result reveal. Make tonight view magazine happen. Type left allow I hear.
Create firm specific anyone ago. Wind glass factor according at court really.",17:17:05,UPI
CUHL01704932377151,GB91DITZ74834780737967,4/4/2017,1546.41,100002,Y,Groceries,SAFARI,MOBILE,Dr,17:58:22,20:50:54,5/26/2017,14499753,1258.65,6,"Camera consider road wonder information century back. Ground minute into dream party. Different prevent yes debate Democrat though.
Probably sign center.",20:19:35,CHEQUE
CUHL01704932377151,GB91DITZ74834780737967,4/4/2017,2246.51,100002,N,Credited,MI,POS,Cr,11:30:47,16:53:10,6/3/2017,52362132,700.1,2,"Finally control join father city.
Lead health group everyone. Citizen authority candidate without ability with quite.
Medical to final thus. Behind lawyer off statement.",14:47:03,IMPS
CUHL01704932377151,GB91DITZ74834780737967,4/4/2017,1546.41,100002,Y,Groceries,EDGE,POS,Dr,16:33:25,19:11:37,6/3/2017,98905010,700.1,1,"Serve entire focus. Base green prove.
Business brother available country foot stop capital up. Economic democratic to marriage this measure.",17:38:24,NEFT
CUHL01704932377151,GB91DITZ74834780737967,4/4/2017,2782.24,100002,N,Credited,OPERA,POS,Cr,7:14:49,8:23:48,6/4/2017,7671890,1235.83,1,"Magazine understand language fast especially land.
As although movie cause win. Argue smile line home let. Staff room them part election. Forget author tree something.",7:46:07,NEFT
CUHL01704932377151,GB91DITZ74834780737967,4/4/2017,4018.07,100002,N,Credited,EDGE,POS,Cr,9:00:41,10:25:32,6/4/2017,78043084,1235.83,2,Generation third than miss smile. These firm individual throughout serve crime much. Dinner society exist more eye natural force.,9:56:54,IMPS
CUHL01704932377151,GB91DITZ74834780737967,4/4/2017,2782.24,100002,Y,Entertainment,FF,PC,Dr,12:44:47,14:44:28,6/4/2017,17330312,1235.83,5,"Window figure knowledge morning recognize country. Plan me use Congress student sound his out.
Enough while they him official offer open.",13:15:42,CARDS
CUHL01704932377151,GB91DITZ74834780737967,4/4/2017,1546.41,100002,Y,Medicals,SAFARI,MOBILE,Dr,18:26:34,20:59:38,6/4/2017,35197256,1235.83,4,Describe reflect drive financial various form. Series quickly with exactly left alone I. Than play maybe physical ahead we somebody. City including imagine Democrat.,19:39:34,UPI
CUHL01704932377151,GB91DITZ74834780737967,4/4/2017,310.58,100002,Y,Household Consumables,OPERA,MOBILE,Dr,21:48:47,24:23:56,6/4/2017,50840205,1235.83,7,"Nor company if most even on. Sport analysis around.
Fine doctor quality ahead. Short know staff indicate world rock sister five. Pm common heavy certainly she listen it important.",22:51:02,DD
CUHL01704932377151,GB91DITZ74834780737967,4/4/2017,451.05,100002,N,Credited,OPERA,MOBILE,Cr,4:54:38,7:18:46,6/5/2017,17070621,140.47,2,Person include actually buy heavy choice. Process issue marriage prevent capital though. Bill art field those will something fear feeling.,6:43:02,IMPS
CUHL01704932377151,GB91DITZ74834780737967,4/4/2017,591.52,100002,N,Credited,MI,MOBILE,Cr,6:43:59,9:01:03,6/5/2017,70916546,140.47,5,"Keep common treatment data blood through.
Summer business project bag. Shoulder oil which conference.",8:32:40,CARDS
CUHL01704932377151,GB91DITZ74834780737967,4/4/2017,731.99,100002,N,Credited,CHROME,MOBILE,Cr,14:05:08,17:33:34,6/5/2017,61915978,140.47,5,Out economy better growth thought get hour lead. Then opportunity whatever cultural let. Quite off reality.,15:57:56,CARDS
CUHL01704932377151,GB91DITZ74834780737967,4/4/2017,872.46,100002,N,Credited,CHROME,PC,Cr,16:29:31,19:06:06,6/5/2017,11246657,140.47,4,"Thus partner whole give detail deal build. Among ground east tell record bit my school.
Have event together catch administration step. Fight open agency make each special cup beat. End foot ahead a.",17:34:59,UPI
CUHL01704932377151,GB91DITZ74834780737967,4/4/2017,731.99,100002,Y,Utilities,FF,PC,Dr,21:07:33,24:16:21,6/5/2017,67369966,140.47,3,Tell attorney market shoulder else me ability. Country expert rate remain. Again born success adult.,22:28:59,RTGS
CUHL01704932377151,GB91DITZ74834780737967,4/4/2017,2094.41,100002,N,Credited,MI,MOBILE,Cr,3:14:00,6:21:59,6/6/2017,95249391,1362.42,1,"Key four former most customer church particularly. Couple up ahead. Offer notice campaign word collection.
Page five third push. Heart seven lot nor. Class particular spring build figure through.",5:15:28,NEFT
CUHL01704932377151,GB91DITZ74834780737967,4/4/2017,3456.83,100002,N,Credited,MI,PC,Cr,9:23:15,13:11:12,6/6/2017,59298168,1362.42,7,"Every light prepare effort. Well lay or financial option teach.
National attack detail boy sort. Base feeling around sometimes discussion husband smile.",11:02:24,DD
CUHL01704932377151,GB91DITZ74834780737967,4/4/2017,4819.25,100002,N,Credited,MI,MOBILE,Cr,13:33:58,15:23:58,6/6/2017,27981382,1362.42,1,Before fish wonder leader. Author coach remember actually. Police office would either save.,14:44:20,NEFT
CUHL01704932377151,GB91DITZ74834780737967,4/4/2017,3456.83,100002,Y,Groceries,OPERA,MOBILE,Dr,19:07:28,20:40:37,6/6/2017,45809477,1362.42,1,Word one expect thank tend attorney feel. Better require administration not late movement less goal. History sit director soon summer.,19:50:13,NEFT
CUHL01704932377151,GB91DITZ74834780737967,4/4/2017,3641.84,100002,N,Credited,IE,MOBILE,Cr,14:09:01,19:06:12,6/14/2017,65354919,185.01,3,"Water team argue into share six black. Themselves new growth alone.
Drive social administration most eye second.",15:13:37,RTGS
CUHL01704932377151,GB91DITZ74834780737967,4/4/2017,3456.83,100002,Y,Entertainment,SAFARI,MOBILE,Dr,17:04:21,22:27:21,6/14/2017,64361611,185.01,1,"Cell fall available serious.
Hour new politics popular. Wide standard improve community. Security message nearly prove.
Special team prove. Appear guy side address personal.",18:44:41,NEFT
CUHL01704932377151,GB91DITZ74834780737967,4/4/2017,2517.52,100002,Y,Medicals,FF,PC,Dr,4:43:43,7:42:38,6/21/2017,43655489,939.31,1,"Tough scientist allow cell buy weight. Keep decade present why chair south. Yourself for lawyer do record.
A stuff executive strong summer think. Individual value power live.",6:14:29,NEFT
CUHL01704932377151,GB91DITZ74834780737967,4/4/2017,1578.21,100002,Y,Personal Care,SAFARI,POS,Dr,8:27:53,10:58:49,6/21/2017,84103222,939.31,5,Offer nor hundred dinner perhaps man. Republican hundred find entire. Board world final defense.,9:47:08,CARDS
CUHL01704932377151,GB91DITZ74834780737967,4/4/2017,2517.52,100002,N,Credited,SAFARI,POS,Cr,12:56:48,14:43:03,6/21/2017,89377833,939.31,2,Word unit six letter whether remember. Prepare base political picture hundred whole.,14:07:19,IMPS
CUHL01704932377151,GB91DITZ74834780737967,4/4/2017,3456.83,100002,N,Credited,EDGE,MOBILE,Cr,15:47:28,19:00:30,6/21/2017,52695735,939.31,6,"Along myself what late some your edge. Thank argue seven return film.
Word food my hear. Interesting color sign.",17:11:19,CHEQUE
CUHL01704932377151,GB91DITZ74834780737967,4/4/2017,2517.52,100002,Y,Transportation,EDGE,PC,Dr,19:47:04,21:44:45,6/21/2017,7412134,939.31,7,"Find fast debate popular college level about. Their chance trouble coach moment term quickly.
Often find throughout before. Whatever ago color stop. Window perform trip.",20:35:59,DD
CUHL01704932377151,GB91DITZ74834780737967,4/4/2017,2523.24,100002,N,Credited,MI,MOBILE,Cr,8:15:29,12:24:18,6/25/2017,95723525,5.72,5,"Management century physical term employee. Mrs stay debate receive.
Finally from skin under each. Throw big population no concern bad.
Their long at several. Else machine wind only.",11:06:12,CARDS
CUHL01704932377151,GB91DITZ74834780737967,4/4/2017,2528.96,100002,N,Credited,IE,PC,Cr,13:07:43,15:18:45,6/25/2017,20682422,5.72,3,Might view either have apply physical day human. Soldier teacher much mouth result. Color her husband serious up much move.,14:15:35,RTGS
CUHL01704932377151,GB91DITZ74834780737967,4/4/2017,2523.24,100002,Y,Transportation,EDGE,MOBILE,Dr,18:45:14,21:21:26,6/25/2017,37304867,5.72,7,Different specific outside hundred nature mission. Network top worry present conference power just. Development east many billion. Benefit TV somebody evening.,19:52:16,DD
CUHL01704932377151,GB91DITZ74834780737967,4/4/2017,4441.05,100002,N,Credited,FF,POS,Cr,3:33:31,6:54:49,7/16/2017,53122711,1917.81,3,"Young worker truth father. Wall mother probably discuss state social.
General and sure again song relate enter. While short Mrs man.",5:32:26,RTGS
CUHL01704932377151,GB91DITZ74834780737967,4/4/2017,2523.24,100002,Y,Utilities,EDGE,MOBILE,Dr,9:20:03,12:24:31,7/16/2017,75749859,1917.81,5,"Could away enough trade alone. Your home open a vote.
Care rise military image. Main small system collection education owner find. Size particular opportunity interesting consider easy born.",10:50:53,CARDS
CUHL01704932377151,GB91DITZ74834780737967,4/4/2017,605.43,100002,Y,Personal Care,SAFARI,MOBILE,Dr,10:41:50,13:16:19,7/16/2017,51420901,1917.81,4,"Above or field. Laugh key activity pay everything or. Live better power happy.
Center product their future Democrat establish. Fund eye box not. Affect thing right glass of trip.",12:40:58,UPI
CUHL01704932377151,GB91DITZ74834780737967,4/4/2017,2523.24,100002,N,Credited,IE,POS,Cr,20:00:46,23:16:13,7/16/2017,20705916,1917.81,1,"Usually firm not serve war nature address. Nearly real sit experience open concern both.
Experience win this cover. Research meeting few cover degree small water.",21:46:38,NEFT
CUHL01704932377151,GB91DITZ74834780737967,4/4/2017,3743.72,100002,N,Credited,IE,POS,Cr,6:09:15,8:41:43,7/18/2017,36195916,1220.48,6,"Leave rich force. American bank project.
Article visit possible source raise price reflect. Build ever especially go rate clearly. Popular board look morning exactly fund over.",6:44:59,CHEQUE
CUHL01704932377151,GB91DITZ74834780737967,4/4/2017,4964.2,100002,N,Credited,OPERA,POS,Cr,8:01:57,11:21:18,7/18/2017,37100513,1220.48,1,"Treat daughter all both five free happen.
Respond reduce wear knowledge add capital seem. Black security consumer ever free throw age. Real most thing case center plant.",10:11:46,NEFT
CUHL01704932377151,GB91DITZ74834780737967,4/4/2017,6184.68,100002,N,Credited,OPERA,PC,Cr,15:23:18,18:17:09,7/18/2017,71712079,1220.48,7,"Strategy message yeah among. Some rate same imagine soldier anything.
Art walk over concern face carry.",16:29:39,DD
CUHL01704932377151,GB91DITZ74834780737967,4/4/2017,7405.16,100002,N,Credited,MI,MOBILE,Cr,19:40:52,23:04:45,7/18/2017,45906800,1220.48,1,"Clearly trouble remain. Despite first bill decide sometimes national decision ready.
Guy sit present yet establish executive south.",21:22:55,NEFT
CUHL01704932377151,GB91DITZ74834780737967,4/4/2017,7028.07,100002,Y,Groceries,OPERA,POS,Dr,12:57:01,17:30:55,7/20/2017,41740088,377.09,7,Art area at product song appear. Bad purpose myself field five professor between. Environmental mean agent drug.,14:53:39,DD
CUHL01704932377151,GB91DITZ74834780737967,4/4/2017,6650.98,100002,Y,Transportation,FF,PC,Dr,22:22:57,24:51:14,7/20/2017,99354497,377.09,3,"Today trip marriage sense character.
Stock available then night. Guy care bag.
Want word black beautiful. Whether window show if management threat fire. Argue behavior director happen.",23:23:58,RTGS
CUHL01704932377151,GB91DITZ74834780737967,4/4/2017,7645.44,100002,N,Credited,EDGE,POS,Cr,12:19:17,20:44:01,7/22/2017,27929704,994.46,3,Past about part hundred. Development though early fly drop everyone point. Sort better policy window find.,17:39:18,RTGS
CUHL01704932377151,GB91DITZ74834780737967,4/4/2017,9541.54,100002,N,Credited,OPERA,MOBILE,Cr,12:07:54,15:59:16,7/28/2017,43223763,1896.1,6,"Production group skill see good. Four role score to. Learn bag quality.
Rise if memory analysis then.",13:50:37,CHEQUE
CUHL01704932377151,GB91DITZ74834780737967,4/4/2017,11437.64,100002,N,Credited,IE,PC,Cr,17:10:37,23:31:01,7/28/2017,17564489,1896.1,3,"Character provide lead final stock. Style actually raise economic direction book son business. In treatment thank special.
Try less radio public. Push owner claim picture religious social care thus.",20:43:22,RTGS
CUHL01704932377151,GB91DITZ74834780737967,4/4/2017,10535.52,100002,Y,Utilities,IE,POS,Dr,12:21:59,19:43:57,8/5/2017,51904999,902.12,3,"Face too out certainly. Who player operation response call.
Several total single hour near sometimes north Mr. Responsibility up let until level staff.",15:53:00,RTGS
CUHL01704932377151,GB91DITZ74834780737967,4/4/2017,9633.4,100002,Y,Entertainment,IE,POS,Dr,19:04:50,22:44:30,8/5/2017,97930914,902.12,7,"Open answer box measure move authority. Form tax sit enough either your somebody.
Above mission finish standard tend such. Third product better resource career else.",21:55:55,DD
CUHL01704932377151,GB91DITZ74834780737967,4/4/2017,10984.83,100002,N,Credited,CHROME,PC,Cr,3:29:36,4:56:59,8/8/2017,89411926,1351.43,5,"Consider level project hot their answer until. Success lot three sea.
Table up street various continue. Region training federal everybody.",4:16:56,CARDS
CUHL01704932377151,GB91DITZ74834780737967,4/4/2017,9633.4,100002,Y,Household Consumables,MI,PC,Dr,9:04:09,12:24:19,8/8/2017,27437490,1351.43,7,"Society evidence even rock. Condition difference reflect.
Democratic cause class. Republican possible friend difference. Apply follow child language Democrat.",10:54:48,DD
CUHL01704932377151,GB91DITZ74834780737967,4/4/2017,8281.97,100002,Y,Rent,MI,PC,Dr,14:06:59,16:54:35,8/8/2017,36825714,1351.43,3,Reason structure he work. Away if gas college material by up. Key mind born him left scientist. Table near develop travel stuff either explain.,15:45:33,RTGS
CUHL01704932377151,GB91DITZ74834780737967,4/4/2017,6930.54,100002,Y,Dining,MI,PC,Dr,17:18:43,19:03:58,8/8/2017,58182321,1351.43,2,Matter radio teach later do available. Economic author son including owner safe test.,17:48:44,IMPS
CUHL01704932377151,GB91DITZ74834780737967,4/4/2017,8281.97,100002,N,Credited,FF,PC,Cr,20:44:29,22:34:17,8/8/2017,67916337,1351.43,1,Cold either commercial experience result author quality operation. Foreign threat perhaps purpose around speech edge.,21:22:10,NEFT
CUHL01704932377151,GB91DITZ74834780737967,4/4/2017,8452.84,100002,N,Credited,FF,POS,Cr,7:46:10,10:37:17,8/15/2017,13778064,170.87,7,"Agency agent one bad class. Contain month pull effort medical. Require he expert moment.
Else also save economic despite cut difference. Measure less story cover bit public material night.",9:07:21,DD
CUHL01704932377151,GB91DITZ74834780737967,4/4/2017,8281.97,100002,Y,Entertainment,CHROME,MOBILE,Dr,11:58:27,14:47:59,8/15/2017,64316093,170.87,5,Almost item hit become week. Almost federal more laugh how scene point. Seven study big account soldier.,13:12:52,CARDS
CUHL01704932377151,GB91DITZ74834780737967,4/4/2017,8452.84,100002,N,Credited,MI,POS,Cr,16:23:59,19:29:36,8/15/2017,25967883,170.87,7,"Economy draw either energy mouth central. Miss billion away show decision.
Focus trouble animal fly without wide. Knowledge include economy there thousand rather take. Song left represent may.",17:39:38,DD
CUHL01704932377151,GB91DITZ74834780737967,4/4/2017,8623.71,100002,N,Credited,FF,POS,Cr,21:24:52,24:59:51,8/15/2017,88092386,170.87,6,"Boy save reduce prevent operation son color.
Lay remain international own he. Color be quality his bed. Since tend experience those simple article image.",23:37:00,CHEQUE
CUHL01704932377151,GB91DITZ74834780737967,4/4/2017,6885.6,100002,Y,Household Consumables,FF,PC,Dr,6:11:50,9:58:00,8/16/2017,96980354,1738.11,3,Standard worker blue social write likely attention. Pm quite respond recently technology deep. Pressure play remember time full.,8:22:21,RTGS
CUHL01704932377151,GB91DITZ74834780737967,4/4/2017,8623.71,100002,N,Credited,MI,PC,Cr,12:30:49,14:09:28,8/16/2017,40635668,1738.11,2,Ready religious whom page size seven window. Top born once international drive large line. Fall debate police but develop.,13:37:32,IMPS
CUHL01704932377151,GB91DITZ74834780737967,4/4/2017,6885.6,100002,Y,Insurance,MI,PC,Dr,14:12:52,16:40:12,8/16/2017,12505609,1738.11,1,Where the professional federal office writer tree. Million yeah guess bill know bring. Kitchen sing have discover fact authority finally. Human pressure seat upon list too admit activity.,15:51:05,NEFT
CUHL01704932377151,GB91DITZ74834780737967,4/4/2017,8623.71,100002,N,Credited,CHROME,POS,Cr,20:43:29,23:57:45,8/16/2017,74638703,1738.11,2,"Federal woman avoid. Each available something them. Event hospital increase lose street.
Building coach deal response job lead consumer.",22:19:54,IMPS
CUHL01704932377151,GB91DITZ74834780737967,4/4/2017,10553.12,100002,N,Credited,OPERA,POS,Cr,17:27:31,25:55:55,8/26/2017,34707579,1929.41,1,Race grow pass. Fast factor series friend. Response woman arm another far several issue.,20:33:36,NEFT
CUHL01704932377151,GB91DITZ74834780737967,4/4/2017,12082.74,100002,N,Credited,FF,PC,Cr,5:24:21,6:45:33,9/14/2017,54075917,1529.62,2,"Suffer big billion study sell staff. Church media song let close you. Hope two throw occur people.
Notice street however total. Including attorney spring moment response.",6:04:33,IMPS
CUHL01704932377151,GB91DITZ74834780737967,4/4/2017,10553.12,100002,Y,Online Shopping,SAFARI,MOBILE,Dr,8:20:33,12:47:22,9/14/2017,15972132,1529.62,2,"Hit support way war American financial before. Truth forward fast.
Training soon on information.
Degree pass near west use number. Myself break politics smile finish improve open.",10:32:52,IMPS
CUHL01704932377151,GB91DITZ74834780737967,4/4/2017,12082.74,100002,N,Credited,SAFARI,POS,Cr,13:15:58,17:12:53,9/14/2017,17975421,1529.62,4,Another fear city within child skin. By join among community probably discover. Husband simple against ability piece them conference talk. Culture hospital kitchen skill.,15:21:58,UPI
CUHL01704932377151,GB91DITZ74834780737967,4/4/2017,13612.36,100002,N,Credited,IE,POS,Cr,20:52:23,23:12:37,9/14/2017,87201468,1529.62,3,"Trade time help for. Past feel difference worker weight police exist purpose.
Fine offer once eye. Skill player side task theory less thought.",22:12:51,RTGS
CUHL01704932377151,GB91DITZ74834780737967,4/4/2017,12259.75,100002,Y,Utilities,SAFARI,PC,Dr,6:58:44,10:11:00,9/19/2017,34117323,1352.61,4,"Song fact class. Dinner suffer age second and will.
Wide song wind lot. Region top upon develop address company former.
Science inside claim affect step kitchen. Involve method each.",8:02:48,UPI
CUHL01704932377151,GB91DITZ74834780737967,4/4/2017,10907.14,100002,Y,Online Shopping,FF,PC,Dr,12:09:34,15:57:22,9/19/2017,10374290,1352.61,1,"Morning president local fly to bank wonder.
Course as far break thank continue until. Detail quality allow agency party child.",15:07:15,NEFT
CUHL01704932377151,GB91DITZ74834780737967,4/4/2017,12259.75,100002,N,Credited,CHROME,PC,Cr,19:39:28,23:31:51,9/19/2017,75261771,1352.61,1,"Last civil campaign image likely responsibility. Shoulder whole owner knowledge north never.
Discover fill teach apply affect who watch. Particular product design possible.",21:28:34,NEFT
CUHL01704932377151,GB91DITZ74834780737967,4/4/2017,12671.33,100002,N,Credited,CHROME,MOBILE,Cr,12:04:39,18:19:48,9/20/2017,18830989,411.58,2,"Few instead fund receive international present attention. Order car whom present college person fine first.
Table often election daughter task. Stock sing school animal.",15:34:40,IMPS
CUHL01704932377151,GB91DITZ74834780737967,4/4/2017,13082.91,100002,N,Credited,FF,MOBILE,Cr,17:58:46,24:07:00,9/20/2017,59349938,411.58,6,"Attorney really team what board. Fish agree although wish really. Area about name.
Phone investment compare today modern five use. Machine town force process table. Tend out middle else drug.",21:35:08,CHEQUE
CUHL01704932377151,GB91DITZ74834780737967,4/4/2017,11485.88,100002,Y,Groceries,FF,POS,Dr,10:55:33,17:56:38,10/5/2017,48960533,1597.03,1,"Reduce kitchen apply animal around manager. Just look down rule. Century him people concern sell camera.
Marriage economic middle knowledge. Break nor evening market least shoulder if population.",14:28:50,NEFT
CUHL01704932377151,GB91DITZ74834780737967,4/4/2017,9882.76,100002,Y,Utilities,SAFARI,MOBILE,Dr,13:07:34,15:34:58,10/13/2017,573214,1603.12,6,"Knowledge let require. Move candidate star deep enough available.
Over growth available car difference. Return beyond piece everybody career hair computer.",14:16:34,CHEQUE
CUHL01704932377151,GB91DITZ74834780737967,4/4/2017,11485.88,100002,N,Credited,IE,POS,Cr,16:25:23,23:07:47,10/13/2017,1276138,1603.12,7,Radio adult price allow hard candidate whole. Fear vote close live its real. Let me media.,19:10:04,DD
CUHL01704932377151,GB91DITZ74834780737967,4/4/2017,11248.87,100002,Y,Online Shopping,OPERA,PC,Dr,2:24:36,4:53:34,10/18/2017,35193869,237.01,5,"Miss production company be budget.
Message act book station environment. Wife effort company two.
Another couple success tend table dinner image. Customer third Mr stage.",4:01:15,CARDS
CUHL01704932377151,GB91DITZ74834780737967,4/4/2017,11485.88,100002,N,Credited,IE,MOBILE,Cr,6:32:11,9:26:21,10/18/2017,90790119,237.01,7,"Radio them organization develop field. She else minute improve. Form new test hotel director first.
Floor deal else drop again right stage leg. Day professor about what gas different inside.",8:06:25,DD
CUHL01704932377151,GB91DITZ74834780737967,4/4/2017,11722.89,100002,N,Credited,MI,PC,Cr,14:21:46,17:03:00,10/18/2017,87234657,237.01,3,Natural series ok would option plant evening court. Certainly including upon manager mother no commercial. Pretty argue imagine American somebody.,15:09:33,RTGS
CUHL01704932377151,GB91DITZ74834780737967,4/4/2017,11485.88,100002,Y,Dining,FF,MOBILE,Dr,15:33:42,18:24:15,10/18/2017,66437932,237.01,4,"Allow movement claim seek step fund maintain.
Member tonight good politics. Point catch yet approach area.
Cut fall teacher sing.
Night material college those without. Town wind much senior.",17:33:16,UPI
CUHL01704932377151,GB91DITZ74834780737967,4/4/2017,11722.89,100002,N,Credited,MI,PC,Cr,19:37:54,22:04:53,10/18/2017,88030173,237.01,4,Whole anything move toward speech choice behavior campaign. Into continue study.,20:17:38,UPI
CUHL01704932377151,GB91DITZ74834780737967,4/4/2017,12793.8,100002,N,Credited,OPERA,POS,Cr,11:32:40,17:25:50,11/10/2017,46659187,1070.91,4,"Herself knowledge measure game go left. Two type positive visit day wonder pull.
Society thank act science life. Reflect response memory.",15:10:10,UPI
CUHL01704932377151,GB91DITZ74834780737967,4/4/2017,11479.23,100002,Y,Transportation,OPERA,POS,Dr,19:31:28,26:57:58,11/13/2017,60194312,1314.57,5,"Tough suffer reflect activity expert here shake. Recognize lot religious as blood.
Environmental series recent because half against quite. Half animal theory.",22:46:39,CARDS
CUHL01704932377151,GB91DITZ74834780737967,4/4/2017,11281.7,100002,Y,Household Consumables,CHROME,MOBILE,Dr,3:42:37,5:46:14,11/17/2017,96501528,197.53,7,"Fire week clear affect lot computer space important. Us place sound.
Best can goal garden police small structure. Employee south whether green. Only size far amount.",4:43:06,DD
CUHL01704932377151,GB91DITZ74834780737967,4/4/2017,11084.17,100002,Y,Dining,CHROME,MOBILE,Dr,8:03:12,10:18:36,11/17/2017,90254727,197.53,4,Race who least manage production area. Reduce hospital able citizen. Buy see consumer simple sense wrong number.,9:35:24,UPI
CUHL01704932377151,GB91DITZ74834780737967,4/4/2017,10886.64,100002,Y,Insurance,SAFARI,POS,Dr,11:22:11,14:27:46,11/17/2017,18050998,197.53,1,Manager method however technology space bad debate. Share form blood feel between story skin. Why professional describe certain identify while view.,13:13:22,NEFT
CUHL01704932377151,GB91DITZ74834780737967,4/4/2017,11084.17,100002,N,Credited,MI,MOBILE,Cr,15:58:33,18:29:27,11/17/2017,96637234,197.53,5,"Draw relate drive hope. Represent window card student. Either question answer time with.
Allow short growth he peace ten. Case rule decade push mouth. Treat point need.",16:46:28,CARDS
CUHL01704932377151,GB91DITZ74834780737967,4/4/2017,11281.7,100002,N,Credited,CHROME,MOBILE,Cr,19:30:49,21:06:29,11/17/2017,71977430,197.53,7,"Difficult six company. Safe bed with score air accept seem. Either industry seem of heavy cold knowledge.
Professional just friend back any. Remember garden down American take design.",20:34:23,DD
CUHL01704932377151,GB91DITZ74834780737967,4/4/2017,13173.74,100002,N,Credited,OPERA,PC,Cr,9:45:31,14:32:26,11/19/2017,789615,1892.04,5,Another practice life whether this create. Structure might force source cause investment within. Certainly effort edge color.,12:19:20,CARDS
CUHL01704932377151,GB91DITZ74834780737967,4/4/2017,11281.7,100002,Y,Entertainment,FF,POS,Dr,14:28:18,19:31:11,11/19/2017,19754567,1892.04,5,"Them other dark. Foreign little find cause main in movement audience. Cultural yet task media.
Agreement know sense include leave there attack. Long science after and throughout.",16:49:09,CARDS
CUHL01704932377151,GB91DITZ74834780737967,4/4/2017,9680.78,100002,Y,Personal Care,IE,PC,Dr,8:37:06,11:26:18,12/2/2017,10215739,1600.92,2,"She south economic change police film wonder suggest. Huge second because child building.
May rich leader score for inside. Hot party hotel break right. Century should attorney human support senior.",9:22:28,IMPS
CUHL01704932377151,GB91DITZ74834780737967,4/4/2017,8079.86,100002,Y,Groceries,SAFARI,MOBILE,Dr,11:37:04,14:33:52,12/2/2017,48656337,1600.92,2,Black almost commercial focus I bill. Challenge admit her attorney. Measure store continue office. Owner beautiful truth away affect.,13:25:23,IMPS
CUHL01704932377151,GB91DITZ74834780737967,4/4/2017,6478.94,100002,Y,Utilities,CHROME,MOBILE,Dr,15:38:47,17:35:33,12/2/2017,59022244,1600.92,6,Level TV receive bit let difference. Enter late interview industry ever space. Speak buy material line.,16:32:04,CHEQUE
CUHL01704932377151,GB91DITZ74834780737967,4/4/2017,4878.02,100002,Y,Online Shopping,OPERA,MOBILE,Dr,18:07:31,21:35:00,12/2/2017,73797616,1600.92,2,"Good system side what during spend approach. Anyone seven industry he hundred perhaps executive.
Base wait against catch. Agree actually vote fund analysis.",19:20:59,IMPS
CUHL01704932377151,GB91DITZ74834780737967,4/4/2017,4050.47,100002,Y,Transportation,FF,PC,Dr,5:28:56,8:51:10,12/4/2017,1505535,827.55,1,"Would million real method. Management exist nor forward note.
Him series research nature us ball cold. Top cold middle agent movie real particularly. Shoulder why of have short.",6:56:48,NEFT
CUHL01704932377151,GB91DITZ74834780737967,4/4/2017,3222.92,100002,Y,Groceries,MI,PC,Dr,9:41:57,12:16:45,12/4/2017,392013,827.55,7,Recently kitchen by quality produce. Work occur really price man inside black.,10:41:10,DD
CUHL01704932377151,GB91DITZ74834780737967,4/4/2017,2395.37,100002,Y,Entertainment,FF,MOBILE,Dr,15:54:14,18:37:04,12/4/2017,81392568,827.55,3,Many drop quality idea point offer. Ready speak cultural hour scientist.,16:33:51,RTGS
CUHL01704932377151,GB91DITZ74834780737967,4/4/2017,3222.92,100002,N,Credited,SAFARI,PC,Cr,19:26:22,22:50:55,12/4/2017,65215500,827.55,6,Popular choose field forward performance statement project spring. Thing recognize hospital bed hot lot.,21:11:39,CHEQUE
CUHL01704932377151,GB91DITZ74834780737967,4/4/2017,2921.91,100002,Y,Personal Care,EDGE,POS,Dr,13:10:06,19:09:06,12/10/2017,98882236,301.01,5,"Would majority east consumer drive over serve. Station decision industry often. Tv bed question effect agreement.
From sell successful use. As for whole today wide. Near some eye bar.",15:13:57,CARDS
CUHL01704932377151,GB91DITZ74834780737967,4/4/2017,3222.92,100002,N,Credited,IE,PC,Cr,21:40:34,23:42:49,12/10/2017,50268214,301.01,2,"Free avoid decade whose either toward set. East trade everybody.
Quality most according work they. Own north easy organization.
Role huge among investment.",22:31:11,IMPS
CUHL01704932377151,GB91DITZ74834780737967,4/4/2017,4786.61,100002,N,Credited,IE,MOBILE,Cr,6:53:26,9:43:05,12/11/2017,40034225,1563.69,2,"Assume whom paper scene behavior like. Together whether four nor direction sign.
Total defense executive business. Whom reveal really somebody.",8:08:58,IMPS
CUHL01704932377151,GB91DITZ74834780737967,4/4/2017,3222.92,100002,Y,Online Shopping,OPERA,PC,Dr,12:40:12,15:51:40,12/11/2017,53504111,1563.69,7,Whole word visit executive nation. North change drop pull industry other. Fish everyone agent agreement.,14:05:04,DD
CUHL01704932377151,GB91DITZ74834780737967,4/4/2017,1659.23,100002,Y,Online Shopping,MI,POS,Dr,14:49:16,17:51:29,12/11/2017,83281204,1563.69,3,National language sea science become. Them about case Democrat stuff he attack Democrat. Reason line majority put. Those be lay mean have which.,16:45:53,RTGS
CUHL01704932377151,GB91DITZ74834780737967,4/4/2017,3222.92,100002,N,Credited,MI,PC,Cr,20:30:58,22:48:11,12/11/2017,49400496,1563.69,4,"Democratic system above exist strong hard. From black hotel it rule computer. Air blood many level me result.
Training manage might alone already would value. Hundred stock push keep general radio.",22:03:31,UPI
CUHL01704932377151,GB91DITZ74834780737967,4/4/2017,3454.71,100002,N,Credited,EDGE,POS,Cr,2:11:41,5:26:43,12/13/2017,34034217,231.79,4,Move market they worry. Something employee need success. Evening hand tough her analysis low get.,4:01:47,UPI
CUHL01704932377151,GB91DITZ74834780737967,4/4/2017,3686.5,100002,N,Credited,OPERA,PC,Cr,9:13:50,11:37:18,12/13/2017,2042732,231.79,2,"Worry staff key perform candidate condition tell. Probably see often low. Any information test.
Executive part program official cover.",10:56:10,IMPS
CUHL01704932377151,GB91DITZ74834780737967,4/4/2017,3918.29,100002,N,Credited,FF,POS,Cr,11:06:03,14:03:11,12/13/2017,8868718,231.79,5,"Four against do away among central.
Some talk read try. Itself professor other performance poor.",12:52:32,CARDS
CUHL01704932377151,GB91DITZ74834780737967,4/4/2017,4150.08,100002,N,Credited,SAFARI,POS,Cr,16:09:35,18:21:53,12/13/2017,53019516,231.79,1,Along hold about per challenge energy action. Team organization central national among. On rise teach medical decide company force.,17:45:59,NEFT
CUHL01704932377151,GB91DITZ74834780737967,4/4/2017,3918.29,100002,Y,Dining,SAFARI,PC,Dr,20:14:00,21:31:26,12/13/2017,74676378,231.79,3,"Page mind oil make couple light. Face shoulder remain help learn baby. Property be far treat identify.
Play speech though. Material public energy main.",21:03:33,RTGS
CUHL01704932377151,GB91DITZ74834780737967,4/4/2017,5655.42,100002,N,Credited,OPERA,POS,Cr,12:29:17,17:15:58,12/14/2017,58171165,1737.13,7,Mission eye hit company professional social state. Democratic painting live focus. Thought already eat figure instead away may.,14:02:05,DD
CUHL01704932377151,GB91DITZ74834780737967,4/4/2017,3918.29,100002,Y,Insurance,OPERA,POS,Dr,22:35:42,27:16:38,12/14/2017,79766210,1737.13,3,Level I American if probably face easy project. Must value time civil partner fear ever. Yard necessary kind relate foreign kid recently weight.,23:31:06,RTGS
CUHL01704932377151,GB91DITZ74834780737967,4/4/2017,2044.08,100002,Y,Household Consumables,IE,PC,Dr,3:48:50,7:14:59,12/16/2017,56613797,1874.21,6,"Score important benefit human school scene. Rate popular friend anyone. Ground people table three find source simple.
Fact main eye right result. Interest my try skill voice do thing.",5:22:47,CHEQUE
CUHL01704932377151,GB91DITZ74834780737967,4/4/2017,3918.29,100002,N,Credited,IE,MOBILE,Cr,10:14:09,12:43:48,12/16/2017,1078817,1874.21,3,"Off eight mention drop between. Tonight cell him town.
Nation of paper group positive data about. Myself information herself.",11:09:10,RTGS
CUHL01704932377151,GB91DITZ74834780737967,4/4/2017,2044.08,100002,Y,Entertainment,MI,MOBILE,Dr,16:15:13,20:54:12,12/16/2017,66710172,1874.21,3,"Check understand policy seek purpose.
Choose buy think under weight protect nature. Guy trial protect performance it.",18:37:42,RTGS
CUHL01704932377151,GB91DITZ74834780737967,4/4/2017,169.87,100002,Y,Household Consumables,SAFARI,PC,Dr,19:20:08,21:36:16,12/16/2017,75450700,1874.21,2,"Quite recognize example remain development. Result detail result street stage easy.
Street leave your pay she life friend seek. Oil truth source.",20:33:22,IMPS
CUHL01704932377151,GB91DITZ74834780737967,4/4/2017,88.46,100002,Y,Personal Care,OPERA,MOBILE,Dr,10:40:30,16:07:07,12/22/2017,18218756,81.41,2,"Brother fill include work loss especially. Dinner past interview despite five letter morning.
Result more scientist century build. Education wall whether once score.",14:36:39,IMPS
CUHL01704932377151,GB91DITZ74834780737967,4/4/2017,7.05,100002,Y,Household Consumables,SAFARI,PC,Dr,16:55:33,22:02:22,12/22/2017,70128826,81.41,3,"Behind special full attorney play happen. Thank your because method avoid since.
Operation range important still team in. Certain model public piece.",20:39:14,RTGS
CUHL01704932377151,GB91DITZ74834780737967,4/4/2017,643.09,100002,N,Credited,OPERA,MOBILE,Cr,5:15:36,11:45:02,12/25/2017,78940000,636.04,4,"Other article stock might. Certainly why nation. Beyond support pay without.
Allow best need decade TV skill push must. Sit organization agent individual record gun for.",8:22:39,UPI
CUHL01704932377151,GB91DITZ74834780737967,4/4/2017,1279.13,100002,N,Credited,MI,PC,Cr,17:54:42,23:04:05,12/25/2017,93514729,636.04,5,"Tax look card. Detail local staff expert.
Beautiful western art almost well protect. Vote speech who increase rest during. Writer machine across may.",20:48:48,CARDS
CUHL01704932377151,GB91DITZ74834780737967,4/4/2017,726.54,100002,Y,Personal Care,SAFARI,PC,Dr,5:18:41,8:22:05,12/26/2017,53285348,552.59,6,Rise entire sign suffer accept field. Of glass contain material middle summer arm. Director chance allow without social run. Investment fund these similar question media far.,7:19:26,CHEQUE
CUHL01704932377151,GB91DITZ74834780737967,4/4/2017,1279.13,100002,N,Credited,IE,POS,Cr,12:12:00,15:50:26,12/26/2017,37975777,552.59,1,"Those theory color again new theory phone. Which against writer yes police how analysis identify. Little keep simply down direction environment beyond send.
Try best bit really thus fight.",13:51:05,NEFT
CUHL01704932377151,GB91DITZ74834780737967,4/4/2017,1831.72,100002,N,Credited,CHROME,MOBILE,Cr,13:49:37,17:37:58,12/26/2017,95256924,552.59,7,"Wife situation cut offer. Throw send what down. Common deal reason ability.
Than others general language generation. That adult move.",15:29:16,DD
CUHL01704932377151,GB91DITZ74834780737967,4/4/2017,1279.13,100002,Y,Household Consumables,SAFARI,PC,Dr,18:54:12,20:31:19,12/26/2017,28349587,552.59,5,"Policy finally eye simple push miss company.
Human director way man network. Teacher decide available beautiful father simply.
Kitchen focus everyone. Operation once last paper certainly bank.",19:38:45,CARDS
CUHL01704932377151,GB91DITZ74834780737967,4/4/2017,3020.23,100002,N,Credited,OPERA,POS,Cr,18:46:07,26:47:07,12/28/2017,10339367,1741.1,2,"Here me question pass method among.
High board pay list indeed especially. Husband why upon several although resource fight sport. Election cost imagine thing those.",23:29:22,IMPS
CUHL01704932377151,GB91DITZ74834780737967,4/4/2017,4734.84,100002,N,Credited,OPERA,POS,Cr,6:11:26,10:47:18,12/29/2017,35823155,1714.61,4,"Pattern plan turn. Firm always receive. Behavior attack simply. Play little wrong discussion take art.
Can trade heart break ask. Second ok teacher direction.",8:25:35,UPI
CUHL01704932377151,GB91DITZ74834780737967,4/4/2017,3020.23,100002,Y,Online Shopping,FF,POS,Dr,15:13:02,19:08:28,12/29/2017,61143746,1714.61,3,"Newspaper agent wide than animal. Late church add rock letter.
Note manager cold plan unit activity. Age seek capital image soldier fish record. Defense add quickly produce get claim.",16:17:58,RTGS
CUHL01704932377151,GB91DITZ74834780737967,4/4/2017,1753.77,100002,Y,Groceries,FF,MOBILE,Dr,4:33:38,7:36:08,12/31/2017,76949340,1266.46,3,"Almost sort want. Bar must hope sign anything.
Wrong when partner professional scientist life. Discover left as card west across. Course their not however and standard.",6:24:18,RTGS
CUHL01704932377151,GB91DITZ74834780737967,4/4/2017,3020.23,100002,N,Credited,FF,PC,Cr,8:14:05,11:19:12,12/31/2017,10101124,1266.46,2,Everything draw audience mention run. Director some by particular treatment you cell. Radio rock hard argue. Build memory friend fine point scene.,10:11:52,IMPS
CUHL01704932377151,GB91DITZ74834780737967,4/4/2017,4286.69,100002,N,Credited,CHROME,MOBILE,Cr,14:41:38,17:36:00,12/31/2017,61593695,1266.46,7,"Training carry society prove performance. Lot most almost trouble capital recent civil.
Number while should. Thus common available loss decade page. Business dark whom heart.",15:54:15,DD
CUHL01704932377151,GB91DITZ74834780737967,4/4/2017,5553.15,100002,N,Credited,IE,PC,Cr,17:27:21,20:16:35,12/31/2017,2059068,1266.46,2,"Partner between product blue force key small. Better tax about night which.
Movie something purpose bad course maintain. Establish stay center.",18:37:24,IMPS
CUHL01704932377151,GB91DITZ74834780737967,4/4/2017,6819.61,100002,N,Credited,FF,MOBILE,Cr,19:42:27,21:29:01,12/31/2017,23756038,1266.46,7,"Skin drive test leave offer. Life this thought task glass.
Population business firm common. American ago to list subject form. Always accept decision building herself state wrong.",21:04:44,DD
CUHL01704932377151,GB91DITZ74834780737967,4/4/2017,6023.83,100002,Y,Rent,EDGE,POS,Dr,4:59:27,10:30:15,1/1/2018,10102428,795.78,5,"Ever respond name. Mission decade throw move organization just item artist.
Simple pretty side process child step think. Course maintain moment piece product life.",7:35:12,CARDS
CUHL01704932377151,GB91DITZ74834780737967,4/4/2017,6819.61,100002,N,Credited,EDGE,PC,Cr,13:51:29,16:55:34,1/1/2018,45111297,795.78,6,"Morning guy service structure fine phone such. Plan case address customer organization everybody again.
Large source senior say environmental store.",14:46:41,CHEQUE
CUHL01704932377151,GB91DITZ74834780737967,4/4/2017,7615.39,100002,N,Credited,MI,PC,Cr,19:53:18,23:30:56,1/1/2018,30156449,795.78,1,"Their reach likely. Trade Congress institution.
History build different yeah. Base large character door city fact. Four just spring second. Reality modern effort provide.",21:46:33,NEFT
CUHL01704932377151,GB91DITZ74834780737967,4/4/2017,8648.23,100002,N,Credited,EDGE,MOBILE,Cr,5:46:46,7:24:25,1/12/2018,69414381,1032.84,2,"Nice nothing serious possible industry media impact.
Travel nature star manage. Federal bring discover instead. She woman those.",6:36:21,IMPS
CUHL01704932377151,GB91DITZ74834780737967,4/4/2017,9681.07,100002,N,Credited,MI,POS,Cr,10:25:23,11:55:16,1/12/2018,39580733,1032.84,3,Without catch mean along safe wish four. See budget base quality whatever herself special authority. Chair discover line cup easy of.,11:29:21,RTGS
CUHL01704932377151,GB91DITZ74834780737967,4/4/2017,8648.23,100002,Y,Transportation,MI,PC,Dr,13:59:27,16:21:23,1/12/2018,99058241,1032.84,4,"Recent general difficult window cup. Those and name heart community sure. Task board evening trip.
Likely point maintain prevent manager. Race form table anyone international western.",15:47:48,UPI
CUHL01704932377151,GB91DITZ74834780737967,4/4/2017,7615.39,100002,Y,Utilities,IE,MOBILE,Dr,15:54:57,19:05:18,1/12/2018,98688890,1032.84,2,"Loss serious low figure. Especially father line popular alone. Human sell all director own street above.
Off decision page amount sense. Represent guess accept government.",17:24:18,IMPS
CUHL01704932377151,GB91DITZ74834780737967,4/4/2017,8648.23,100002,N,Credited,EDGE,MOBILE,Cr,23:03:08,25:16:31,1/12/2018,37177485,1032.84,3,Experience current bit what. Certain Republican course use whether network main.,23:35:18,RTGS
CUHL01704932377151,GB91DITZ74834780737967,4/4/2017,8037.21,100002,Y,Utilities,FF,MOBILE,Dr,8:23:04,12:36:58,1/20/2018,83105999,611.02,7,"Air way voice your speech collection trip.
Serve sea include anything matter might. Author accept rest trip general group choice arm. Hope politics threat. Nation manager arm job physical likely it.",10:00:32,DD
CUHL01704932377151,GB91DITZ74834780737967,4/4/2017,7426.19,100002,Y,Utilities,EDGE,POS,Dr,11:18:50,13:44:24,1/20/2018,44459147,611.02,7,"Too fly Congress hotel less public. Most only customer never issue peace tell. Statement laugh run.
Together draw actually garden. Fill firm order necessary identify cover. Wall evening positive.",12:18:58,DD
CUHL01704932377151,GB91DITZ74834780737967,4/4/2017,8037.21,100002,N,Credited,IE,MOBILE,Cr,21:14:15,24:56:04,1/20/2018,18022513,611.02,7,"Help ability stop friend herself hour. Physical experience few offer drop fact avoid. Word student attack together PM put my.
Physical at true. Moment subject its others her church.",22:26:19,DD
CUHL01704932377151,GB91DITZ74834780737967,4/4/2017,8882.41,100002,N,Credited,EDGE,POS,Cr,8:00:54,10:31:32,1/21/2018,66443438,845.2,2,"Add professional able recognize because property executive. Or shake measure.
Large rest even type if pass. Travel clearly dream whole since next suffer. Truth top its movement section suddenly.",8:42:32,IMPS
CUHL01704932377151,GB91DITZ74834780737967,4/4/2017,8037.21,100002,Y,Entertainment,SAFARI,POS,Dr,11:28:44,14:13:18,1/21/2018,32663907,845.2,6,"Just appear kind. Support reach consumer need. Eight field including total. Himself to draw.
Manage exist able. Federal under mouth forward that painting.",13:39:02,CHEQUE
CUHL01704932377151,GB91DITZ74834780737967,4/4/2017,8882.41,100002,N,Credited,MI,POS,Cr,13:44:07,16:53:58,1/21/2018,386708,845.2,7,"Become fill write place natural.
Various same say my class eight. Someone class ok people.
Hospital choose decide speak.",15:30:17,DD
CUHL01704932377151,GB91DITZ74834780737967,4/4/2017,8037.21,100002,Y,Utilities,EDGE,MOBILE,Dr,19:56:22,22:37:45,1/21/2018,8921871,845.2,1,"Food act poor medical security citizen treatment. Fire animal painting.
Century argue term method guess. Medical free your road throughout crime company.",22:05:13,NEFT
CUHL01704932377151,GB91DITZ74834780737967,4/4/2017,9223.84,100002,N,Credited,SAFARI,MOBILE,Cr,15:14:47,23:31:45,1/31/2018,29267149,1186.63,4,Bill two admit claim. Over feeling ever ago phone then table. Travel value our see community garden.,18:46:16,UPI
CUHL01704932377151,GB91DITZ74834780737967,4/4/2017,7761.91,100002,Y,Personal Care,CHROME,MOBILE,Dr,5:02:34,8:59:13,2/5/2018,7395369,1461.93,5,"History rich group entire.
Defense section quite build. Save role only before.",6:24:08,CARDS
CUHL01704932377151,GB91DITZ74834780737967,4/4/2017,9223.84,100002,N,Credited,OPERA,PC,Cr,10:08:26,14:33:42,2/5/2018,40498881,1461.93,7,Although set relationship their. Leader nearly by me they prove player. Whether paper plan effort record. Entire reveal onto summer knowledge parent interview.,12:39:22,DD
CUHL01704932377151,GB91DITZ74834780737967,4/4/2017,10685.77,100002,N,Credited,CHROME,POS,Cr,19:13:34,21:36:32,2/5/2018,55970358,1461.93,1,"Book of land where crime.
Interview weight minute.
Suddenly leader door writer. Kind per wide billion into animal part.",20:01:00,NEFT
CUHL01704932377151,GB91DITZ74834780737967,4/4/2017,8787.06,100002,Y,Insurance,FF,POS,Dr,4:13:48,6:32:02,2/7/2018,35889717,1898.71,7,"Resource since good within old some which. Be exist ahead she.
Nothing collection tree. Simple sort base civil reason person. Current crime Congress before capital.",5:30:55,DD
CUHL01704932377151,GB91DITZ74834780737967,4/4/2017,6888.35,100002,Y,Medicals,FF,POS,Dr,7:38:19,9:38:14,2/7/2018,42296676,1898.71,7,Political significant within social future go rock. Teacher note sit entire single now capital. Defense star white.,8:43:14,DD
CUHL01704932377151,GB91DITZ74834780737967,4/4/2017,4989.64,100002,Y,Medicals,OPERA,MOBILE,Dr,12:33:59,15:40:40,2/7/2018,66474067,1898.71,5,"Stage beyond answer go.
Travel behind behavior forward risk study. Course help end social.",14:20:36,CARDS
CUHL01704932377151,GB91DITZ74834780737967,4/4/2017,3090.93,100002,Y,Transportation,IE,PC,Dr,18:54:00,21:11:24,2/7/2018,19525969,1898.71,4,"Perhaps commercial quite treat interview create.
I property serious modern firm increase.
Bag defense medical. Garden minute according especially she Mr.",19:19:13,UPI
CUHL01704932377151,GB91DITZ74834780737967,4/4/2017,1192.22,100002,Y,Entertainment,IE,PC,Dr,20:08:19,21:04:26,2/7/2018,10103371,1898.71,7,"Debate within individual under key nation.
Thousand guy evidence alone hear for. Yet these outside whether economy own civil face. In certainly movement role.",20:34:12,DD
CUHL01704932377151,GB91DITZ74834780737967,4/4/2017,2779.29,100002,N,Credited,OPERA,POS,Cr,13:58:10,17:45:43,2/18/2018,47024441,1587.07,5,"Where well speak cost clearly give thousand. Structure our tree north. Gas car box rise herself accept.
Democratic food necessary stand tax close. Able chance ready myself have.",15:59:40,CARDS
CUHL01704932377151,GB91DITZ74834780737967,4/4/2017,4366.36,100002,N,Credited,EDGE,MOBILE,Cr,19:43:19,23:05:27,2/18/2018,73329633,1587.07,1,Commercial each involve church. People learn lawyer prove near. Money bank culture argue son once course every.,21:34:40,NEFT
CUHL01704932377151,GB91DITZ74834780737967,4/4/2017,5725.13,100002,N,Credited,CHROME,MOBILE,Cr,4:19:30,7:02:05,3/1/2018,53941657,1358.77,1,"Popular maintain however use Democrat high. Line in democratic agency star example send.
Democrat this do after billion. Commercial painting scene need nature economic test middle.",6:10:10,NEFT
CUHL01704932377151,GB91DITZ74834780737967,4/4/2017,7083.9,100002,N,Credited,IE,MOBILE,Cr,9:14:31,11:31:29,3/1/2018,55948074,1358.77,6,"Market staff indeed hard always operation. Foot another after project.
Too close play top. Effect successful bank quickly. Affect before agent young everyone.",9:59:22,CHEQUE
CUHL01704932377151,GB91DITZ74834780737967,4/4/2017,8442.67,100002,N,Credited,MI,MOBILE,Cr,13:23:29,15:08:43,3/1/2018,79852586,1358.77,5,Area agent body require. Newspaper inside Mrs summer. Which read follow beat support be hundred seem.,13:56:40,CARDS
CUHL01704932377151,GB91DITZ74834780737967,4/4/2017,7083.9,100002,Y,Utilities,OPERA,PC,Dr,15:07:20,17:08:24,3/1/2018,29922437,1358.77,3,"Second happen pull. Partner remember owner. South could hear again.
Who leg section meeting high big personal. Job medical body. Up future animal resource meeting clearly.",16:16:03,RTGS
CUHL01704932377151,GB91DITZ74834780737967,4/4/2017,8442.67,100002,N,Credited,SAFARI,MOBILE,Cr,19:05:22,21:35:14,3/1/2018,32364415,1358.77,3,"View support important six leg foot store. Least wrong down every. Else their meeting series name however leave.
Where respond person person discuss speak role.",20:07:37,RTGS
CUHL01704932377151,GB91DITZ74834780737967,4/4/2017,9615.54,100002,N,Credited,MI,POS,Cr,3:40:09,6:39:56,3/4/2018,90945632,1172.87,4,Do figure they court carry. Both quality senior skin. Three us production officer peace important get.,4:48:14,UPI
CUHL01704932377151,GB91DITZ74834780737967,4/4/2017,10788.41,100002,N,Credited,SAFARI,MOBILE,Cr,7:40:33,10:30:55,3/4/2018,64154374,1172.87,2,"Direction country serve back. Standard cause bag exist. Perhaps financial specific line responsibility participant.
Firm kitchen free.
Material more beautiful hard.",8:45:50,IMPS
CUHL01704932377151,GB91DITZ74834780737967,4/4/2017,11961.28,100002,N,Credited,CHROME,POS,Cr,10:47:59,13:38:45,3/4/2018,27392904,1172.87,3,Job reduce beat lawyer answer several change. Role people actually space meet administration poor.,12:03:15,RTGS
CUHL01704932377151,GB91DITZ74834780737967,4/4/2017,13134.15,100002,N,Credited,CHROME,POS,Cr,15:35:32,18:09:18,3/4/2018,64139715,1172.87,5,"Mouth front range marriage boy.
Forget stay American machine bank such like. Simply town practice cut.",17:30:37,CARDS
CUHL01704932377151,GB91DITZ74834780737967,4/4/2017,11961.28,100002,Y,Transportation,CHROME,POS,Dr,21:43:31,23:34:08,3/4/2018,49581720,1172.87,2,"Trade time capital include. Drop scene interest air.
Do bit summer should decision. Himself state toward marriage discover impact through. Catch police door guy understand run write night.",22:21:38,IMPS
CUHL01704932377151,GB91DITZ74834780737967,4/4/2017,11912.48,100002,Y,Dining,IE,PC,Dr,2:46:48,5:42:18,3/20/2018,9888296,48.8,3,"Exist he development value sport. Trouble price require area. Nearly seem speech dark.
Thousand use feeling conference would wall. Determine than describe model police tough order major.",4:29:14,RTGS
CUHL01704932377151,GB91DITZ74834780737967,4/4/2017,11961.28,100002,N,Credited,OPERA,POS,Cr,6:41:17,9:45:31,3/20/2018,15622693,48.8,4,Kid rather me capital sure. Let family common significant song good let. Charge toward food top between human.,8:29:00,UPI
CUHL01704932377151,GB91DITZ74834780737967,4/4/2017,11912.48,100002,Y,Personal Care,IE,MOBILE,Dr,13:20:28,14:51:30,3/20/2018,58614716,48.8,5,"Anything culture activity difficult tree. International who board. Detail suffer join.
Yeah Congress serve top these look half. Scene institution easy environment.",13:53:08,CARDS
CUHL01704932377151,GB91DITZ74834780737967,4/4/2017,11863.68,100002,Y,Groceries,IE,MOBILE,Dr,14:59:36,17:34:46,3/20/2018,13817220,48.8,7,"Probably message worry black listen hotel. Contain real view open decide.
Window one force sea say start education. Car record item make. Beautiful low fire case.",16:48:43,DD
CUHL01704932377151,GB91DITZ74834780737967,4/4/2017,11814.88,100002,Y,Rent,FF,PC,Dr,23:05:30,25:19:25,3/20/2018,4244646,48.8,4,"Team push purpose research which child security. Effect herself wear spend. Personal writer partner both nor nation.
Certain kind other at place word several. Pick prevent hotel mean wide.",23:56:59,UPI
CUHL01704932377151,GB91DITZ74834780737967,4/4/2017,13460.34,100002,N,Credited,IE,MOBILE,Cr,6:34:39,10:05:12,3/24/2018,16557833,1645.46,7,"Onto may peace section forward second. Technology participant experience almost should.
Big behind town character along. Staff three political year realize. Then college thought process thing.",9:09:36,DD
CUHL01704932377151,GB91DITZ74834780737967,4/4/2017,11814.88,100002,Y,Dining,FF,POS,Dr,14:20:25,19:17:33,3/24/2018,50903047,1645.46,4,"Spring open position know five green. Campaign fight foot arrive. Scientist benefit position imagine safe ever radio.
Energy lot view value stand your near. Impact style point visit page.",16:32:24,UPI
CUHL01704932377151,GB91DITZ74834780737967,4/4/2017,10169.42,100002,Y,Insurance,CHROME,MOBILE,Dr,15:28:30,20:50:58,3/24/2018,47496668,1645.46,7,"Why cup state off. Many hot would happen concern the ahead window.
Structure out begin response. High choose month senior crime analysis. National focus entire look.",18:25:13,DD
CUHL01704932377151,GB91DITZ74834780737967,4/4/2017,9593.92,100002,Y,Dining,IE,PC,Dr,8:55:17,13:41:36,3/29/2018,56627589,575.5,5,"Choose two perhaps someone author. Sometimes series better although rise write. Tend view center.
Fish once head actually eat. Opportunity style network pass performance west since.",11:04:28,CARDS
CUHL01704932377151,GB91DITZ74834780737967,4/4/2017,9018.42,100002,Y,Transportation,EDGE,PC,Dr,14:35:20,18:01:34,3/29/2018,29629589,575.5,3,Member yourself benefit can cold short. Fear themselves themselves interview. Social able poor adult follow. What forward represent land evidence pattern woman.,17:04:38,RTGS
CUHL01704932377151,GB91DITZ74834780737967,4/4/2017,8442.92,100002,Y,Rent,SAFARI,PC,Dr,18:44:03,23:02:37,3/29/2018,28988465,575.5,5,Receive seven music investment. Local itself political as trial body relationship. Successful nor whatever involve west.,20:41:16,CARDS
CUHL01704932377151,GB91DITZ74834780737967,4/4/2017,7543.52,100002,Y,Household Consumables,SAFARI,MOBILE,Dr,4:46:23,7:31:13,3/31/2018,74641819,899.4,6,Artist matter reach police coach hard. Forget good former stage character follow necessary. Thing focus college shake glass man.,5:18:25,CHEQUE
CUHL01704932377151,GB91DITZ74834780737967,4/4/2017,8442.92,100002,N,Credited,MI,MOBILE,Cr,12:30:02,15:41:41,3/31/2018,5013272,899.4,4,"Easy only thousand quite but hand leave develop. Live century loss assume.
Run very clear play game book. Billion save thus style. Thought call particular social.",13:40:14,UPI
CUHL01704932377151,GB91DITZ74834780737967,4/4/2017,9342.32,100002,N,Credited,MI,PC,Cr,13:44:46,17:10:09,3/31/2018,55529655,899.4,4,"Each east drop quite. Fire which you choice.
Daughter life foreign place firm information receive. Crime next sense garden charge. Foreign ten imagine almost compare.",15:06:54,UPI
CUHL01704932377151,GB91DITZ74834780737967,4/4/2017,8442.92,100002,Y,Dining,CHROME,PC,Dr,22:29:31,23:58:19,3/31/2018,11525660,899.4,2,Police especially change resource name be. Party bit establish. Book white approach total shake. Guy determine carry talk teacher together ever defense.,23:17:21,IMPS
CUHL01704932377151,GB91DITZ74834780737967,4/4/2017,8005.15,100002,Y,Insurance,SAFARI,POS,Dr,13:39:16,19:34:11,4/3/2018,17521079,437.77,7,"Change manager dinner road their. Finally let result quickly walk provide worry.
World the show state. Benefit discussion author eight hospital. Land interest table drop level.",16:07:44,DD
CUHL01704932377151,GB91DITZ74834780737967,4/4/2017,6744.47,100002,Y,Utilities,SAFARI,POS,Dr,8:49:56,13:01:11,4/15/2018,51888176,1260.68,2,"Section pretty traditional order medical remember amount. Experience establish PM go best natural.
Within behind especially fact. Air blood nothing production produce. You kitchen there painting ago.",10:43:59,IMPS
CUHL01704932377151,GB91DITZ74834780737967,4/4/2017,8005.15,100002,N,Credited,EDGE,MOBILE,Cr,15:02:15,18:00:42,4/15/2018,8349422,1260.68,2,"Improve feel hear would. Effect else consider like population dinner. Serious firm you air know.
Edge sister against clearly hold interview conference. Room best trip forward.",17:01:12,IMPS
CUHL01704932377151,GB91DITZ74834780737967,4/4/2017,9141.17,100002,N,Credited,EDGE,MOBILE,Cr,6:58:07,9:24:50,4/16/2018,96811931,1136.02,5,"Remain civil boy mouth. Fire evening assume coach people surface her break. Often bad capital nearly rock hot speech.
Line former agency each. Since eye television sea her lawyer call.",8:21:32,CARDS
CUHL01704932377151,GB91DITZ74834780737967,4/4/2017,10277.19,100002,N,Credited,SAFARI,PC,Cr,10:42:06,14:54:19,4/16/2018,60850300,1136.02,7,"Deal eat idea attention. Push around sport special full despite size.
Society station certainly race. Building establish hotel.",12:52:32,DD
CUHL01704932377151,GB91DITZ74834780737967,4/4/2017,11413.21,100002,N,Credited,OPERA,MOBILE,Cr,21:19:06,24:19:15,4/16/2018,56883237,1136.02,7,"Similar name many each. Many fire lawyer knowledge half top activity. Least describe likely example coach.
Upon cultural however eat. Fall lawyer every. Ahead call now.",23:30:43,DD
CUHL01704932377151,GB91DITZ74834780737967,4/4/2017,11045.26,100002,Y,Groceries,OPERA,MOBILE,Dr,6:00:17,10:55:19,4/19/2018,5300624,367.95,2,Reason question my relate. There science last hand new. Big where less.,9:47:36,IMPS
CUHL01704932377151,GB91DITZ74834780737967,4/4/2017,10677.31,100002,Y,Utilities,MI,POS,Dr,19:42:08,23:27:03,4/19/2018,27689042,367.95,7,"Time miss end push. Million factor try move use top.
Sure language class finally real morning.",21:16:45,DD
CUHL01704932377151,GB91DITZ74834780737967,4/4/2017,8804.9,100002,Y,Rent,CHROME,POS,Dr,7:30:34,11:14:52,4/29/2018,41823194,1872.41,1,"Audience expert girl affect north white blue edge. Task international doctor management resource.
Difficult want draw job get almost west. Base including by him. Sure my visit once management.",8:59:59,NEFT
CUHL01704932377151,GB91DITZ74834780737967,4/4/2017,6932.49,100002,Y,Insurance,EDGE,PC,Dr,14:13:42,18:32:14,4/29/2018,77878618,1872.41,7,"Officer budget grow force. Baby now writer sing. Particularly quality however arm boy experience source.
Past baby serve seek.",16:05:28,DD
CUHL01704932377151,GB91DITZ74834780737967,4/4/2017,8804.9,100002,N,Credited,OPERA,PC,Cr,21:27:47,25:13:54,4/29/2018,58291245,1872.41,6,"Computer find money factor. Center specific blue by. Wrong great add return.
But officer participant course study win relate north.",22:46:28,CHEQUE
CUHL01704932377151,GB91DITZ74834780737967,4/4/2017,10684.89,100002,N,Credited,CHROME,PC,Cr,7:36:50,9:31:11,4/30/2018,21615177,1879.99,5,"If safe drive discuss. Law fund consumer for.
Fear hard clear something. Decade she open media against friend.
Consider would impact third seem little. Item that need buy. Day style star.",8:57:09,CARDS
CUHL01704932377151,GB91DITZ74834780737967,4/4/2017,8804.9,100002,Y,Transportation,CHROME,PC,Dr,9:12:17,10:42:15,4/30/2018,31620550,1879.99,6,"Reason pull minute send agreement argue consumer. Debate task dark quality.
Receive serious charge resource because exactly reach. Easy far need short.",10:02:57,CHEQUE
CUHL01704932377151,GB91DITZ74834780737967,4/4/2017,10684.89,100002,N,Credited,IE,MOBILE,Cr,16:54:28,20:57:18,4/30/2018,93986946,1879.99,3,Former could design begin wait Congress father image. Difficult physical can decision evening follow he. Short today employee full my section.,18:48:58,RTGS
CUHL01704932377151,GB91DITZ74834780737967,4/4/2017,12564.88,100002,N,Credited,FF,POS,Cr,21:58:46,25:23:16,4/30/2018,70915952,1879.99,1,"Something performance give in sure. Over pass marriage guy student.
Capital low final significant before hour. Watch sing only word.",23:53:12,NEFT
CUHL01704932377151,GB91DITZ74834780737967,4/4/2017,12885.22,100002,N,Credited,SAFARI,PC,Cr,6:07:24,11:20:29,5/21/2018,74751938,320.34,7,"Fire history could by key stuff produce. Unit speak again eye money. Why ever democratic appear issue nice.
Sport one discover my. Mission end on together. Phone section thank analysis.",9:39:08,DD
CUHL01704932377151,GB91DITZ74834780737967,4/4/2017,12564.88,100002,Y,Online Shopping,SAFARI,POS,Dr,20:56:47,24:36:59,5/21/2018,1065756,320.34,3,"Writer message single ball reason might. Time door receive member include.
Modern sound local fast she. Despite increase American environmental college establish picture would.",23:14:14,RTGS
CUHL01704932377151,GB91DITZ74834780737967,4/4/2017,13101.83,100002,N,Credited,EDGE,POS,Cr,3:29:19,6:44:28,6/7/2018,81545032,536.95,6,"One clear food worry ready place. Low serve campaign visit campaign do democratic range.
Local most other stop design significant both. Save us miss forward computer natural.",4:54:22,CHEQUE
CUHL01704932377151,GB91DITZ74834780737967,4/4/2017,12564.88,100002,Y,Household Consumables,FF,PC,Dr,9:32:29,12:26:10,6/7/2018,65647264,536.95,5,"Seven president much field on land. Represent production recently pressure.
Decide all program month situation. Fight reflect realize indicate case main spend.",11:38:48,CARDS
CUHL01704932377151,GB91DITZ74834780737967,4/4/2017,12027.93,100002,Y,Rent,SAFARI,POS,Dr,17:17:08,20:20:31,6/7/2018,82959371,536.95,5,"We cell between win stock life. Make son thousand yes meet. Brother as fast do. Clear serious ahead run hold build.
Wonder onto much rich memory individual. Machine build movie consumer.",18:44:14,CARDS
CUHL01704932377151,GB91DITZ74834780737967,4/4/2017,11490.98,100002,Y,Rent,FF,MOBILE,Dr,23:04:15,25:28:32,6/7/2018,5562435,536.95,4,"Drug actually American record herself respond. Specific administration contain movement.
Expect else former thus. Majority type state situation visit.",23:50:19,UPI
CUHL01704932377151,GB91DITZ74834780737967,4/4/2017,12569.81,100002,N,Credited,IE,POS,Cr,8:23:25,10:06:13,6/14/2018,93351331,1078.83,3,"None much including forget because bring author. Wide statement single camera yes board west. National himself again outside.
Single bar everyone. Early challenge increase several keep.",9:13:20,RTGS
CUHL01704932377151,GB91DITZ74834780737967,4/4/2017,13648.64,100002,N,Credited,EDGE,MOBILE,Cr,11:15:31,14:24:37,6/14/2018,70978537,1078.83,5,"Natural national maintain water case. Chance thousand above investment.
Reduce break evidence player let. Treat because many view keep activity. Change indeed car yet view.",12:03:45,CARDS
CUHL01704932377151,GB91DITZ74834780737967,4/4/2017,14727.47,100002,N,Credited,EDGE,POS,Cr,17:19:34,21:30:03,6/14/2018,37074982,1078.83,1,"Nice at good. Body firm professional sign. Phone both foot society popular enjoy. Between he half arrive pattern eat.
Fund successful increase appear picture. Exactly wear wear work understand.",20:08:11,NEFT
CUHL01704932377151,GB91DITZ74834780737967,4/4/2017,14941.23,100002,N,Credited,CHROME,PC,Cr,4:08:56,8:29:44,6/15/2018,75524111,213.76,3,"Team bar phone lawyer realize. Often both open. Peace describe poor over attention.
Ready receive major write memory owner.",6:34:06,RTGS
CUHL01704932377151,GB91DITZ74834780737967,4/4/2017,15154.99,100002,N,Credited,EDGE,POS,Cr,10:21:31,13:17:36,6/15/2018,57301297,213.76,7,"His bar black prove politics ok economy. Pressure speech help room including. Bring rather but inside class.
Help through attack. Much heart case.",12:15:31,DD
CUHL01704932377151,GB91DITZ74834780737967,4/4/2017,15368.75,100002,N,Credited,MI,MOBILE,Cr,16:56:07,19:27:36,6/15/2018,30599642,213.76,3,"Explain popular conference fund forget. Two admit fund world throughout investment keep.
Growth let north agree direction with. Near fine key school specific.
Skin management man start white line.",18:03:19,RTGS
CUHL01704932377151,GB91DITZ74834780737967,4/4/2017,17030.15,100002,N,Credited,FF,MOBILE,Cr,9:49:58,15:17:26,7/1/2018,90154508,1661.4,3,"Fact heart phone will area. Enough head ok animal.
Us suffer already manager growth. Study second season meeting house on. Source state middle represent look star see. Consumer she page expect.",12:25:20,RTGS
CUHL01704932377151,GB91DITZ74834780737967,4/4/2017,18691.55,100002,N,Credited,SAFARI,PC,Cr,14:38:40,20:35:28,7/1/2018,40717869,1661.4,1,"Nor single clear bag avoid yourself simple. Result mouth agent physical.
Common quite station late recent hit quality special. Bill worker plan yet land.",17:50:43,NEFT
CUHL01704932377151,GB91DITZ74834780737967,4/4/2017,19358.13,100002,N,Credited,CHROME,MOBILE,Cr,9:23:49,12:07:36,7/3/2018,25289114,666.58,4,"Everyone training baby none. Process contain within first. Take camera home evidence.
Side produce idea research. Another against kid them maybe street source.",10:14:18,UPI
CUHL01704932377151,GB91DITZ74834780737967,4/4/2017,20024.71,100002,N,Credited,CHROME,MOBILE,Cr,12:48:47,15:49:56,7/3/2018,54964693,666.58,3,Employee black director open PM. Newspaper generation also laugh young consumer sound. Energy finally onto and art close actually whole.,14:30:54,RTGS
CUHL01704932377151,GB91DITZ74834780737967,4/4/2017,19358.13,100002,Y,Household Consumables,EDGE,POS,Dr,15:33:17,18:55:17,7/3/2018,12129959,666.58,4,"Top century television movement side.
Together option degree yes him challenge. Main above not.",18:12:12,UPI
CUHL01704932377151,GB91DITZ74834780737967,4/4/2017,19969.27,100002,N,Credited,CHROME,MOBILE,Cr,6:36:53,9:58:40,7/8/2018,40594934,611.14,6,Example everyone best type same perform rule cause. Night hand management beautiful traditional. Two beautiful lay often travel concern be.,7:38:04,CHEQUE
CUHL01704932377151,GB91DITZ74834780737967,4/4/2017,19358.13,100002,Y,Groceries,IE,MOBILE,Dr,11:50:58,14:55:32,7/8/2018,3448731,611.14,7,"Write different represent design. Through affect local lay never loss. Allow professor talk also.
Ten bill raise song TV unit stand. Voice result quality. Majority feel cost audience region.",14:08:00,DD
CUHL01704932377151,GB91DITZ74834780737967,4/4/2017,19969.27,100002,N,Credited,IE,MOBILE,Cr,17:05:21,19:49:02,7/8/2018,38953842,611.14,1,Reach beat ever religious official. Seek away cup prepare able employee. Anything simply outside plant sport food as.,18:47:34,NEFT
CUHL01704932377151,GB91DITZ74834780737967,4/4/2017,19358.13,100002,Y,Insurance,EDGE,POS,Dr,20:58:29,22:36:22,7/8/2018,36832231,611.14,7,Cold memory sense yes glass. Require behavior former glass. Rate country mouth across series.,22:05:51,DD
CUHL01704932377151,GB91DITZ74834780737967,4/4/2017,17995.96,100002,Y,Utilities,FF,MOBILE,Dr,4:20:39,7:57:49,7/11/2018,75691738,1362.17,1,Treat Republican buy source eye health. Later fill speech those not himself.,6:07:59,NEFT
CUHL01704932377151,GB91DITZ74834780737967,4/4/2017,19358.13,100002,N,Credited,OPERA,PC,Cr,9:14:21,11:37:36,7/11/2018,63884456,1362.17,3,Time into if although reveal area. Thought sell skin rich.,10:45:54,RTGS
CUHL01704932377151,GB91DITZ74834780737967,4/4/2017,20720.3,100002,N,Credited,FF,MOBILE,Cr,11:04:10,13:32:23,7/11/2018,2910468,1362.17,4,"Now ok front city admit state set. Issue explain ready give.
Order go news toward task. Party eye whom sister reflect offer. Herself food organization fly road trade may bit.",13:03:33,UPI
CUHL01704932377151,GB91DITZ74834780737967,4/4/2017,22082.47,100002,N,Credited,OPERA,POS,Cr,17:46:54,20:36:39,7/11/2018,98880911,1362.17,4,Participant single cover machine space. Character care physical production stuff. Decision camera oil bring key.,19:05:51,UPI
CUHL01704932377151,GB91DITZ74834780737967,4/4/2017,20720.3,100002,Y,Groceries,OPERA,PC,Dr,20:14:05,22:31:16,7/11/2018,95405094,1362.17,6,Themselves candidate everyone score strategy. Listen indeed even cultural compare federal. Spring there account bit tonight ground.,21:35:31,CHEQUE
CUHL01704932377151,GB91DITZ74834780737967,4/4/2017,21132.8,100002,N,Credited,CHROME,POS,Cr,16:02:11,24:23:35,7/13/2018,65856253,412.5,6,"Without quickly character. There degree sign type move yes. Although Republican activity hand.
Interest sometimes source wife interesting. Particularly draw skill pattern billion name.",19:51:45,CHEQUE
CUHL01704932377151,GB91DITZ74834780737967,4/4/2017,19465.65,100002,Y,Utilities,CHROME,PC,Dr,8:38:36,10:47:22,7/18/2018,31006453,1667.15,5,Model determine task animal put tell only nothing. Agent better give daughter gas. Then environmental street fall affect light discussion hot.,9:17:49,CARDS
CUHL01704932377151,GB91DITZ74834780737967,4/4/2017,17798.5,100002,Y,Personal Care,CHROME,PC,Dr,9:37:37,13:30:22,7/18/2018,81218158,1667.15,6,"Soon behavior nice. Hand tell really kid bed.
Drug a east. Much sea against staff pay early.
Race outside hear everything young. White goal because professional dinner.",12:19:59,CHEQUE
CUHL01704932377151,GB91DITZ74834780737967,4/4/2017,16131.35,100002,Y,Insurance,SAFARI,MOBILE,Dr,21:48:52,25:09:31,7/18/2018,5371136,1667.15,6,"Billion rather management song other.
Cause deal race notice bank little. This show season imagine.",23:29:29,CHEQUE
CUHL01704932377151,GB91DITZ74834780737967,4/4/2017,15157.67,100002,Y,Insurance,OPERA,POS,Dr,13:03:28,17:56:06,7/25/2018,66700975,973.68,2,Realize report director long defense. True note area along try. Else open type lay practice whether.,14:41:54,IMPS
CUHL01704932377151,GB91DITZ74834780737967,4/4/2017,14183.99,100002,Y,Dining,IE,POS,Dr,18:06:48,22:53:39,7/25/2018,99568443,973.68,7,"Road better oil. Community thought leader hundred sort newspaper argue.
People experience more during skill activity let. Now think school simple. You dinner know employee wear hold recently page.",19:24:29,DD
CUHL01704932377151,GB91DITZ74834780737967,4/4/2017,15108.36,100002,N,Credited,OPERA,MOBILE,Cr,6:31:28,12:51:59,7/28/2018,88691350,924.37,5,Stand address relationship front. Source understand break newspaper between it. Student position week measure successful.,8:52:51,CARDS
CUHL01704932377151,GB91DITZ74834780737967,4/4/2017,14183.99,100002,Y,Groceries,EDGE,PC,Dr,19:05:17,24:01:49,7/28/2018,54810747,924.37,5,Pass put idea every responsibility month. Sure down however finally able. Describe just including report color activity.,20:19:26,CARDS
CUHL01704932377151,GB91DITZ74834780737967,4/4/2017,14218.48,100002,N,Credited,FF,PC,Cr,6:16:14,10:55:23,8/7/2018,74356898,34.49,6,"Financial improve rich heart owner. Customer information require. Member sort spend even few. Hair food television over.
Special market opportunity budget plant improve. Beat box with.",8:33:49,CHEQUE
CUHL01704932377151,GB91DITZ74834780737967,4/4/2017,14183.99,100002,Y,Medicals,OPERA,POS,Dr,10:42:44,14:00:26,8/7/2018,75451868,34.49,2,Candidate support with police couple. Can whether community then information second mission.,12:15:05,IMPS
CUHL01704932377151,GB91DITZ74834780737967,4/4/2017,14218.48,100002,N,Credited,OPERA,MOBILE,Cr,17:31:40,19:15:09,8/7/2018,11428336,34.49,4,"Some allow member have soldier. Question approach general often open player. Other including ask source within. Little million choice particularly indicate war yes.
Real without control either.",18:24:36,UPI
CUHL01704932377151,GB91DITZ74834780737967,4/4/2017,13019.67,100002,Y,Utilities,FF,POS,Dr,3:55:54,7:53:52,8/19/2018,38514111,1198.81,2,"Concern none building significant somebody. Indeed social especially every join.
Thousand treat hit see. College approach tree. Argue far trouble safe leave.",5:56:52,IMPS
CUHL01704932377151,GB91DITZ74834780737967,4/4/2017,11820.86,100002,Y,Dining,OPERA,MOBILE,Dr,8:37:57,12:59:56,8/19/2018,73893448,1198.81,1,"Military reduce television front. Seek room stop. Address blue as together sense trip.
Suggest there free interview edge hit do. Really someone society trade.",11:01:32,NEFT
CUHL01704932377151,GB91DITZ74834780737967,4/4/2017,13019.67,100002,N,Credited,CHROME,MOBILE,Cr,16:02:42,18:27:27,8/19/2018,11629948,1198.81,1,Cost meet daughter both hear next TV. Accept employee animal price seem every. In six sport catch cultural rate. Art police evening.,17:41:07,NEFT
CUHL01704932377151,GB91DITZ74834780737967,4/4/2017,11820.86,100002,Y,Medicals,SAFARI,POS,Dr,18:36:54,21:36:58,8/19/2018,68431945,1198.81,4,"Doctor trial both character. Price capital cause high popular.
Attention tax hot economy speak less choose. Goal claim group successful will trade. Similar it relationship child international TV.",19:18:36,UPI
CUHL01704932377151,GB91DITZ74834780737967,4/4/2017,10633.97,100002,Y,Insurance,EDGE,MOBILE,Dr,7:55:36,10:39:00,8/29/2018,77116505,1186.89,6,"Thing we TV study factor middle. Loss choice effect thousand majority. Increase drop chance fund between likely policy.
Local because doctor film production some. Behind buy him wrong seem friend.",9:26:23,CHEQUE
CUHL01704932377151,GB91DITZ74834780737967,4/4/2017,9447.08,100002,Y,Medicals,SAFARI,MOBILE,Dr,12:15:30,15:16:41,8/29/2018,76699542,1186.89,5,"Arrive who protect happy eat. Once store shake consider actually.
Political building contain system scene beyond. Recent rather price team attack cup apply put. Worry company serve.",13:48:20,CARDS
CUHL01704932377151,GB91DITZ74834780737967,4/4/2017,10633.97,100002,N,Credited,CHROME,PC,Cr,12:15:05,16:38:24,8/29/2018,18495393,1186.89,2,"Someone whatever matter PM shoulder. Try series station baby fast letter.
Fire politics try black. Against his challenge for rich.
Note but reach phone baby next away. Drive expert agency.",14:34:18,IMPS
CUHL01704932377151,GB91DITZ74834780737967,4/4/2017,11820.86,100002,N,Credited,CHROME,MOBILE,Cr,18:10:35,21:14:19,8/29/2018,40203577,1186.89,1,Manage people indeed writer. Sell think receive draw social only newspaper. Story action not project finally.,20:18:57,NEFT
CUHL01704932377151,GB91DITZ74834780737967,4/4/2017,10720.68,100002,Y,Insurance,IE,POS,Dr,6:16:27,8:03:48,8/30/2018,35468592,1100.18,4,"Huge take rich four. Music number throughout effort some.
Truth paper trial simply simply capital not. Serious discover five bring growth able.
Tv specific send leader. Perhaps to military group and.",7:34:23,UPI
CUHL01704932377151,GB91DITZ74834780737967,4/4/2017,11820.86,100002,N,Credited,OPERA,PC,Cr,7:18:35,9:02:59,8/30/2018,22947888,1100.18,2,Sense to together friend task action. Over scientist performance blue travel simply. Put study current cause notice within. Or bank lay religious about per.,8:19:02,IMPS
CUHL01704932377151,GB91DITZ74834780737967,4/4/2017,12921.04,100002,N,Credited,CHROME,PC,Cr,14:24:49,16:15:11,8/30/2018,62694193,1100.18,2,"Choose national surface step bar. Skill analysis world nice. Item tree send political.
Contain whether prevent security serve join. Remember all affect plan.",15:06:18,IMPS
CUHL01704932377151,GB91DITZ74834780737967,4/4/2017,11820.86,100002,Y,Rent,IE,MOBILE,Dr,17:00:56,18:28:38,8/30/2018,64563459,1100.18,5,Happen why themselves strategy expect believe if administration. Go side true action eight.,17:30:55,CARDS
CUHL01704932377151,GB91DITZ74834780737967,4/4/2017,10720.68,100002,Y,Household Consumables,FF,MOBILE,Dr,20:27:48,22:57:05,8/30/2018,74013517,1100.18,3,"Hour site develop clear area born pull success. Easy surface as team account.
Later service reason single much between. Drug another main these. Right institution edge.",21:19:20,RTGS
CUHL01704932377151,GB91DITZ74834780737967,4/4/2017,10665.35,100002,Y,Online Shopping,FF,POS,Dr,12:12:26,16:34:11,8/31/2018,17133869,55.33,1,Learn and law central year. Keep activity whom yes central. Pick step difficult sign edge generation money.,15:24:00,NEFT
CUHL01704932377151,GB91DITZ74834780737967,4/4/2017,10720.68,100002,N,Credited,FF,POS,Cr,19:24:42,24:04:08,8/31/2018,66046127,55.33,7,Official white direction bed art summer determine beyond. Treatment believe party hundred. Statement save account the.,21:50:04,DD
CUHL01704932377151,GB91DITZ74834780737967,4/4/2017,11334.78,100002,N,Credited,EDGE,POS,Cr,5:04:42,11:06:11,9/1/2018,98297634,614.1,2,Authority ask wrong. Knowledge lead phone others anything cell.,8:48:04,IMPS
CUHL01704932377151,GB91DITZ74834780737967,4/4/2017,11948.88,100002,N,Credited,MI,MOBILE,Cr,19:45:51,23:07:00,9/1/2018,27153055,614.1,6,Time everybody range smile rule will give. Behind trouble head particularly generation number water. This community reveal truth her environmental go.,22:04:02,CHEQUE
CUHL01704932377151,GB91DITZ74834780737967,4/4/2017,11492.03,100002,Y,Personal Care,CHROME,MOBILE,Dr,8:07:44,12:49:50,9/12/2018,78491212,456.85,3,Someone rule community fight back check occur. Matter level toward nice opportunity build. Why hotel throw least be bag.,10:46:19,RTGS
CUHL01704932377151,GB91DITZ74834780737967,4/4/2017,11035.18,100002,Y,Rent,MI,PC,Dr,15:14:39,18:26:24,9/12/2018,25742015,456.85,7,"Talk resource can. Skill public trial. Ball decide street action.
By kind by draw growth save. Difficult cut follow win remember often music. Back several quality staff according art TV.",17:34:47,DD
CUHL01704932377151,GB91DITZ74834780737967,4/4/2017,12616.29,100002,N,Credited,OPERA,PC,Cr,7:20:50,8:49:58,9/19/2018,4765219,1581.11,2,"Him again enough phone responsibility. Machine pull fund question land these against recognize.
Green significant firm why candidate. Kid reflect pressure all include matter range.",8:00:32,IMPS
CUHL01704932377151,GB91DITZ74834780737967,4/4/2017,11035.18,100002,Y,Household Consumables,SAFARI,PC,Dr,10:40:22,13:08:25,9/19/2018,80527879,1581.11,4,"Democrat again voice event only she. Half because save anything under either task.
Up section hand. Myself newspaper commercial around these.",12:24:03,UPI
CUHL01704932377151,GB91DITZ74834780737967,4/4/2017,9454.07,100002,Y,Household Consumables,EDGE,PC,Dr,16:49:29,19:34:06,9/19/2018,57227764,1581.11,4,"Certain drive form traditional such. Network somebody recent common song always ago serious.
Experience system trade success eye any. Poor bit very generation.",18:20:58,UPI
CUHL01704932377151,GB91DITZ74834780737967,4/4/2017,11035.18,100002,N,Credited,EDGE,POS,Cr,22:13:14,24:43:38,9/19/2018,40924458,1581.11,4,Indicate enjoy station long spring court different. Another whom carry oil note. Right beautiful service.,23:43:06,UPI
CUHL01704932377151,GB91DITZ74834780737967,4/4/2017,9830.41,100002,Y,Dining,MI,PC,Dr,4:22:41,7:26:38,9/21/2018,48961387,1204.77,3,"Time choice approach travel situation. Politics president specific day. Paper prevent game lose on.
Fear note head once including according.",6:13:44,RTGS
CUHL01704932377151,GB91DITZ74834780737967,4/4/2017,11035.18,100002,N,Credited,EDGE,POS,Cr,11:49:56,14:01:56,9/21/2018,80286943,1204.77,5,"Church travel effort defense decide. Positive past should thought. Whether wonder gun red responsibility finish.
Final tough off development safe.",13:06:25,CARDS
CUHL01704932377151,GB91DITZ74834780737967,4/4/2017,9830.41,100002,Y,Online Shopping,OPERA,POS,Dr,19:14:46,23:58:46,9/21/2018,52251016,1204.77,1,"Story long agree final opportunity guess. Help later although stand them return wait happy.
Day choose front keep.",21:10:44,NEFT
CUHL01704932377151,GB91DITZ74834780737967,4/4/2017,9742.92,100002,Y,Personal Care,EDGE,PC,Dr,6:23:17,10:43:10,9/23/2018,92206472,87.49,2,His compare president onto. Fly election impact represent court next. Ten they sing approach record.,8:29:13,IMPS
CUHL01704932377151,GB91DITZ74834780737967,4/4/2017,9655.43,100002,Y,Personal Care,OPERA,MOBILE,Dr,12:09:07,15:12:25,9/23/2018,25949643,87.49,4,"With certain vote. Within remain people. Cause particularly vote stand mouth.
Cover business nearly good woman. Nice bad close guess cover include.",13:32:32,UPI
CUHL01704932377151,GB91DITZ74834780737967,4/4/2017,9742.92,100002,N,Credited,EDGE,POS,Cr,12:57:45,17:14:02,9/23/2018,8131409,87.49,6,"Third peace myself high share. Cold time structure hot hit to. Feeling get form than moment.
Within happen nothing side. Ago accept city. Enjoy option west election herself office coach.",15:18:36,CHEQUE
CUHL01704932377151,GB91DITZ74834780737967,4/4/2017,9830.41,100002,N,Credited,MI,POS,Cr,19:16:42,22:23:14,9/23/2018,38609275,87.49,3,"Amount she guy main. Car third yourself simple.
Hospital tonight grow simple. Drop listen present walk community natural. Spring ability between stand notice.",20:36:08,RTGS
CUHL01704932377151,GB91DITZ74834780737967,4/4/2017,11546.13,100002,N,Credited,FF,PC,Cr,4:52:09,7:34:41,10/4/2018,93437363,1715.72,5,"Pressure write let. Shoulder into animal production beyond wife executive. Write house different analysis range dark inside.
Bag that adult still expect. Left this laugh son thing so box.",5:56:53,CARDS
CUHL01704932377151,GB91DITZ74834780737967,4/4/2017,9830.41,100002,Y,Personal Care,FF,POS,Dr,10:14:41,13:47:18,10/4/2018,3989753,1715.72,3,Thing career collection easy wind will perhaps. Way third recently out too tend agreement. Contain office senior but glass least bar.,11:59:07,RTGS
CUHL01704932377151,GB91DITZ74834780737967,4/4/2017,8114.69,100002,Y,Dining,SAFARI,POS,Dr,14:29:45,17:04:30,10/4/2018,61677661,1715.72,3,"Writer history dinner out save determine. Investment pick nearly able live.
Including candidate truth tax write hotel.",15:48:58,RTGS
CUHL01704932377151,GB91DITZ74834780737967,4/4/2017,9830.41,100002,N,Credited,OPERA,MOBILE,Cr,15:45:45,17:26:08,10/4/2018,15297242,1715.72,2,"Budget result mention Mrs. Collection test body book toward guy never or.
Before crime season example establish form item. Major way beyond teach shake safe all. Position leave seem animal.",16:53:31,IMPS
CUHL01704932377151,GB91DITZ74834780737967,4/4/2017,11546.13,100002,N,Credited,OPERA,MOBILE,Cr,22:29:03,24:44:10,10/4/2018,28446576,1715.72,1,"Difficult southern land.
Reality person company imagine. Fly behavior the town brother end. Matter state since water beautiful different investment.",23:59:04,NEFT
CUHL01704932377151,GB91DITZ74834780737967,4/4/2017,13288.68,100002,N,Credited,FF,PC,Cr,14:17:45,24:36:51,10/5/2018,19233857,1742.55,5,"Wife PM indicate nice. Son pattern production safe. Myself but sister. Discover check success late.
Debate memory card account college health television past. Management TV hair above.",19:37:49,CARDS
CUHL01704932377151,GB91DITZ74834780737967,4/4/2017,12563.57,100002,Y,Utilities,CHROME,PC,Dr,16:57:59,24:25:05,10/13/2018,40714905,725.11,3,Place deep upon business radio economy half lay. Music finish current stuff record store. This cultural tough director force.,19:32:50,RTGS
CUHL01704932377151,GB91DITZ74834780737967,4/4/2017,13064.81,100002,N,Credited,FF,MOBILE,Cr,4:34:00,6:08:14,10/14/2018,34372692,501.24,6,"Nice under sell. Many single possible building realize.
Ever sense reduce analysis. Stuff seat great fine close support. We report memory figure health.",5:28:42,CHEQUE
CUHL01704932377151,GB91DITZ74834780737967,4/4/2017,12563.57,100002,Y,Rent,OPERA,MOBILE,Dr,7:44:30,10:51:31,10/14/2018,12383962,501.24,3,"Give until care. Time unit program difference.
Sign their food institution. National money less beat necessary. Action music see significant cultural summer.",9:20:48,RTGS
CUHL01704932377151,GB91DITZ74834780737967,4/4/2017,12062.33,100002,Y,Online Shopping,EDGE,PC,Dr,13:59:45,16:22:37,10/14/2018,95674773,501.24,2,Once month pull sense. Make suffer life candidate remember continue mother. Get represent wrong pattern own focus.,15:25:28,IMPS
CUHL01704932377151,GB91DITZ74834780737967,4/4/2017,11561.09,100002,Y,Dining,SAFARI,MOBILE,Dr,18:44:16,20:25:49,10/14/2018,75386894,501.24,1,Even standard stand create again majority. Water movie single get book amount. Issue range analysis raise. Trade pass economy several.,19:30:06,NEFT
CUHL01704932377151,GB91DITZ74834780737967,4/4/2017,11059.85,100002,Y,Household Consumables,IE,MOBILE,Dr,22:27:32,24:20:30,10/14/2018,878982,501.24,6,"Foot theory where beyond trade live agree. Need office manage. Shoulder message often possible son.
Foot billion product compare.",23:12:28,CHEQUE
CUHL01704932377151,GB91DITZ74834780737967,4/4/2017,12503.89,100002,N,Credited,SAFARI,PC,Cr,12:13:55,18:17:23,10/20/2018,76447181,1444.04,6,"Since base various college decision team wide. Ever own data society network news. Kind point hear catch keep Mrs.
On forward dog. Skin available song real.",13:58:01,CHEQUE
CUHL01704932377151,GB91DITZ74834780737967,4/4/2017,11882.34,100002,Y,Medicals,IE,POS,Dr,8:05:01,13:07:07,10/23/2018,38811883,621.55,5,"Pay moment inside professor room time. Appear husband crime you travel position decision.
Girl cause explain southern machine edge. Message pull learn resource.",10:55:25,CARDS
CUHL01704932377151,GB91DITZ74834780737967,4/4/2017,12503.89,100002,N,Credited,MI,POS,Cr,14:19:37,17:41:25,10/23/2018,42874300,621.55,2,"Above special car those service decide. Anyone brother same hold near agreement. Season case write when perhaps.
Involve oil break send. Impact meet expert night have.",16:10:29,IMPS
CUHL01704932377151,GB91DITZ74834780737967,4/4/2017,13125.44,100002,N,Credited,EDGE,MOBILE,Cr,19:57:51,22:49:26,10/23/2018,63526721,621.55,1,"Medical else similar gun week traditional question. Alone here learn open music account.
Drug moment class director add. Their until begin arrive small industry difference.",21:16:05,NEFT
CUHL01704932377151,GB91DITZ74834780737967,4/4/2017,13472.3,100002,N,Credited,IE,POS,Cr,10:09:24,18:57:28,10/27/2018,14899010,346.86,2,"Summer record thought certainly along newspaper leg. Position send discuss impact less road.
Three employee job which decide nearly decade. Doctor at home player nation whatever.",15:56:21,IMPS
CUHL01704932377151,GB91DITZ74834780737967,4/4/2017,13574.77,100002,N,Credited,EDGE,POS,Cr,16:20:17,20:37:51,11/3/2018,2586618,102.47,5,"Same Mr line factor.
Effect music ball certain turn history develop seek. Personal sound decade city hospital rise. Environmental after kid woman start show medical.",18:31:13,CARDS
CUHL01704932377151,GB91DITZ74834780737967,4/4/2017,11997.66,100002,Y,Dining,IE,MOBILE,Dr,10:44:57,15:08:33,11/4/2018,39915986,1577.11,4,"Data democratic concern wish plan western none majority. Drop yes purpose either early interview field.
Here against recognize property service safe quality pressure. Leader participant song.",12:58:25,UPI
CUHL01704932377151,GB91DITZ74834780737967,4/4/2017,13574.77,100002,N,Credited,MI,MOBILE,Cr,18:10:28,24:21:47,11/4/2018,40567433,1577.11,2,"Write new should eye treat business itself.
Suffer now bed under save. Girl everybody away future.",20:36:18,IMPS
CUHL01704932377151,GB91DITZ74834780737967,4/4/2017,11996.81,100002,Y,Entertainment,IE,POS,Dr,7:15:15,10:21:48,11/11/2018,25684834,1577.96,7,"Boy among they. Weight if special site take local message.
Seven responsibility message technology. Difficult light former drop likely. Sport song effect civil theory art big.",9:27:39,DD
CUHL01704932377151,GB91DITZ74834780737967,4/4/2017,13574.77,100002,N,Credited,FF,MOBILE,Cr,13:17:39,15:40:38,11/11/2018,85615144,1577.96,7,"Policy last debate tough represent either toward. Star mean business than rather collection.
Read lay care me. Often opportunity begin idea major.",14:10:56,DD
CUHL01704932377151,GB91DITZ74834780737967,4/4/2017,11996.81,100002,Y,Online Shopping,CHROME,MOBILE,Dr,14:25:32,17:36:34,11/11/2018,43148097,1577.96,4,"Save either political yard take young.
Type all have question loss talk. Away involve measure quality by. Front far response alone.",16:01:30,UPI
CUHL01704932377151,GB91DITZ74834780737967,4/4/2017,10418.85,100002,Y,Household Consumables,MI,POS,Dr,21:35:11,23:35:55,11/11/2018,4075875,1577.96,4,Wind campaign back you piece building. Easy sell food probably ago.,22:15:23,UPI
CUHL01704932377151,GB91DITZ74834780737967,4/4/2017,8923.5,100002,Y,Utilities,CHROME,POS,Dr,4:14:38,5:46:51,11/15/2018,70261271,1495.35,1,Ground along challenge. Option single book issue behind sort. Stuff high choice. Rock thank available later.,4:52:59,NEFT
CUHL01704932377151,GB91DITZ74834780737967,4/4/2017,7428.15,100002,Y,Dining,OPERA,PC,Dr,11:00:50,14:48:58,11/15/2018,52736971,1495.35,4,"Feeling pressure life small me food meet. Pattern especially foot.
Office war choice team room defense. Mission scene believe. Example manage before suggest.",13:13:21,UPI
CUHL01704932377151,GB91DITZ74834780737967,4/4/2017,8923.5,100002,N,Credited,FF,PC,Cr,15:35:11,18:04:16,11/15/2018,88814742,1495.35,4,Finish cause article concern. Read while thought present. Across space around act woman defense civil history.,16:27:42,UPI
CUHL01704932377151,GB91DITZ74834780737967,4/4/2017,7428.15,100002,Y,Household Consumables,IE,MOBILE,Dr,19:27:36,22:48:07,11/15/2018,54739932,1495.35,5,"Agreement coach world easy.
Military resource dark long. Which while unit society provide institution.",20:55:46,CARDS
CUHL01704932377151,GB91DITZ74834780737967,4/4/2017,7992.8,100002,N,Credited,IE,MOBILE,Cr,5:32:23,8:00:21,11/16/2018,68886806,564.65,4,Gun subject peace fund board. Still perhaps question hear sister turn. Economy defense identify inside discuss yourself.,6:40:44,UPI
CUHL01704932377151,GB91DITZ74834780737967,4/4/2017,8557.45,100002,N,Credited,EDGE,POS,Cr,9:13:43,12:10:05,11/16/2018,51928957,564.65,5,Job commercial might time spend yourself. Box thus girl keep occur operation. Film available from.,10:34:57,CARDS
CUHL01704932377151,GB91DITZ74834780737967,4/4/2017,7992.8,100002,Y,Medicals,FF,POS,Dr,14:06:01,17:24:26,11/16/2018,4999614,564.65,3,"Light story require candidate game break. Role cultural student.
Hard detail ten represent effort your interest.",15:54:50,RTGS
CUHL01704932377151,GB91DITZ74834780737967,4/4/2017,7428.15,100002,Y,Personal Care,CHROME,PC,Dr,16:09:19,18:40:28,11/16/2018,84841223,564.65,6,"Reach street officer message. Age officer campaign speech local. Doctor ever attack free.
Ball specific opportunity message. Threat then particular modern first pretty major. Whatever loss kind new.",16:49:52,CHEQUE
CUHL01704932377151,GB91DITZ74834780737967,4/4/2017,7992.8,100002,N,Credited,EDGE,MOBILE,Cr,19:11:29,21:40:07,11/16/2018,33785226,564.65,7,"Everything process network. If window third eye group behind machine.
Certainly author million size. Modern air capital sense cause hand run.",20:02:10,DD
CUHL01704932377151,GB91DITZ74834780737967,4/4/2017,9096.77,100002,N,Credited,CHROME,PC,Cr,7:00:42,10:53:05,11/23/2018,61477889,1103.97,6,"Author several official often space. Several when item she mouth food. Book space rule rock team.
Trouble will draw with rich. Resource full any improve big economic.",9:49:42,CHEQUE
CUHL01704932377151,GB91DITZ74834780737967,4/4/2017,10200.74,100002,N,Credited,OPERA,POS,Cr,11:09:31,16:09:14,11/23/2018,27265161,1103.97,1,"General side hear later. Technology financial enough item support quickly true. Figure compare job majority collection.
Meeting hold state public per. Exist project soon eight paper.",13:36:24,NEFT
CUHL01704932377151,GB91DITZ74834780737967,4/4/2017,11304.71,100002,N,Credited,OPERA,POS,Cr,18:23:45,22:43:08,11/23/2018,7197536,1103.97,6,Base hard daughter consider find next south. Necessary science according cell central group. Among lead admit fill record administration hope.,21:03:29,CHEQUE
CUHL01704932377151,GB91DITZ74834780737967,4/4/2017,12271.28,100002,N,Credited,MI,PC,Cr,18:06:17,28:37:03,11/26/2018,99451523,966.57,1,Note rule tend seek assume. Board surface official soldier medical top role. White especially gun bank young. White international rate responsibility.,22:56:52,NEFT
CUHL01704932377151,GB91DITZ74834780737967,4/4/2017,11869.59,100002,Y,Rent,SAFARI,POS,Dr,8:39:21,10:40:37,12/9/2018,61478244,401.69,4,"Mission take democratic. Especially fire day fish owner involve.
Speak specific leg nor. Late such involve go night forward task partner. Care treatment develop amount fund sport.",10:04:20,UPI
CUHL01704932377151,GB91DITZ74834780737967,4/4/2017,12271.28,100002,N,Credited,OPERA,POS,Cr,15:29:30,19:42:38,12/9/2018,43805624,401.69,2,"Leg information herself wind. Chair body sign give.
Agreement interest machine real here some explain. Body happy all whether small well safe and. Tough because really feeling.",17:17:29,IMPS
CUHL01704932377151,GB91DITZ74834780737967,4/4/2017,11869.59,100002,Y,Household Consumables,SAFARI,MOBILE,Dr,19:03:08,23:27:58,12/9/2018,26203119,401.69,3,"Into agreement beyond its. Test prepare forward power enough.
Cultural left common cell late history. Study likely show second wear message. Rest break from base bag from must view.",21:54:21,RTGS
CUHL01704932377151,GB91DITZ74834780737967,4/4/2017,11488.96,100002,Y,Transportation,EDGE,PC,Dr,7:45:23,17:40:03,12/15/2018,71590233,380.63,1,College resource local. Address meet pretty. Politics wish wall result reduce difference.,12:12:21,NEFT
CUHL01704932377151,GB91DITZ74834780737967,4/4/2017,10377.36,100002,Y,Transportation,SAFARI,PC,Dr,15:13:09,20:43:16,12/20/2018,57347165,1111.6,6,"Yes science sort music. Several past simply seem those recently situation southern. Different offer like garden remain.
Top smile various even could. Test evening event family movie compare after.",18:21:54,CHEQUE
CUHL01704932377151,GB91DITZ74834780737967,4/4/2017,11154.52,100002,N,Credited,IE,MOBILE,Cr,6:28:14,8:33:16,1/2/2019,20651466,777.16,2,"Piece fall later star. Group something help begin to.
Not present decide spring maybe. Section Democrat score build daughter.",7:09:17,IMPS
CUHL01704932377151,GB91DITZ74834780737967,4/4/2017,10377.36,100002,Y,Insurance,SAFARI,MOBILE,Dr,13:29:06,17:16:41,1/2/2019,95170091,777.16,7,"Car woman father product. Member speech TV represent heart. Movie official market staff reveal.
Gas bit Mr indeed parent since crime. Win cost system skill show approach.",14:21:54,DD
CUHL01704932377151,GB91DITZ74834780737967,4/4/2017,9600.2,100002,Y,Medicals,EDGE,POS,Dr,20:15:49,22:31:29,1/2/2019,9903029,777.16,7,"Writer leg office customer society collection.
Try whether clearly little. School perhaps course raise. Word actually green drop. Professional sort condition relationship change value believe.",21:28:52,DD
CUHL01704932377151,GB91DITZ74834780737967,4/4/2017,10825.23,100002,N,Credited,OPERA,PC,Cr,5:48:12,8:02:01,1/22/2019,40269030,1225.03,3,"Never movie day candidate benefit. Camera computer bill back paper health.
Democrat likely face fine hear over. Second scene his.",7:33:47,RTGS
CUHL01704932377151,GB91DITZ74834780737967,4/4/2017,12050.26,100002,N,Credited,OPERA,MOBILE,Cr,10:42:30,12:47:44,1/22/2019,65415757,1225.03,3,Service certainly writer before article almost leader risk. Within industry answer. Close concern manage mind future collection. Control surface citizen sort girl subject hair.,11:50:44,RTGS
CUHL01704932377151,GB91DITZ74834780737967,4/4/2017,13275.29,100002,N,Credited,SAFARI,PC,Cr,10:54:04,14:07:41,1/22/2019,69490163,1225.03,1,Help professor themselves from offer thank. Middle allow base sign quality.,12:28:22,NEFT
CUHL01704932377151,GB91DITZ74834780737967,4/4/2017,12050.26,100002,Y,Household Consumables,CHROME,PC,Dr,15:24:27,17:42:03,1/22/2019,25932102,1225.03,5,Deep tonight contain which bank. Reveal example light fast perhaps call magazine. Spring pull fight forward last fill hard.,16:46:50,CARDS
CUHL01704932377151,GB91DITZ74834780737967,4/4/2017,13275.29,100002,N,Credited,IE,PC,Cr,20:09:27,22:03:58,1/22/2019,30945593,1225.03,3,"Inside year wear identify. Long skin remember.
Suffer face walk really nice instead old system. Article science fast. Improve rest contain air away.",21:20:11,RTGS
CUHL01704932377151,GB91DITZ74834780737967,4/4/2017,14973.58,100002,N,Credited,OPERA,POS,Cr,2:14:49,5:49:46,1/28/2019,43671069,1698.29,6,"Mouth floor politics than list talk only run. Difference plant early prevent expert.
Away church role style. Possible allow save consumer daughter.",4:03:15,CHEQUE
CUHL01704932377151,GB91DITZ74834780737967,4/4/2017,16671.87,100002,N,Credited,FF,POS,Cr,10:57:49,13:04:07,1/28/2019,78736689,1698.29,1,Understand decision professor fear cup. Every box full these write special. Forget customer drive right whom consider rest course. Cultural effect public my medical bring information report.,11:49:12,NEFT
CUHL01704932377151,GB91DITZ74834780737967,4/4/2017,18370.16,100002,N,Credited,OPERA,POS,Cr,12:43:53,15:01:30,1/28/2019,3057995,1698.29,2,Have finally contain program follow indeed. Food local attorney positive at brother full. Military company military bad rest summer situation. Structure group me reduce age recognize.,14:37:15,IMPS
CUHL01704932377151,GB91DITZ74834780737967,4/4/2017,16671.87,100002,Y,Dining,FF,POS,Dr,16:25:18,18:42:07,1/28/2019,26331041,1698.29,3,Candidate military fight bill church very. Opportunity perhaps serve another avoid every. Information position lot specific.,16:59:58,RTGS
CUHL01704932377151,GB91DITZ74834780737967,4/4/2017,18370.16,100002,N,Credited,FF,PC,Cr,20:53:21,23:14:46,1/28/2019,81174409,1698.29,6,Important our fall notice method style. Industry visit would read few miss. Draw practice term cup about property.,22:06:57,CHEQUE
CUHL01704932377151,GB91DITZ74834780737967,4/4/2017,19228.58,100002,N,Credited,OPERA,POS,Cr,5:28:52,8:19:23,2/2/2019,15575180,858.42,3,"Tend challenge mind camera. Window expert sure election piece hotel. Between my hair offer subject.
Color pressure recognize become after. Address course particularly only soon.",6:39:24,RTGS
CUHL01704932377151,GB91DITZ74834780737967,4/4/2017,18370.16,100002,Y,Household Consumables,CHROME,POS,Dr,12:37:21,15:34:57,2/2/2019,13227326,858.42,7,None thing police factor fear up total just. Data simply performance everything. Talk make would who owner despite.,14:45:01,DD
CUHL01704932377151,GB91DITZ74834780737967,4/4/2017,17511.74,100002,Y,Transportation,CHROME,POS,Dr,21:18:52,24:47:13,2/2/2019,58521984,858.42,5,Work method hand mean he out fish possible. Six trial focus doctor society. Degree increase article likely.,22:51:35,CARDS
CUHL01704932377151,GB91DITZ74834780737967,4/4/2017,15809.77,100002,Y,Dining,IE,PC,Dr,4:23:02,6:45:38,2/4/2019,80786030,1701.97,3,Daughter institution pull answer teacher kitchen back. Almost raise manage begin. Something control partner seem issue. Painting available take still.,6:08:14,RTGS
CUHL01704932377151,GB91DITZ74834780737967,4/4/2017,17511.74,100002,N,Credited,EDGE,MOBILE,Cr,9:00:29,11:27:15,2/4/2019,87543476,1701.97,7,"Option end economy debate bag past between. Seat or expect.
Yet sit suddenly in raise.
Exist identify their. War police break level cause.
Subject believe tree per pass give.",10:54:52,DD
CUHL01704932377151,GB91DITZ74834780737967,4/4/2017,19213.71,100002,N,Credited,CHROME,PC,Cr,16:10:34,19:18:53,2/4/2019,29553020,1701.97,7,"Force century accept religious area knowledge cause. State professor cause hit. How science mission say product move east general.
Identify condition raise weight. Knowledge investment safe.",18:07:02,DD
CUHL01704932377151,GB91DITZ74834780737967,4/4/2017,17511.74,100002,Y,Household Consumables,OPERA,POS,Dr,21:38:15,23:51:09,2/4/2019,13920340,1701.97,2,Usually available maintain sing main candidate. Admit suddenly herself trip leg.,22:23:09,IMPS
CUHL01704932377151,GB91DITZ74834780737967,4/4/2017,16175.04,100002,Y,Transportation,MI,POS,Dr,10:32:52,15:21:36,2/24/2019,66507567,1336.7,4,"Bed through organization back. Be group improve war also cup new.
Against best matter rule outside coach hit. Nice western his send play test. Smile professor customer consumer around anyone.",11:46:02,UPI
CUHL01704932377151,GB91DITZ74834780737967,4/4/2017,17511.74,100002,N,Credited,FF,POS,Cr,22:34:52,26:55:22,2/24/2019,82121457,1336.7,7,"Couple marriage begin when address. Time sing only hotel country rich play. Information enjoy democratic voice scientist political team both.
Possible Democrat name use need.",23:34:19,DD
CUHL01704932377151,GB91DITZ74834780737967,4/4/2017,17695.06,100002,N,Credited,SAFARI,MOBILE,Cr,14:09:32,21:57:09,3/3/2019,82843311,183.32,5,"Support wide test run.
Clearly line prepare. Book enjoy region beyond thank employee network worry.",19:38:10,CARDS
CUHL01704932377151,GB91DITZ74834780737967,4/4/2017,15891.39,100002,Y,Transportation,SAFARI,POS,Dr,15:52:25,25:14:48,3/8/2019,25053494,1803.67,7,"Carry then interest poor late something. Him occur outside. Somebody process rest mother.
None every oil hour. Candidate skin game. Throughout break defense single choose professor practice.",19:49:38,DD
CUHL01704932377151,GB91DITZ74834780737967,4/4/2017,17740.11,100002,N,Credited,MI,POS,Cr,4:02:51,5:18:48,3/9/2019,59380900,1848.72,6,"First draw free present will gas. His alone media modern international. Board quality language these her.
Own thus choice teacher send wall best billion. Yard worry girl participant.",4:33:19,CHEQUE
CUHL01704932377151,GB91DITZ74834780737967,4/4/2017,15891.39,100002,Y,Rent,EDGE,PC,Dr,10:25:22,12:58:11,3/9/2019,70814958,1848.72,2,Phone bad protect body. Should decision let often. Worker song bag protect recent Democrat Republican.,11:54:42,IMPS
CUHL01704932377151,GB91DITZ74834780737967,4/4/2017,14042.67,100002,Y,Dining,EDGE,MOBILE,Dr,10:36:24,13:22:42,3/9/2019,10242322,1848.72,4,"Feel stop with someone. Standard director school base attack professor.
Condition garden likely last group letter close. Rather man theory poor.",12:35:10,UPI
CUHL01704932377151,GB91DITZ74834780737967,4/4/2017,15891.39,100002,N,Credited,IE,POS,Cr,14:30:09,17:32:02,3/9/2019,74302970,1848.72,6,"Cover music foot should however actually. Deal various hope kitchen however.
Time follow performance week minute. Final management those fight. Speech life participant.",16:05:25,CHEQUE
CUHL01704932377151,GB91DITZ74834780737967,4/4/2017,17740.11,100002,N,Credited,CHROME,PC,Cr,19:23:39,22:09:14,3/9/2019,36161140,1848.72,6,College network west describe bring improve. Easy set later need. Civil next describe issue.,21:00:49,CHEQUE
CUHL01704932377151,GB91DITZ74834780737967,4/4/2017,15741.31,100002,Y,Medicals,CHROME,POS,Dr,6:10:34,8:47:48,3/24/2019,31357692,1998.8,6,"Building town determine fund term our. Father turn adult score drive anyone.
Receive statement point fire goal. Herself help visit similar policy customer avoid.",7:44:45,CHEQUE
CUHL01704932377151,GB91DITZ74834780737967,4/4/2017,17740.11,100002,N,Credited,CHROME,PC,Cr,9:34:37,15:08:44,3/24/2019,34920046,1998.8,7,"Security feeling number sell.
Not defense prove. Like go attack attention goal sport mention. Natural foreign he Congress final wide herself. Call not strong you current less.",12:17:18,DD
CUHL01704932377151,GB91DITZ74834780737967,4/4/2017,15741.31,100002,Y,Medicals,FF,PC,Dr,19:27:42,24:09:45,3/24/2019,18803938,1998.8,1,"Goal rather now say their of make. Worker door lose though discussion ok why.
Debate safe course adult take far. Political officer I pattern someone nature direction.",21:38:03,NEFT
CUHL01704932377151,GB91DITZ74834780737967,4/4/2017,16329.17,100002,N,Credited,FF,PC,Cr,11:33:54,17:05:24,4/2/2019,13043094,587.86,5,"People across seven. Test couple room class. Probably respond share risk manager sound role.
Single write agent full left central art. Eight exist home computer cover. Community accept wall hard.",14:21:33,CARDS
CUHL01704932377151,GB91DITZ74834780737967,4/4/2017,15741.31,100002,Y,Entertainment,EDGE,MOBILE,Dr,16:14:13,21:01:58,4/2/2019,94076301,587.86,5,"Price summer ahead live unit one. Draw really often news.
Arm accept majority thus oil staff south. Start government news near. Food inside performance suggest easy worker information agency.",18:06:27,CARDS
CUHL01704932377151,GB91DITZ74834780737967,4/4/2017,14944.3,100002,Y,Personal Care,MI,POS,Dr,12:07:26,15:48:56,4/10/2019,67297306,797.01,3,"Again service almost attorney alone. There modern back sense end help why.
They huge manage step. Professional establish either common single. Chance body chair heavy seven several describe or.",14:16:17,RTGS
CUHL01704932377151,GB91DITZ74834780737967,4/4/2017,15372.74,100002,N,Credited,SAFARI,POS,Cr,6:36:51,10:02:17,4/22/2019,44763671,428.44,4,"Toward finish Republican data section matter fall. May region end.
Mouth write mission choice. Hard president road operation.",8:51:45,UPI
CUHL01704932377151,GB91DITZ74834780737967,4/4/2017,14944.3,100002,Y,Groceries,OPERA,POS,Dr,14:14:43,17:38:46,4/22/2019,10846803,428.44,4,"Direction word particular huge bring detail. Eat attorney back marriage area less organization.
Degree guess field fast allow. Real space win after start direction majority.",16:01:37,UPI
CUHL01704932377151,GB91DITZ74834780737967,4/4/2017,13996.82,100002,Y,Utilities,FF,PC,Dr,8:13:46,11:08:57,5/4/2019,80168676,947.48,7,The movie decade officer. Money take everyone specific which develop off. Seven special whatever thought present decision.,9:04:50,DD
CUHL01704932377151,GB91DITZ74834780737967,4/4/2017,14944.3,100002,N,Credited,MI,POS,Cr,8:43:52,12:01:02,5/4/2019,99151614,947.48,5,Population bed my radio meet change strong present. Best financial capital institution sing notice but. Where test policy carry.,10:26:19,CARDS
CUHL01704932377151,GB91DITZ74834780737967,4/4/2017,13996.82,100002,Y,Entertainment,EDGE,MOBILE,Dr,15:22:17,17:53:46,5/4/2019,68774639,947.48,1,Sense beautiful example management fact condition drop. Challenge assume out research father.,16:06:12,NEFT
CUHL01704932377151,GB91DITZ74834780737967,4/4/2017,14944.3,100002,N,Credited,CHROME,POS,Cr,19:48:22,22:20:50,5/4/2019,57089997,947.48,5,Southern partner election mind. Federal still evening director.,21:15:34,CARDS
CUHL01704932377151,GB91DITZ74834780737967,4/4/2017,12981.94,100002,Y,Utilities,OPERA,POS,Dr,6:01:24,9:01:18,5/10/2019,36625031,1962.36,3,"Miss baby care continue particular when. Almost determine authority theory choose. Executive professor fear thus land.
Want decide program play term major.",8:03:06,RTGS
CUHL01704932377151,GB91DITZ74834780737967,4/4/2017,14944.3,100002,N,Credited,MI,POS,Cr,12:31:13,15:22:55,5/10/2019,48238717,1962.36,2,"Want expert share score. See management science image.
Staff radio hold player possible they. Arm example seat here no.",13:35:44,IMPS
CUHL01704932377151,GB91DITZ74834780737967,4/4/2017,16906.66,100002,N,Credited,CHROME,MOBILE,Cr,16:35:04,19:32:59,5/10/2019,98925506,1962.36,4,"Few result role size care that. Girl box tend part their. Area alone pass by this.
Suffer his person any practice health interesting. Free clear per onto adult range. House in race fine.",17:44:51,UPI
CUHL01704932377151,GB91DITZ74834780737967,4/4/2017,18869.02,100002,N,Credited,IE,POS,Cr,18:26:34,20:09:17,5/10/2019,70685367,1962.36,7,"Much over answer paper. Much guess everyone control try speech low recently.
Certain property short clear. Guess no better visit agreement want serve.",19:28:35,DD
CUHL01704932377151,GB91DITZ74834780737967,4/4/2017,17056.53,100002,Y,Household Consumables,MI,PC,Dr,5:24:33,8:35:52,5/23/2019,1915891,1812.49,7,"Provide parent huge man director major.
Interesting together organization young five western shoulder.
Little anything several. Natural field bag during fly kid. Man church above already.",6:23:15,DD
CUHL01704932377151,GB91DITZ74834780737967,4/4/2017,18869.02,100002,N,Credited,FF,MOBILE,Cr,14:55:36,16:18:49,5/23/2019,53774033,1812.49,2,"Thousand kind air.
Onto green gun usually. Hear spring story affect raise play little whose. Expect hear life state explain serious understand. Possible this environment matter southern.",15:40:00,IMPS
CUHL01704932377151,GB91DITZ74834780737967,4/4/2017,17056.53,100002,Y,Rent,MI,POS,Dr,21:30:14,24:27:08,5/23/2019,24322812,1812.49,4,"Ever difficult talk watch.
Dark choose kitchen head set participant. Prove painting type successful today.
Large choose mouth. South that team all.
Cup improve type true catch gas through quickly.",22:20:15,UPI
CUHL01704932377151,GB91DITZ74834780737967,4/4/2017,17979.31,100002,N,Credited,EDGE,MOBILE,Cr,16:42:02,19:39:12,5/24/2019,37311728,922.78,3,May anyone read guy occur into nearly. Event list here explain I. Level president since.,18:10:31,RTGS
CUHL01704932377151,GB91DITZ74834780737967,4/4/2017,19511.55,100002,N,Credited,OPERA,PC,Cr,14:43:04,20:33:09,6/2/2019,563765,1532.24,2,"Organization matter start purpose myself. Blue fear yeah. Day seven deal fill town watch stay will.
Hit control now more. Business quickly nothing claim. Happen language rise test.",19:17:10,IMPS
CUHL01704932377151,GB91DITZ74834780737967,4/4/2017,20658.68,100002,N,Credited,FF,PC,Cr,11:11:16,17:19:20,6/20/2019,33887272,1147.13,2,"Action commercial film particular fill home.
Couple Republican parent under key player room. Best turn plan particularly across.
Field series group skin religious feel. Why law experience position.",14:05:00,IMPS
CUHL01704932377151,GB91DITZ74834780737967,4/4/2017,22276.76,100002,N,Credited,EDGE,POS,Cr,4:08:35,6:20:02,6/27/2019,86872898,1618.08,3,"Hospital technology surface suffer difficult myself soldier. It strategy effort since to daughter national.
The mind stand Congress upon my paper. Major enough around power order.",4:33:54,RTGS
CUHL01704932377151,GB91DITZ74834780737967,4/4/2017,20658.68,100002,Y,Utilities,IE,PC,Dr,9:48:07,12:38:26,6/27/2019,19654911,1618.08,1,Best art third. Region brother site nation why. Democratic majority thing wonder either place. Road nice group phone continue civil.,11:24:45,NEFT
CUHL01704932377151,GB91DITZ74834780737967,4/4/2017,22276.76,100002,N,Credited,EDGE,POS,Cr,13:32:30,17:09:57,6/27/2019,77711984,1618.08,5,"Right business music five himself without front. Appear different true kid include.
Low hit involve improve rate. Key education little change sit. True investment set change catch blue.",15:11:17,CARDS
CUHL01704932377151,GB91DITZ74834780737967,4/4/2017,23894.84,100002,N,Credited,FF,PC,Cr,18:42:59,20:43:33,6/27/2019,81650576,1618.08,7,Data newspaper reason admit least hope. Everything nature church discussion expect scene best.,19:59:15,DD
CUHL01704932377151,GB91DITZ74834780737967,4/4/2017,25512.92,100002,N,Credited,EDGE,POS,Cr,21:28:28,24:08:59,6/27/2019,78780552,1618.08,7,"Form color main here language choose democratic.
As more such tough. Require season sister himself hospital might force. When sit onto official tree instead.",22:57:35,DD
CUHL01704932377151,GB91DITZ74834780737967,4/4/2017,23838.3,100002,Y,Transportation,CHROME,POS,Dr,11:42:37,18:27:21,6/30/2019,22333582,1674.62,1,"May less only be culture radio. Sing according affect TV.
Buy run this born significant tend learn. Message old turn once because life.",15:26:38,NEFT
CUHL01704932377151,GB91DITZ74834780737967,4/4/2017,25512.92,100002,N,Credited,SAFARI,POS,Cr,19:56:31,23:41:38,6/30/2019,45179532,1674.62,1,"That bar along. Thank front girl difference participant discover. Politics sense matter when.
Money teach world remain sing send appear particular. Then many follow.",21:52:53,NEFT
CUHL01704932377151,GB91DITZ74834780737967,4/4/2017,24720.28,100002,Y,Online Shopping,EDGE,MOBILE,Dr,6:36:33,8:43:18,7/3/2019,24650854,792.64,5,Over word surface ok body performance. Perform mind let teach truth different.,7:25:43,CARDS
CUHL01704932377151,GB91DITZ74834780737967,4/4/2017,25512.92,100002,N,Credited,CHROME,MOBILE,Cr,9:02:52,11:51:42,7/3/2019,18218886,792.64,3,"Especially newspaper against them decade hard. Probably of son remain free.
Store approach day perhaps address create. Blood hundred group nice any guy long.
Response young teach edge film.",10:05:59,RTGS
CUHL01704932377151,GB91DITZ74834780737967,4/4/2017,24720.28,100002,Y,Household Consumables,SAFARI,MOBILE,Dr,14:47:16,17:46:22,7/3/2019,55097536,792.64,6,American under almost trouble near. Final center religious short discuss media need. Still offer present beautiful if big all investment.,16:45:02,CHEQUE
CUHL01704932377151,GB91DITZ74834780737967,4/4/2017,23927.64,100002,Y,Rent,CHROME,PC,Dr,20:03:23,22:35:46,7/3/2019,97060567,792.64,3,"Person gun should large almost Congress trial change. State style without prepare card could itself.
Much billion do religious rest property. Hold result give they write discover everybody shake.",20:48:36,RTGS
CUHL01704932377151,GB91DITZ74834780737967,4/4/2017,25923.48,100002,N,Credited,IE,POS,Cr,10:23:25,17:17:22,7/21/2019,5551828,1995.84,6,Good woman rate board wish view. Son similar mother growth while capital maintain who. Material I power blood themselves trip road concern.,14:11:04,CHEQUE
CUHL01704932377151,GB91DITZ74834780737967,4/4/2017,27919.32,100002,N,Credited,MI,MOBILE,Cr,13:54:33,20:31:33,7/21/2019,62437882,1995.84,4,Always rest finally health base avoid relationship. Heavy move fall subject unit plan boy country.,16:34:39,UPI
CUHL01704932377151,GB91DITZ74834780737967,4/4/2017,27828.07,100002,Y,Transportation,MI,POS,Dr,12:09:30,19:02:02,7/23/2019,17675154,91.25,6,Just even once suffer. Hear should toward maintain. Free try go whose.,17:03:58,CHEQUE
CUHL01704932377151,GB91DITZ74834780737967,4/4/2017,29445.92,100002,N,Credited,OPERA,MOBILE,Cr,14:07:54,20:43:56,7/28/2019,49738339,1617.85,1,Member add sister tend learn language. Where civil series. Before little future fast generation have indeed. Pay because check able either quickly adult.,17:24:17,NEFT
CUHL01704932377151,GB91DITZ74834780737967,4/4/2017,28101.59,100002,Y,Entertainment,FF,PC,Dr,10:24:25,18:52:13,8/13/2019,96537527,1344.33,2,"Wall cultural night serious. Business power now item. Instead remember organization remain in force I.
About bring activity television camera side. Main stuff state quickly tough through.",13:24:07,IMPS
CUHL01704932377151,GB91DITZ74834780737967,4/4/2017,28572.74,100002,N,Credited,OPERA,PC,Cr,5:02:56,7:31:05,8/15/2019,84433916,471.15,5,"Never wrong whose moment catch. Young address call specific.
Ask religious may stay those pattern very. Affect newspaper best rich others.
Air necessary what article develop more.",5:46:38,CARDS
CUHL01704932377151,GB91DITZ74834780737967,4/4/2017,28101.59,100002,Y,Utilities,SAFARI,MOBILE,Dr,11:17:06,13:49:20,8/15/2019,94508413,471.15,5,"Why level scene never pretty ago. Begin would else light place rate stage.
Service step difference popular. Account rock relate able.",13:17:54,CARDS
CUHL01704932377151,GB91DITZ74834780737967,4/4/2017,27630.44,100002,Y,Online Shopping,EDGE,PC,Dr,12:16:09,16:43:37,8/15/2019,56048742,471.15,1,Force respond already fish attention. Across its environment doctor.,14:34:10,NEFT
CUHL01704932377151,GB91DITZ74834780737967,4/4/2017,27159.29,100002,Y,Personal Care,CHROME,PC,Dr,20:00:09,22:42:26,8/15/2019,53261168,471.15,5,"Mouth beat someone human police will letter seven. Party case chance window machine hot teach.
Anything poor cup people. At then black small. Wind center two nice.",21:49:50,CARDS
CUHL01704932377151,GB91DITZ74834780737967,4/4/2017,28900.96,100002,N,Credited,EDGE,PC,Cr,5:46:57,10:18:48,8/24/2019,2841717,1741.67,5,"Base box American. Wind writer go subject. Sing general Democrat case agreement tough.
Message cell hospital everything support operation.",8:13:28,CARDS
CUHL01704932377151,GB91DITZ74834780737967,4/4/2017,30642.63,100002,N,Credited,OPERA,MOBILE,Cr,15:42:13,19:11:32,8/24/2019,59234630,1741.67,3,Both question indicate or first charge head. Evening leg you article account once. This yet information week method.,16:33:44,RTGS
CUHL01704932377151,GB91DITZ74834780737967,4/4/2017,29266.86,100002,Y,Household Consumables,EDGE,POS,Dr,6:26:57,8:33:56,8/25/2019,84848499,1375.77,4,"Subject doctor population company. Bill generation suggest. Recently plan alone shake.
Woman these read financial. Full successful marriage human. Serve stay day.",7:43:45,UPI
CUHL01704932377151,GB91DITZ74834780737967,4/4/2017,30642.63,100002,N,Credited,SAFARI,PC,Cr,16:15:24,18:20:24,8/25/2019,96378465,1375.77,6,Because assume note though according. If next hour base hear rise apply. Management weight word hundred wear. Sound stay before station.,17:27:45,CHEQUE
CUHL01704932377151,GB91DITZ74834780737967,4/4/2017,32018.4,100002,N,Credited,EDGE,POS,Cr,18:13:46,21:27:56,8/25/2019,45209628,1375.77,7,Rate hold level marriage. Under special technology senior toward.,19:11:18,DD
CUHL01704932377151,GB91DITZ74834780737967,4/4/2017,30055.21,100002,Y,Utilities,CHROME,PC,Dr,4:12:08,6:22:26,8/27/2019,32948929,1963.19,4,"Of person pay current deep.
Power city ago goal human. Concern course last PM include impact imagine land. Him in our today poor deep red.
Teacher part set. Listen best kitchen talk.",5:19:45,UPI
CUHL01704932377151,GB91DITZ74834780737967,4/4/2017,28092.02,100002,Y,Personal Care,SAFARI,PC,Dr,13:13:26,14:58:12,8/27/2019,4475798,1963.19,4,"Leg night item catch know message. Author music attention attorney national.
Occur important position we. Our soon benefit. Learn peace market fear over.",14:01:40,UPI
CUHL01704932377151,GB91DITZ74834780737967,4/4/2017,26128.83,100002,Y,Personal Care,OPERA,MOBILE,Dr,15:38:31,18:17:44,8/27/2019,10709610,1963.19,4,"Could green heart. Edge leader describe indeed situation degree war trip.
List raise season protect my someone. Today read dog across manager simply. Service act campaign wife.",16:07:32,UPI
CUHL01704932377151,GB91DITZ74834780737967,4/4/2017,24165.64,100002,Y,Insurance,OPERA,POS,Dr,21:49:39,24:33:36,8/27/2019,99746186,1963.19,3,Management just now me method order receive show. Toward set few true tend painting federal. Focus produce wide dream some main.,22:47:11,RTGS
CUHL01704932377151,GB91DITZ74834780737967,4/4/2017,22646.9,100002,Y,Entertainment,FF,MOBILE,Dr,5:18:06,10:18:56,9/9/2019,17187121,1518.74,5,"Mr form admit newspaper tree word thing. Around include season what.
Point her cost with good local. Authority newspaper institution.
Life affect center at entire. Since project develop.",7:59:26,CARDS
CUHL01704932377151,GB91DITZ74834780737967,4/4/2017,24165.64,100002,N,Credited,IE,POS,Cr,13:22:25,16:07:22,9/9/2019,38862533,1518.74,1,Wide turn now then evening catch improve begin. Your explain area reason against floor program. Win prepare financial however culture establish.,15:11:40,NEFT
CUHL01704932377151,GB91DITZ74834780737967,4/4/2017,25684.38,100002,N,Credited,OPERA,POS,Cr,16:19:02,20:54:59,9/9/2019,90833144,1518.74,4,"Down college live. Ask across would view activity chance little chair.
Compare perhaps interest consider Mr source.",18:32:01,UPI
CUHL01704932377151,GB91DITZ74834780737967,4/4/2017,24163.99,100002,Y,Entertainment,FF,MOBILE,Dr,18:07:14,25:05:01,9/25/2019,53505880,1520.39,1,"Government project interview even education. Another mouth event sit name.
Movie public trial president up leader some. Type along air consider culture quality special.",19:51:37,NEFT
CUHL01704932377151,GB91DITZ74834780737967,4/4/2017,24898.05,100002,N,Credited,CHROME,MOBILE,Cr,3:52:57,6:41:39,9/27/2019,2474878,734.06,6,"Various contain position would. Use manager suddenly hope. Open option very loss test stage.
Adult none year every.",5:29:39,CHEQUE
CUHL01704932377151,GB91DITZ74834780737967,4/4/2017,24163.99,100002,Y,Insurance,MI,POS,Dr,8:23:27,11:56:29,9/27/2019,7478468,734.06,4,"Probably free for allow. Arrive that program type threat. Career stock member partner.
Read together himself agree third mind financial. Red cause area.",9:50:57,UPI
CUHL01704932377151,GB91DITZ74834780737967,4/4/2017,24898.05,100002,N,Credited,FF,PC,Cr,15:37:38,18:18:23,9/27/2019,9085886,734.06,6,List mind senior to time red. Seat foot born interesting record material. Brother suggest tonight my movie just debate method.,16:30:23,CHEQUE
CUHL01704932377151,GB91DITZ74834780737967,4/4/2017,25632.11,100002,N,Credited,SAFARI,PC,Cr,18:04:25,22:20:09,9/27/2019,86969505,734.06,3,"Will everyone guess picture them. Company appear a middle single yeah face.
Rich local leader relate newspaper bring open. Enjoy difference top evidence.",20:08:02,RTGS
CUHL01704932377151,GB91DITZ74834780737967,4/4/2017,26605.51,100002,N,Credited,SAFARI,PC,Cr,8:37:49,11:01:54,10/4/2019,97791317,973.4,1,"Measure industry cover reflect. Truth despite music behavior song.
Pretty rich big floor control. Pretty success president those she account trade.",10:15:58,NEFT
CUHL01704932377151,GB91DITZ74834780737967,4/4/2017,27578.91,100002,N,Credited,SAFARI,PC,Cr,14:51:24,18:07:07,10/4/2019,57148090,973.4,5,Receive just military compare behavior age. Expect line effort off. Student fire enjoy those power. Property by operation find drug.,15:53:46,CARDS
CUHL01704932377151,GB91DITZ74834780737967,4/4/2017,26605.51,100002,Y,Groceries,CHROME,PC,Dr,15:37:24,19:42:09,10/4/2019,4984986,973.4,3,Data total under position take tonight. Think each forward future. Write religious everybody why institution ready commercial. Live response this marriage series manager.,18:21:27,RTGS
CUHL01704932377151,GB91DITZ74834780737967,4/4/2017,26810.19,100002,N,Credited,MI,POS,Cr,17:01:57,21:27:24,10/9/2019,7320095,204.68,7,Major stock assume soldier though stop always nothing. Church voice car until above eight dream. Animal current tax federal production door.,20:09:44,DD
CUHL01704932377151,GB91DITZ74834780737967,4/4/2017,27307.67,100002,N,Credited,OPERA,MOBILE,Cr,7:00:31,10:47:17,10/22/2019,97659426,497.48,4,"Rather prove field physical what believe site. Allow hear like certain strategy price.
Responsibility you question rest determine effect specific. Everything support wind.",7:47:59,UPI
CUHL01704932377151,GB91DITZ74834780737967,4/4/2017,27805.15,100002,N,Credited,MI,POS,Cr,13:19:23,17:28:03,10/22/2019,16419544,497.48,1,Soldier century minute serious produce beat must. Region game wrong subject draw note event.,15:32:08,NEFT
CUHL01704932377151,GB91DITZ74834780737967,4/4/2017,27307.67,100002,Y,Online Shopping,CHROME,MOBILE,Dr,16:47:14,21:45:24,10/22/2019,22577146,497.48,4,Give young need speech current budget form. One day live truth strategy beat including. Rule carry tell onto participant.,18:55:57,UPI
CUHL01704932377151,GB91DITZ74834780737967,4/4/2017,26385.06,100002,Y,Entertainment,CHROME,MOBILE,Dr,7:07:34,10:08:43,10/25/2019,76683404,922.61,1,Situation road child decade might few up. Of the glass. Allow reveal responsibility he sit own.,7:51:08,NEFT
CUHL01704932377151,GB91DITZ74834780737967,4/4/2017,27307.67,100002,N,Credited,IE,PC,Cr,14:13:43,19:21:23,10/25/2019,74602018,922.61,3,"He create finally. Manage line peace detail account hope.
Four require claim fill that listen south.
How system whole.",17:08:11,RTGS
CUHL01704932377151,GB91DITZ74834780737967,4/4/2017,26385.06,100002,Y,Online Shopping,SAFARI,POS,Dr,18:05:51,22:05:41,10/25/2019,55130455,922.61,1,Best least exactly pick process girl share. Mr involve training former as. Glass toward deep of recognize argue music.,19:14:12,NEFT
CUHL01704932377151,GB91DITZ74834780737967,4/4/2017,27618.88,100002,N,Credited,MI,MOBILE,Cr,7:41:22,11:50:00,10/28/2019,30528642,1233.82,7,"Run never wish across. Condition no run quickly security. Third option decision nor traditional.
Minute full become affect involve economic Democrat page. Throughout term trade them.",10:16:16,DD
CUHL01704932377151,GB91DITZ74834780737967,4/4/2017,28852.7,100002,N,Credited,FF,PC,Cr,13:40:58,17:14:24,10/28/2019,48815758,1233.82,7,Recently smile service door everything note situation.,15:47:51,DD
CUHL01704932377151,GB91DITZ74834780737967,4/4/2017,30086.52,100002,N,Credited,SAFARI,PC,Cr,22:04:39,26:25:42,10/28/2019,76133343,1233.82,6,"Part actually dog. Network discuss talk cold.
Plan back everybody agreement product first. Me act success certain. Attack home look.",23:46:06,CHEQUE
CUHL01704932377151,GB91DITZ74834780737967,4/4/2017,28932.01,100002,Y,Online Shopping,OPERA,MOBILE,Dr,6:25:51,8:52:22,11/12/2019,40331485,1154.51,1,"Administration bar attorney set concern month. Experience require stay agree but old home.
My position various region.
This green chair want sort.",7:30:13,NEFT
CUHL01704932377151,GB91DITZ74834780737967,4/4/2017,30086.52,100002,N,Credited,FF,POS,Cr,11:29:48,14:45:05,11/12/2019,3133552,1154.51,6,"Even daughter institution true. Foreign there police program.
Rate rich through style husband. Rather action apply act.",13:00:47,CHEQUE
CUHL01704932377151,GB91DITZ74834780737967,4/4/2017,31241.03,100002,N,Credited,MI,POS,Cr,17:41:07,19:56:32,11/12/2019,30707115,1154.51,3,"Social early special. Difference health activity meet bill recognize. Bar describe yard add professor color.
Instead sell cold early.",18:46:10,RTGS
CUHL01704932377151,GB91DITZ74834780737967,4/4/2017,30086.52,100002,Y,Rent,CHROME,MOBILE,Dr,18:38:49,20:58:39,11/12/2019,34992876,1154.51,5,"Far story amount can herself clearly. Choose year mean.
Weight knowledge recognize enter century. Half stock bank woman tell through source.",19:38:39,CARDS
CUHL01704932377151,GB91DITZ74834780737967,4/4/2017,30715.71,100002,N,Credited,CHROME,POS,Cr,13:32:49,18:24:01,11/16/2019,34407165,629.19,5,Information protect water mention improve her. Walk perform accept. Effect friend each half.,15:19:07,CARDS
CUHL01704932377151,GB91DITZ74834780737967,4/4/2017,29523.24,100002,Y,Personal Care,IE,PC,Dr,7:54:49,10:43:25,11/20/2019,35795117,1192.47,1,"Success arm food view traditional head order red. Hope head research style wait. School late sound road amount.
Must population senior. Into music money affect hold western education.",8:56:56,NEFT
CUHL01704932377151,GB91DITZ74834780737967,4/4/2017,28330.77,100002,Y,Utilities,MI,POS,Dr,11:34:59,15:34:37,11/20/2019,15874399,1192.47,7,"Often product pretty smile character. Defense bag drive best Mr. Result federal option man small blood individual.
Series art I behavior star. Must floor least another matter cover risk.",14:03:41,DD
CUHL01704932377151,GB91DITZ74834780737967,4/4/2017,29523.24,100002,N,Credited,FF,MOBILE,Cr,20:26:29,23:14:05,11/20/2019,83506246,1192.47,7,"Technology than wall whole. Society manager direction drug suddenly probably if tonight.
Worker five Mr interesting. Wind example religious simple. Step finish fall else future soon shake join.",22:33:37,DD
CUHL01704932377151,GB91DITZ74834780737967,4/4/2017,28269.86,100002,Y,Groceries,IE,MOBILE,Dr,5:40:50,7:54:47,11/26/2019,15860620,1253.38,1,"Street method since family long. Rather standard still.
Protect play son against who cultural. Power upon deal his require scientist education bring. Through close shake fill think method per.",6:24:32,NEFT
CUHL01704932377151,GB91DITZ74834780737967,4/4/2017,29523.24,100002,N,Credited,MI,POS,Cr,12:35:39,15:05:57,11/26/2019,46817341,1253.38,2,We degree recent plan success kind word. Understand movement north including per sense follow pattern. Product as friend yet rich south nothing government.,13:47:07,IMPS
CUHL01704932377151,GB91DITZ74834780737967,4/4/2017,28269.86,100002,Y,Dining,OPERA,MOBILE,Dr,16:45:13,19:10:24,11/26/2019,61963900,1253.38,2,"Newspaper miss think during send war consumer. Trade traditional story go poor bill. Huge feel detail dog kind bad plant.
Audience material agency realize whatever then.",17:17:07,IMPS
CUHL01704932377151,GB91DITZ74834780737967,4/4/2017,27016.48,100002,Y,Online Shopping,CHROME,PC,Dr,19:11:38,21:57:22,11/26/2019,79347914,1253.38,2,"Threat tonight short so. With effect manager control deep.
Leader avoid realize lead. Somebody office approach follow participant machine.",20:59:00,IMPS
CUHL01704932377151,GB91DITZ74834780737967,4/4/2017,27193.25,100002,N,Credited,EDGE,PC,Cr,5:00:33,7:14:00,12/8/2019,39878083,176.77,4,"Product soldier start tree building.
Read tell very baby discuss bill continue reason. Sure certain open claim serve from field. Traditional figure since whatever federal.",6:16:41,UPI
CUHL01704932377151,GB91DITZ74834780737967,4/4/2017,27016.48,100002,Y,Household Consumables,IE,PC,Dr,14:13:22,16:09:24,12/8/2019,2649450,176.77,4,How open gun town certainly professor. Trip compare skill respond job situation officer. Pass go hit out cold me manage once. Forget detail receive executive you.,15:18:58,UPI
CUHL01704932377151,GB91DITZ74834780737967,4/4/2017,26839.71,100002,Y,Insurance,OPERA,MOBILE,Dr,20:48:41,24:24:58,12/8/2019,15104588,176.77,3,Laugh health get author local city can character. Now fill trouble green surface cold party. Cultural believe everything though.,21:52:24,RTGS
CUHL01704932377151,GB91DITZ74834780737967,4/4/2017,28170.31,100002,N,Credited,CHROME,MOBILE,Cr,10:16:39,12:16:27,12/10/2019,40955353,1330.6,6,Cultural some run past community. Join heavy major anyone. Some suffer discuss letter newspaper wait sing color.,11:10:56,CHEQUE
CUHL01704932377151,GB91DITZ74834780737967,4/4/2017,26839.71,100002,Y,Groceries,FF,POS,Dr,12:36:11,16:37:19,12/10/2019,22722201,1330.6,1,Outside himself huge international song. Right increase door. Short suddenly picture run event performance. Indeed woman inside over.,15:24:35,NEFT
CUHL01704932377151,GB91DITZ74834780737967,4/4/2017,28170.31,100002,N,Credited,EDGE,MOBILE,Cr,20:44:58,25:27:58,12/10/2019,47227408,1330.6,7,"Off political who one manage something. Big happen food suffer avoid order.
Stop piece surface after. Third find attorney. Produce include road poor those course wide value.",23:11:29,DD
CUHL01704932377151,GB91DITZ74834780737967,4/4/2017,28985.84,100002,N,Credited,MI,PC,Cr,5:43:48,8:41:39,12/15/2019,39815729,815.53,3,Laugh film not understand picture film truth. Ask term choice through. Why teach opportunity.,6:45:27,RTGS
CUHL01704932377151,GB91DITZ74834780737967,4/4/2017,28170.31,100002,Y,Rent,EDGE,MOBILE,Dr,9:07:53,11:04:05,12/15/2019,57495842,815.53,7,"Stage structure turn health enjoy.
Note administration condition result actually. Your difference wonder. Image mention add.",9:35:46,DD
CUHL01704932377151,GB91DITZ74834780737967,4/4/2017,27354.78,100002,Y,Groceries,IE,PC,Dr,14:14:09,16:34:20,12/15/2019,72313916,815.53,3,"Join plant child safe none mother class. Performance manager agree will.
Serve eat set. Forget get choice worker. Buy beautiful often address establish nature final.",15:21:23,RTGS
CUHL01704932377151,GB91DITZ74834780737967,4/4/2017,26539.25,100002,Y,Groceries,OPERA,MOBILE,Dr,18:07:32,19:34:07,12/15/2019,65360330,815.53,3,"Officer at protect small paper growth.
Toward design two. Their tonight wall bag concern magazine until. Yeah response president movie contain.",18:58:54,RTGS
CUHL01704932377151,GB91DITZ74834780737967,4/4/2017,25723.72,100002,Y,Utilities,EDGE,POS,Dr,22:15:25,25:22:34,12/15/2019,20467029,815.53,6,Culture season project race. Happy floor boy skin life light pretty set.,23:38:42,CHEQUE
CUHL01704932377151,GB91DITZ74834780737967,4/4/2017,25834.31,100002,N,Credited,FF,PC,Cr,18:41:25,24:40:31,12/19/2019,4287766,110.59,7,"Whatever certainly training lead space against enjoy. Public spring him face pull coach. Step leg here resource.
Inside bank part executive group person. Time model give day.",22:51:53,DD
CUHL01704932377151,GB91DITZ74834780737967,4/4/2017,26096.92,100002,N,Credited,IE,PC,Cr,8:20:50,10:40:34,12/21/2019,90335648,262.61,1,"Take within commercial the per economic maybe. Admit animal say data power see suffer. When special picture sport.
Number machine them lead radio.",10:04:25,NEFT
CUHL01704932377151,GB91DITZ74834780737967,4/4/2017,26359.53,100002,N,Credited,FF,POS,Cr,11:17:38,15:20:09,12/21/2019,82801625,262.61,3,Them property consumer among may public firm. Writer song course ten country effort consider. Admit them family economy.,13:20:13,RTGS
CUHL01704932377151,GB91DITZ74834780737967,4/4/2017,26622.14,100002,N,Credited,IE,MOBILE,Cr,20:38:00,24:26:34,12/21/2019,27296141,262.61,6,"Able knowledge tree market population American. To try push second never.
Accept his size need food.
And lose store available Congress role whose respond. Process head whatever even.",22:22:43,CHEQUE
CUHL01704932377151,GB91DITZ74834780737967,4/4/2017,26541.65,100002,Y,Personal Care,FF,POS,Dr,5:42:16,8:48:08,12/29/2019,56402315,80.49,3,Laugh at help organization president stage. Show measure first unit thank thus. Baby size without how media candidate. Up tree myself girl air director point community.,7:39:33,RTGS
CUHL01704932377151,GB91DITZ74834780737967,4/4/2017,26622.14,100002,N,Credited,FF,PC,Cr,9:43:47,12:37:56,12/29/2019,64941448,80.49,2,Language respond reduce result remember remember improve. Return stay mission ground future. Interesting vote foreign child more. Every modern southern about develop.,12:07:04,IMPS
CUHL01704932377151,GB91DITZ74834780737967,4/4/2017,26541.65,100002,Y,Rent,MI,PC,Dr,14:23:30,16:37:46,12/29/2019,22941732,80.49,6,Believe without especially. Media political sister reveal color plan. Create these last property summer could hold.,15:13:37,CHEQUE
CUHL01704932377151,GB91DITZ74834780737967,4/4/2017,26461.16,100002,Y,Insurance,CHROME,PC,Dr,18:04:42,21:38:39,12/29/2019,59932642,80.49,3,Item situation loss foot rule. Leg business first level series break woman especially. Strategy theory yeah cultural ok.,20:25:13,RTGS
CUHL01704932377151,GB91DITZ74834780737967,4/4/2017,28169.23,100002,N,Credited,FF,MOBILE,Cr,6:56:55,9:42:21,12/30/2019,74610495,1708.07,2,Seem provide collection affect subject left. Natural together day exist manager land factor close. Professional my single market.,7:41:37,IMPS
CUHL01704932377151,GB91DITZ74834780737967,4/4/2017,29877.3,100002,N,Credited,CHROME,MOBILE,Cr,12:48:45,14:32:38,12/30/2019,23665408,1708.07,5,Positive water these. Few mother energy itself western citizen. Through mother record build responsibility send.,13:53:32,CARDS
CUHL01704932377151,GB91DITZ74834780737967,4/4/2017,28169.23,100002,Y,Groceries,FF,POS,Dr,16:41:10,19:52:31,12/30/2019,61448629,1708.07,1,Fish development reality finally place. Land owner collection loss. Management real group wear say crime.,19:00:53,NEFT
CUHL01704932377151,GB91DITZ74834780737967,4/4/2017,29877.3,100002,N,Credited,CHROME,PC,Cr,20:13:58,24:25:05,12/30/2019,57496139,1708.07,1,"Any true small rock college. Provide present all process reach reality. Common though score rise well car better.
Hard source body social information. Reality team cover admit represent site almost.",22:25:18,NEFT
CUHL01704932377151,GB91DITZ74834780737967,4/4/2017,29843.28,100002,Y,Insurance,CHROME,POS,Dr,10:40:55,13:34:59,1/1/2020,99223601,34.02,5,Feel represent week sport health change thought. According these else tree student military role. Family since response long heart whether involve.,11:49:00,CARDS
CUHL01704932377151,GB91DITZ74834780737967,4/4/2017,29809.26,100002,Y,Household Consumables,IE,POS,Dr,15:32:59,19:39:20,1/1/2020,33984315,34.02,5,"Man continue end organization. Section believe work. Get race military Mrs film ball.
Field recent data rise available you baby. Moment box either rule attack meet method.",16:40:01,CARDS
CUHL01704932377151,GB91DITZ74834780737967,4/4/2017,29843.28,100002,N,Credited,IE,MOBILE,Cr,17:27:08,20:35:58,1/1/2020,67070442,34.02,1,Create education likely everything international chance drive. Set particularly my actually reduce pressure many knowledge.,19:58:06,NEFT
CUHL01704932377151,GB91DITZ74834780737967,4/4/2017,27959,100002,Y,Medicals,CHROME,PC,Dr,6:16:25,16:06:12,1/3/2020,42219231,1884.28,5,"Only eight ground process recently over. Once design admit read nature answer act. He point produce.
Meet what meet himself rock. Service position food finish.",12:06:27,CARDS
CUHL01704932377151,GB91DITZ74834780737967,4/4/2017,26985.94,100002,Y,Insurance,OPERA,POS,Dr,4:28:37,7:27:30,1/8/2020,12664801,973.06,4,"Ground time catch place seven east. Include top economic Democrat. Result her series.
Ability summer enough. Student bill cut create manager court.
Make per year section throw happen after.",6:17:05,UPI
CUHL01704932377151,GB91DITZ74834780737967,4/4/2017,26012.88,100002,Y,Online Shopping,MI,MOBILE,Dr,9:43:22,12:14:03,1/8/2020,13586232,973.06,3,"Yeah our hour. Expect population give southern simple eight.
Street person close to little research. Treatment decision pattern go always themselves inside just. Cost himself possible floor specific.",10:34:47,RTGS
CUHL01704932377151,GB91DITZ74834780737967,4/4/2017,26985.94,100002,N,Credited,CHROME,POS,Cr,14:05:09,16:30:13,1/8/2020,18263299,973.06,7,"Allow my woman say name recognize. Institution hair senior that sometimes.
Success me read hard. Heavy central laugh ever miss nature land. When reach that system range.",15:20:23,DD
CUHL01704932377151,GB91DITZ74834780737967,4/4/2017,26012.88,100002,Y,Entertainment,IE,POS,Dr,17:51:53,20:04:06,1/8/2020,76335747,973.06,6,"Only together trial according. Buy fact remain tax carry.
So around how return. Beat one yard product bag.
Officer I language. Give themselves sign direction measure able.",19:04:37,CHEQUE
CUHL01704932377151,GB91DITZ74834780737967,4/4/2017,25039.82,100002,Y,Rent,EDGE,POS,Dr,18:38:37,22:04:12,1/8/2020,91843111,973.06,2,"Several job data risk. Lot including leg financial.
Country control must central production support. Should city indicate blue source.",20:09:46,IMPS
CUHL01704932377151,GB91DITZ74834780737967,4/4/2017,23165.24,100002,Y,Insurance,EDGE,MOBILE,Dr,3:24:34,6:39:45,1/11/2020,39549921,1874.58,6,"Movie wear own myself. Cold level choice property.
New morning these table president. Next include top expect number behavior quality sea.",5:08:28,CHEQUE
CUHL01704932377151,GB91DITZ74834780737967,4/4/2017,25039.82,100002,N,Credited,FF,POS,Cr,11:58:55,14:04:00,1/11/2020,86666213,1874.58,4,Mission force result science. Article evening exist evidence. Bar author add writer.,13:07:13,UPI
CUHL01704932377151,GB91DITZ74834780737967,4/4/2017,26914.4,100002,N,Credited,SAFARI,PC,Cr,13:52:00,16:44:40,1/11/2020,77841131,1874.58,7,"Capital draw economic wish garden similar. Interview follow although bad only I first.
Under bed memory financial give season. Decide police he. Conference wide indicate now past ability there.",15:43:37,DD
CUHL01704932377151,GB91DITZ74834780737967,4/4/2017,25039.82,100002,Y,Groceries,SAFARI,PC,Dr,21:47:50,25:16:56,1/11/2020,77163707,1874.58,4,Bring space perhaps. Specific beat maybe social thought. Operation send Republican federal require government event.,23:51:11,UPI
CUHL01704932377151,GB91DITZ74834780737967,4/4/2017,23106.94,100002,Y,Dining,IE,PC,Dr,5:16:12,9:06:00,1/15/2020,34291603,1932.88,2,"Scene kid second feeling family alone. Spend economic police argue. South key inside church. Rich pattern smile move.
Talk marriage must.",8:05:39,IMPS
CUHL01704932377151,GB91DITZ74834780737967,4/4/2017,25039.82,100002,N,Credited,EDGE,MOBILE,Cr,16:18:46,20:02:26,1/15/2020,50400959,1932.88,3,"Environment recently result personal imagine. Paper federal Republican eight world.
Player sort line medical herself turn. Know weight may wear car budget affect.",17:40:25,RTGS
CUHL01704932377151,GB91DITZ74834780737967,4/4/2017,26972.7,100002,N,Credited,OPERA,MOBILE,Cr,20:16:09,23:04:36,1/15/2020,41053621,1932.88,5,"Painting weight future. Field page hot put actually action.
Try foot truth decide southern only pattern.
Deep case personal name receive.",22:00:28,CARDS
CUHL01704932377151,GB91DITZ74834780737967,4/4/2017,27932.62,100002,N,Credited,IE,PC,Cr,13:25:52,20:22:14,1/30/2020,43636419,959.92,7,"Identify poor scientist top. Success line pass green enjoy worry.
Unit nor task start tonight school second. I discover speech thought response Mrs garden away.",16:47:57,DD
CUHL01704932377151,GB91DITZ74834780737967,4/4/2017,29904.8,100002,N,Credited,SAFARI,PC,Cr,18:56:40,24:55:19,2/5/2020,47877894,1972.18,5,"Focus serve responsibility participant.
Energy perform rich system play he. Notice drive two son matter must realize.",22:05:18,CARDS
CUHL01704932377151,GB91DITZ74834780737967,4/4/2017,28567.25,100002,Y,Insurance,SAFARI,POS,Dr,8:07:12,12:53:49,2/12/2020,31583626,1337.55,6,Brother fight call someone development style book. Most whatever officer me everyone east cup.,9:55:12,CHEQUE
CUHL01704932377151,GB91DITZ74834780737967,4/4/2017,29904.8,100002,N,Credited,SAFARI,POS,Cr,13:44:22,18:29:48,2/12/2020,53678867,1337.55,4,"Fight determine best than. Itself stay another morning mean million west.
Nor deal energy government. Mother somebody new power point.",16:25:41,UPI
CUHL01704932377151,GB91DITZ74834780737967,4/4/2017,28567.25,100002,Y,Online Shopping,EDGE,MOBILE,Dr,19:38:19,21:07:20,2/12/2020,99463366,1337.55,2,Begin energy network claim between. Newspaper time that kind thing strong rich mind. Interesting surface person social. Start resource board foot government stage.,20:16:27,IMPS
CUHL01704932377151,GB91DITZ74834780737967,4/4/2017,28905.1,100002,N,Credited,OPERA,PC,Cr,8:58:35,14:36:55,2/25/2020,3660027,337.85,2,"Moment radio series finish floor. Rate interesting around democratic stop commercial. Tell stop drop follow most.
Himself size about spend. Environmental police boy economic.",12:20:05,IMPS
CUHL01704932377151,GB91DITZ74834780737967,4/4/2017,28567.25,100002,Y,Personal Care,SAFARI,MOBILE,Dr,19:27:52,24:38:07,2/25/2020,66732556,337.85,4,Claim course thing range everything sit kind. Discover summer edge per us. Tree building fly special herself citizen now however.,21:49:20,UPI
CUHL01704932377151,GB91DITZ74834780737967,4/4/2017,27733.24,100002,Y,Household Consumables,MI,PC,Dr,7:37:00,12:02:48,3/1/2020,27268322,834.01,5,"Late radio life mission finally month. Imagine area never per seem management strategy. Degree stock tax up.
Effect start third phone compare. Actually through free where.",10:33:31,CARDS
CUHL01704932377151,GB91DITZ74834780737967,4/4/2017,26899.23,100002,Y,Dining,SAFARI,PC,Dr,14:06:42,17:54:51,3/1/2020,81345106,834.01,1,"Policy business president. Health be person own try. Nearly dream large. South education Congress.
Talk benefit rock own relationship. Case development seven pull law know me.",17:04:04,NEFT
CUHL01704932377151,GB91DITZ74834780737967,4/4/2017,27733.24,100002,N,Credited,OPERA,MOBILE,Cr,21:02:07,24:32:43,3/1/2020,83795893,834.01,4,"Which sign top yard debate choose also. Goal writer wait board entire everyone quite. Hour respond far election cost.
Standard someone rest system evening air. Next early lawyer through bit true try.",23:15:30,UPI
CUHL01704932377151,GB91DITZ74834780737967,4/4/2017,26984.14,100002,Y,Personal Care,CHROME,MOBILE,Dr,8:38:36,14:56:48,3/2/2020,9479142,749.1,3,From forward car population late win word. Per process run anyone theory future. Often serve matter board kid radio general.,11:45:53,RTGS
CUHL01704932377151,GB91DITZ74834780737967,4/4/2017,27733.24,100002,N,Credited,MI,MOBILE,Cr,14:28:18,18:57:08,3/2/2020,51736606,749.1,6,"Computer structure nature. Tend person stock red. Pattern still city think look day even.
Myself lay main street card magazine develop. Leader candidate whom common miss easy hold.",17:52:47,CHEQUE
CUHL01704932377151,GB91DITZ74834780737967,4/4/2017,27963.42,100002,N,Credited,OPERA,POS,Cr,9:47:56,13:37:28,3/6/2020,31726856,230.18,4,"Child senior although tell. Third specific either third continue.
Establish wear reality have require. Response behind particularly tax music player resource. Particular prevent open hair time.",10:48:25,UPI
CUHL01704932377151,GB91DITZ74834780737967,4/4/2017,27733.24,100002,Y,Medicals,SAFARI,PC,Dr,14:32:02,17:55:10,3/6/2020,39474056,230.18,6,"Herself rule book ground after. Floor reality risk remain. Art face skill make court.
Present recognize include between hospital region. Attorney voice everybody budget.",16:00:19,CHEQUE
CUHL01704932377151,GB91DITZ74834780737967,4/4/2017,27993.08,100002,N,Credited,OPERA,POS,Cr,4:05:06,6:58:55,3/9/2020,72057247,259.84,2,"Certain direction oil none line about ball. Product film surface clear expect line.
Collection produce personal how record nothing. Door inside least manager.",5:16:32,IMPS
CUHL01704932377151,GB91DITZ74834780737967,4/4/2017,28252.92,100002,N,Credited,OPERA,MOBILE,Cr,9:33:14,10:49:10,3/9/2020,20586126,259.84,4,"Box those out response writer southern. Rich product right true discussion.
Bill real bring might. Animal only purpose save worker statement. Animal his effect unit.",10:02:28,UPI
CUHL01704932377151,GB91DITZ74834780737967,4/4/2017,27993.08,100002,Y,Dining,EDGE,POS,Dr,13:02:25,14:35:49,3/9/2020,27498279,259.84,1,Remain near part safe. Partner on structure camera event job in.,13:59:24,NEFT
CUHL01704932377151,GB91DITZ74834780737967,4/4/2017,27733.24,100002,Y,Utilities,MI,POS,Dr,17:53:57,20:00:02,3/9/2020,71279206,259.84,3,"View stop remain hear already writer. Position a small or large training.
Buy month middle. Tend name between.",18:22:37,RTGS
CUHL01704932377151,GB91DITZ74834780737967,4/4/2017,27473.4,100002,Y,Household Consumables,EDGE,PC,Dr,20:36:45,22:27:55,3/9/2020,25886849,259.84,3,"Require happy agree agreement kitchen. Various president organization site performance all.
Expect daughter only available reflect. Increase almost rise about Democrat attack.",21:03:36,RTGS
CUHL01704932377151,GB91DITZ74834780737967,4/4/2017,25479.12,100002,Y,Groceries,EDGE,MOBILE,Dr,5:20:24,8:29:05,4/8/2020,44891817,1994.28,7,Yes song protect capital defense. Project gun likely thus office. Stage certainly sea newspaper remain next reality.,7:29:37,DD
CUHL01704932377151,GB91DITZ74834780737967,4/4/2017,27473.4,100002,N,Credited,FF,PC,Cr,9:20:32,13:02:06,4/8/2020,94191301,1994.28,1,Lay case attack firm thought common carry. Decade behind east everybody message food. Suggest threat knowledge open.,10:53:41,NEFT
CUHL01704932377151,GB91DITZ74834780737967,4/4/2017,25479.12,100002,Y,Insurance,EDGE,MOBILE,Dr,13:39:27,16:01:38,4/8/2020,18230864,1994.28,6,"Education arm beat bank follow seem value. Key industry soldier southern.
Front central health capital PM. Try lawyer black. Fight stop hundred common partner.",15:22:53,CHEQUE
CUHL01704932377151,GB91DITZ74834780737967,4/4/2017,23484.84,100002,Y,Utilities,OPERA,MOBILE,Dr,17:30:25,20:12:26,4/8/2020,4303350,1994.28,1,"Organization on identify another herself firm. Site night suffer. Sense subject movement agency clear help.
Help election moment job. Receive politics position several half.",19:21:56,NEFT
CUHL01704932377151,GB91DITZ74834780737967,4/4/2017,24040.51,100002,N,Credited,EDGE,POS,Cr,6:31:42,9:26:32,4/15/2020,32540840,555.67,1,"Within small always end truth.
Local nice skill least result none hold. Act prepare keep position.
Season she call teacher. Job affect one focus.",7:26:17,NEFT
CUHL01704932377151,GB91DITZ74834780737967,4/4/2017,23484.84,100002,Y,Dining,MI,POS,Dr,13:31:50,16:01:13,4/15/2020,15428233,555.67,5,Type size lay because leader career main. Morning nature eat wonder cut.,15:01:56,CARDS
CUHL01704932377151,GB91DITZ74834780737967,4/4/2017,22929.17,100002,Y,Online Shopping,IE,MOBILE,Dr,18:46:01,23:29:44,4/15/2020,17393089,555.67,4,Raise send friend want also street community it. Summer record floor east month drug. Former without ahead onto indicate industry manage beautiful.,21:32:34,UPI
CUHL01704932377151,GB91DITZ74834780737967,4/4/2017,23460.83,100002,N,Credited,IE,MOBILE,Cr,6:23:56,9:26:46,4/19/2020,91850621,531.66,4,"Ago institution doctor. Hospital claim name.
Allow turn every consider. Call hold stuff cover tough lot it. Operation call travel health force carry behavior.",7:16:59,UPI
CUHL01704932377151,GB91DITZ74834780737967,4/4/2017,23992.49,100002,N,Credited,FF,PC,Cr,9:28:20,13:03:19,4/19/2020,50986729,531.66,1,"Recently prove these visit drop public. Building game international prevent true no material. Tell able for address my.
Join work serve expert now six start over. Family once company baby.",11:19:29,NEFT
CUHL01704932377151,GB91DITZ74834780737967,4/4/2017,24524.15,100002,N,Credited,FF,MOBILE,Cr,18:26:27,20:09:24,4/19/2020,37518622,531.66,1,"Wind degree while population require hear north. Investment grow remain.
Public good write. Trade range yes alone.
Production word position head however lose more. Ready fine car force activity.",18:59:38,NEFT
CUHL01704932377151,GB91DITZ74834780737967,4/4/2017,25055.81,100002,N,Credited,SAFARI,MOBILE,Cr,18:06:27,21:13:14,4/19/2020,74142910,531.66,3,"National camera common democratic.
Floor individual later shoulder need impact show international. Work parent surface shake go black.",20:19:18,RTGS
CUHL01704932377151,GB91DITZ74834780737967,4/4/2017,25968.2,100002,N,Credited,CHROME,PC,Cr,3:54:33,7:04:12,4/22/2020,4914860,912.39,2,"Can life he market police really indicate. Try tax yeah various institution place.
Audience shake religious. Ago represent grow challenge.",5:16:16,IMPS
CUHL01704932377151,GB91DITZ74834780737967,4/4/2017,26880.59,100002,N,Credited,FF,POS,Cr,8:39:37,12:38:30,4/22/2020,70225754,912.39,5,Popular policy relationship sure represent blood where. Lay condition once play less ready try occur. Simple like west pressure first responsibility.,10:44:48,CARDS
CUHL01704932377151,GB91DITZ74834780737967,4/4/2017,27792.98,100002,N,Credited,CHROME,POS,Cr,16:40:29,18:59:32,4/22/2020,39289391,912.39,2,"Choose plant girl two heavy song save. Different design political radio service.
Me nice sell former only level will. Why plan stage whatever.",17:40:01,IMPS
CUHL01704932377151,GB91DITZ74834780737967,4/4/2017,28705.37,100002,N,Credited,SAFARI,PC,Cr,20:50:08,23:00:59,4/22/2020,37816339,912.39,7,Sit popular them range student seek. Beyond outside management grow among field.,21:59:50,DD
CUHL01704932377151,GB91DITZ74834780737967,4/4/2017,27411.4,100002,Y,Entertainment,OPERA,MOBILE,Dr,6:53:09,8:30:43,4/23/2020,26603445,1293.97,1,"Mrs despite run imagine. Picture myself his personal different. Minute fast plant base.
Note base outside keep lay. Task recent family scientist father determine.",7:42:24,NEFT
CUHL01704932377151,GB91DITZ74834780737967,4/4/2017,26117.43,100002,Y,Groceries,MI,PC,Dr,10:50:05,13:03:55,4/23/2020,33717470,1293.97,1,"Daughter green may record most conference. Market skill best firm rule. Wall might film better give bring every.
Mrs stand season provide any suffer. Miss prove tonight.",11:34:12,NEFT
CUHL01704932377151,GB91DITZ74834780737967,4/4/2017,24823.46,100002,Y,Rent,FF,POS,Dr,12:45:11,15:09:51,4/23/2020,28858942,1293.97,5,"Court current though source. Century system professional per again make.
Crime information subject lay Republican. Figure class able simple couple radio join. Eat line notice strong instead address.",13:20:32,CARDS
CUHL01704932377151,GB91DITZ74834780737967,4/4/2017,26117.43,100002,N,Credited,IE,PC,Cr,16:27:59,19:05:18,4/23/2020,57938318,1293.97,7,"Suggest already including wall. Investment figure miss contain image medical each.
Ball much top common. Case surface reduce continue smile around garden.",17:58:35,DD
CUHL01704932377151,GB91DITZ74834780737967,4/4/2017,27411.4,100002,N,Credited,IE,POS,Cr,22:35:11,25:42:05,4/23/2020,53476067,1293.97,3,"Change task scientist garden back. Long foreign develop training benefit.
Congress join need attack just. Region stand charge test own military. Chance attention cold give.",23:57:32,RTGS
CUHL01704932377151,GB91DITZ74834780737967,4/4/2017,29006.24,100002,N,Credited,CHROME,MOBILE,Cr,5:09:26,8:50:21,4/27/2020,59582328,1594.84,2,Scientist any visit before career born nature. Card man newspaper call live Republican. Affect mean high partner house book.,6:59:06,IMPS
CUHL01704932377151,GB91DITZ74834780737967,4/4/2017,30601.08,100002,N,Credited,EDGE,POS,Cr,10:59:01,13:50:25,4/27/2020,39036254,1594.84,6,Church civil laugh instead ground when oil matter. Partner property least party general heavy three seven.,12:49:56,CHEQUE
CUHL01704932377151,GB91DITZ74834780737967,4/4/2017,32195.92,100002,N,Credited,CHROME,PC,Cr,21:12:43,24:17:05,4/27/2020,4100386,1594.84,7,Make game fine town. Drive network election throw form garden. Line yeah effect address trial.,21:56:47,DD
CUHL01704932377151,GB91DITZ74834780737967,4/4/2017,33524.59,100002,N,Credited,EDGE,MOBILE,Cr,19:56:59,23:56:34,4/29/2020,33204031,1328.67,4,"Ready body stock stop. Leave production affect prove.
Mention senior leg air culture thing. Something fund visit modern adult size risk. No help similar summer begin. Fine voice save.",22:07:33,UPI
CUHL01704932377151,GB91DITZ74834780737967,4/4/2017,35166.41,100002,N,Credited,CHROME,PC,Cr,6:19:09,8:18:17,5/3/2020,78369474,1641.82,3,Person modern design modern network head. Senior low single animal standard. Space argue chair dog whatever father old however.,6:59:44,RTGS
CUHL01704932377151,GB91DITZ74834780737967,4/4/2017,36808.23,100002,N,Credited,SAFARI,MOBILE,Cr,10:30:30,13:12:13,5/3/2020,15993113,1641.82,2,"Series parent direction positive. Knowledge state prove age size measure fish hear. When company act head world.
Court truth affect whom.",11:51:41,IMPS
CUHL01704932377151,GB91DITZ74834780737967,4/4/2017,35166.41,100002,Y,Transportation,FF,MOBILE,Dr,14:16:00,17:32:31,5/3/2020,31172158,1641.82,7,"Peace pretty oil. Short about particularly seek check attorney. South world maintain affect role majority.
He fund consider father. Firm garden clear civil officer work. Term network more talk ask.",15:41:59,DD
CUHL01704932377151,GB91DITZ74834780737967,4/4/2017,36808.23,100002,N,Credited,SAFARI,PC,Cr,16:03:31,18:13:56,5/3/2020,75911119,1641.82,4,"Interview air law poor. Send education natural memory only.
Purpose meeting blue ask this we. Establish often answer after. Group order toward collection.",17:13:42,UPI
CUHL01704932377151,GB91DITZ74834780737967,4/4/2017,38450.05,100002,N,Credited,IE,MOBILE,Cr,19:38:44,21:22:49,5/3/2020,55744485,1641.82,1,General story style foreign. Thus miss agree development business.,20:17:39,NEFT
CUHL01704932377151,GB91DITZ74834780737967,4/4/2017,37010.6,100002,Y,Entertainment,MI,POS,Dr,4:24:10,5:57:17,5/16/2020,52126901,1439.45,4,"Car blue report too population. Newspaper hour style science consumer.
Door know available career natural series state glass. Firm month plant prepare. Win citizen father sell admit cold reach.",5:17:55,UPI
CUHL01704932377151,GB91DITZ74834780737967,4/4/2017,38450.05,100002,N,Credited,SAFARI,PC,Cr,9:36:28,12:40:56,5/16/2020,99518936,1439.45,3,"Defense answer month conference and art threat. Audience consumer amount hear.
Plan off purpose past. Receive audience for goal else team receive practice.",11:49:53,RTGS
CUHL01704932377151,GB91DITZ74834780737967,4/4/2017,39889.5,100002,N,Credited,CHROME,PC,Cr,14:30:49,17:58:34,5/16/2020,91200716,1439.45,3,"Keep hard drop cup turn. Education do move business such letter. Yet economy smile improve.
Myself goal new. Report nice suffer cause stay. Company also put can.",15:59:06,RTGS
CUHL01704932377151,GB91DITZ74834780737967,4/4/2017,38450.05,100002,Y,Rent,EDGE,MOBILE,Dr,22:00:59,25:36:26,5/16/2020,73069652,1439.45,5,"Detail it race minute knowledge knowledge level carry. Year beyond several suffer.
Impact nor pattern mother. Gas exactly easy factor student again.",23:22:18,CARDS
CUHL01704932377151,GB91DITZ74834780737967,4/4/2017,37260.23,100002,Y,Rent,OPERA,POS,Dr,3:17:32,6:20:32,5/24/2020,8143815,1189.82,6,"Road generation ten require.
Member no century sure know official then night. Catch along career.",4:40:05,CHEQUE
CUHL01704932377151,GB91DITZ74834780737967,4/4/2017,36070.41,100002,Y,Medicals,MI,PC,Dr,7:45:28,10:38:44,5/24/2020,75927615,1189.82,7,"Decide forget question new stay every. Raise day whose identify paper simple future.
Suffer role brother issue for two. Business crime main finish accept center take take.",9:08:31,DD
CUHL01704932377151,GB91DITZ74834780737967,4/4/2017,34880.59,100002,Y,Insurance,IE,MOBILE,Dr,13:02:52,14:57:44,5/24/2020,13214456,1189.82,4,"Conference agreement employee grow you list. Throw imagine while customer.
Meet always about. Piece trade fact leave.
Because this moment prevent though. Vote police respond so.",14:32:08,UPI
CUHL01704932377151,GB91DITZ74834780737967,4/4/2017,36070.41,100002,N,Credited,FF,MOBILE,Cr,17:18:41,19:19:36,5/24/2020,51601065,1189.82,2,"Feeling stage happen answer cold section safe. Animal machine fill could wife beautiful. Understand both deal how. Wear power statement wear ago.
Eight cultural understand.",18:31:11,IMPS
CUHL01704932377151,GB91DITZ74834780737967,4/4/2017,37260.23,100002,N,Credited,IE,PC,Cr,21:51:14,24:56:53,5/24/2020,97532309,1189.82,4,"Close issue board here idea. World no would take. His decide between effect late art.
Then reduce subject. Without rest behavior myself ready him.
Position crime before rate magazine thousand.",23:21:22,UPI
CUHL01704932377151,GB91DITZ74834780737967,4/4/2017,37685.79,100002,N,Credited,IE,POS,Cr,10:25:54,16:50:37,5/26/2020,90974830,425.56,5,Dream article important enjoy. Store world car player. Network present audience once. Couple water health player animal clear.,13:34:26,CARDS
CUHL01704932377151,GB91DITZ74834780737967,4/4/2017,37260.23,100002,Y,Entertainment,MI,POS,Dr,15:25:00,21:11:21,5/26/2020,16582132,425.56,3,"Inside those choice. Number stage on cost hope white. Officer second way.
Site member Congress ground decade simple word from. Address front hand shoulder sea door test.",18:18:11,RTGS
CUHL01704932377151,GB91DITZ74834780737967,4/4/2017,35929.8,100002,Y,Personal Care,OPERA,POS,Dr,6:42:09,10:47:13,5/28/2020,92294219,1330.43,6,"Culture I outside artist hair. My put local measure food I.
Let relate main month effort feeling. Federal artist you for knowledge.
Movie difference trial allow character. Feeling interest ahead off.",8:55:50,CHEQUE
CUHL01704932377151,GB91DITZ74834780737967,4/4/2017,37260.23,100002,N,Credited,CHROME,POS,Cr,8:48:53,10:56:07,5/28/2020,16820005,1330.43,7,"Its visit skill join music. Computer student politics next.
Commercial environment make fly threat yet bar. Under tonight special reach. Congress crime work should.",9:39:46,DD
CUHL01704932377151,GB91DITZ74834780737967,4/4/2017,35929.8,100002,Y,Online Shopping,FF,PC,Dr,14:49:48,18:28:53,5/28/2020,68793883,1330.43,3,"Ever pass according focus guy. Shake everyone speak strategy example arrive. Center threat them everybody.
Herself production break life listen.",16:36:26,RTGS
CUHL01704932377151,GB91DITZ74834780737967,4/4/2017,34599.37,100002,Y,Insurance,SAFARI,MOBILE,Dr,22:26:00,24:21:02,5/28/2020,2207025,1330.43,3,Wife leg young eat mind experience particular. Level finish cup like likely.,23:36:23,RTGS
CUHL01704932377151,GB91DITZ74834780737967,4/4/2017,33577.02,100002,Y,Entertainment,MI,PC,Dr,8:08:45,10:53:27,5/30/2020,8448972,1022.35,7,Article car message camera. Easy build energy every southern husband reduce. A floor perform certainly recognize special over.,9:40:56,DD
CUHL01704932377151,GB91DITZ74834780737967,4/4/2017,34599.37,100002,N,Credited,FF,MOBILE,Cr,12:34:32,15:54:00,5/30/2020,18196931,1022.35,5,"Anyone ask alone affect friend toward. Role choice political summer.
Several everything citizen class we common pass. Respond despite property on weight.",14:15:20,CARDS
CUHL01704932377151,GB91DITZ74834780737967,4/4/2017,35621.72,100002,N,Credited,EDGE,PC,Cr,17:33:46,21:17:27,5/30/2020,86137270,1022.35,2,"Tree Democrat small too contain another within. Mind part writer area.
Although loss support. Answer guy modern order get.",18:55:13,IMPS
CUHL01704932377151,GB91DITZ74834780737967,4/4/2017,37435.57,100002,N,Credited,OPERA,POS,Cr,7:36:41,11:56:07,6/1/2020,28980056,1813.85,2,"Plan marriage policy newspaper technology fear likely. Boy short able religious.
Easy might hour price truth. Onto relate tough child. Popular per yard.",10:52:28,IMPS
CUHL01704932377151,GB91DITZ74834780737967,4/4/2017,35621.72,100002,Y,Groceries,OPERA,POS,Dr,14:55:54,19:50:49,6/1/2020,50568574,1813.85,1,Hold bar table policy heart recently follow. Organization often talk later difference. Study lay form.,17:41:47,NEFT
CUHL01704932377151,GB91DITZ74834780737967,4/4/2017,35355.13,100002,Y,Online Shopping,MI,POS,Dr,11:45:03,15:25:24,6/8/2020,49443271,266.59,7,"Artist specific direction full include him. Marriage push into onto agree close board.
Behind drive foreign study. Attorney help actually start probably. Kind reality education able write arrive.",13:34:29,DD
CUHL01704932377151,GB91DITZ74834780737967,4/4/2017,35621.72,100002,N,Credited,CHROME,MOBILE,Cr,20:15:17,25:11:58,6/8/2020,47241107,266.59,1,"Respond reach explain fear choose see feel.
Suddenly democratic world bring loss base government wish. Full nothing son pretty field book. Enter away true next eat.",21:39:11,NEFT
CUHL01704932377151,GB91DITZ74834780737967,4/4/2017,35755.67,100002,N,Credited,CHROME,POS,Cr,3:47:12,5:32:10,6/11/2020,46182319,133.95,2,"Right push economy require. Success plant short sort. Staff treat official work today.
Trip similar themselves sort hard help.",4:44:28,IMPS
CUHL01704932377151,GB91DITZ74834780737967,4/4/2017,35621.72,100002,Y,Online Shopping,MI,POS,Dr,7:31:52,10:54:31,6/11/2020,86487603,133.95,6,Work thousand opportunity inside scientist notice word it. Him half apply tend other doctor job. Yet film major likely. War exist challenge inside.,9:02:33,CHEQUE
CUHL01704932377151,GB91DITZ74834780737967,4/4/2017,35487.77,100002,Y,Utilities,FF,POS,Dr,12:55:22,15:53:10,6/11/2020,50252145,133.95,2,Contain choice sometimes institution through. Example both raise doctor. Daughter member relationship seat. Trade long reflect moment score style.,14:20:20,IMPS
CUHL01704932377151,GB91DITZ74834780737967,4/4/2017,35353.82,100002,Y,Transportation,IE,MOBILE,Dr,15:41:18,18:01:47,6/11/2020,86555487,133.95,1,"Few face change any quickly history. Age ago no base public. Social may foot else anything want. Success nation drive chance give give my.
While glass remember hope city seek.",16:20:05,NEFT
CUHL01704932377151,GB91DITZ74834780737967,4/4/2017,35219.87,100002,Y,Rent,EDGE,MOBILE,Dr,23:10:35,25:50:21,6/11/2020,32426120,133.95,2,Of end spring last child wish understand. Prove actually live especially hundred thousand.,23:55:09,IMPS
CUHL01704932377151,GB91DITZ74834780737967,4/4/2017,35421.05,100002,N,Credited,SAFARI,PC,Cr,9:09:45,11:55:21,6/19/2020,59536666,201.18,7,"City tax party heart maybe. Risk what him training.
Huge mind close wish. Beyond everyone fall already.",10:33:46,DD
CUHL01704932377151,GB91DITZ74834780737967,4/4/2017,35219.87,100002,Y,Online Shopping,SAFARI,PC,Dr,13:35:15,21:19:23,6/19/2020,48187022,201.18,6,"Whether summer director agency election. Professor debate phone lay. Trade development improve natural door.
Gun truth daughter bar when peace different. Ground artist station what baby not never.",17:32:17,CHEQUE
CUHL01704932377151,GB91DITZ74834780737967,4/4/2017,33873.45,100002,Y,Insurance,CHROME,MOBILE,Dr,16:02:57,21:14:34,6/27/2020,24413985,1346.42,7,"Start record security less.
Call issue personal sign. Second new involve natural wind any born.",18:13:55,DD
CUHL01704932377151,GB91DITZ74834780737967,4/4/2017,33932.06,100002,N,Credited,FF,MOBILE,Cr,6:24:39,10:32:32,7/6/2020,32278040,58.61,2,Entire develop know scientist job firm of individual. Tough speak never sell health skill. Generation deep step north.,8:25:53,IMPS
CUHL01704932377151,GB91DITZ74834780737967,4/4/2017,33990.67,100002,N,Credited,MI,PC,Cr,10:43:40,13:58:22,7/6/2020,25592238,58.61,2,Thousand mind nation computer allow senior. Including quickly already who. Magazine culture hundred.,12:12:10,IMPS
CUHL01704932377151,GB91DITZ74834780737967,4/4/2017,34049.28,100002,N,Credited,FF,MOBILE,Cr,16:38:09,20:28:01,7/6/2020,67669752,58.61,7,"Tax cultural show anything now future power. To environment write control indeed.
Environmental culture among recently member. Defense product discuss.",18:23:55,DD
CUHL01704932377151,GB91DITZ74834780737967,4/4/2017,33990.67,100002,Y,Household Consumables,MI,POS,Dr,20:37:07,23:02:20,7/6/2020,29199891,58.61,5,"Seven part kid human. Media green person data sport. Music thousand arm television administration.
City create evidence game music yet. Form past risk camera.",21:27:50,CARDS
CUHL01704932377151,GB91DITZ74834780737967,4/4/2017,32235.86,100002,Y,Rent,FF,POS,Dr,2:57:30,7:19:00,7/7/2020,82670832,1754.81,5,Tend quite word again happen explain. Key information no. Doctor miss read friend.,5:09:32,CARDS
CUHL01704932377151,GB91DITZ74834780737967,4/4/2017,30481.05,100002,Y,Personal Care,OPERA,POS,Dr,8:53:18,11:16:35,7/7/2020,21915826,1754.81,2,"Speak cell eye fact other mother. Matter develop score send.
His especially prepare source reality. To claim then financial oil suddenly. Too center stop black scene expect.",10:40:17,IMPS
CUHL01704932377151,GB91DITZ74834780737967,4/4/2017,28726.24,100002,Y,Household Consumables,FF,PC,Dr,14:18:25,16:31:22,7/7/2020,21124907,1754.81,4,"Keep table meet behind general government create prepare. Idea although great human impact voice.
Go reduce issue news. Fall them follow argue phone identify number.",15:16:09,UPI
CUHL01704932377151,GB91DITZ74834780737967,4/4/2017,26971.43,100002,Y,Transportation,IE,POS,Dr,18:23:26,21:28:45,7/7/2020,64991818,1754.81,2,Event their name involve economy study. Wonder federal live. Evening bank lay away.,20:16:43,IMPS
CUHL01704932377151,GB91DITZ74834780737967,4/4/2017,26115.77,100002,Y,Rent,CHROME,POS,Dr,20:30:59,23:36:48,7/11/2020,2955773,855.66,5,"Each number size particularly area blue.
Also serve concern employee resource. Unit Republican fill decide represent two certainly modern. Nearly finally mission hair strong approach.",22:00:17,CARDS
CUHL01704932377151,GB91DITZ74834780737967,4/4/2017,26476.15,100002,N,Credited,EDGE,PC,Cr,6:38:41,9:28:30,7/17/2020,73237471,360.38,7,"Magazine opportunity send staff. Physical science under agent usually prevent.
Near opportunity perform treatment wrong. Often threat bed together work laugh fire. Change tonight effect on these.",7:49:23,DD
CUHL01704932377151,GB91DITZ74834780737967,4/4/2017,26115.77,100002,Y,Insurance,MI,MOBILE,Dr,10:52:29,13:07:38,7/17/2020,31542401,360.38,6,School although occur food officer impact. Past true under tonight cause. Kind day answer second street young.,11:34:28,CHEQUE
CUHL01704932377151,GB91DITZ74834780737967,4/4/2017,26476.15,100002,N,Credited,SAFARI,PC,Cr,11:33:12,14:28:31,7/17/2020,60451927,360.38,4,"Total left toward national care once without support. Morning day picture stop low.
Medical run street major. Or provide reflect home policy front stay. Record learn song girl computer.",12:31:50,UPI
CUHL01704932377151,GB91DITZ74834780737967,4/4/2017,26115.77,100002,Y,Transportation,OPERA,POS,Dr,16:24:36,18:44:10,7/17/2020,49776287,360.38,6,"Visit research field Republican month. These outside wide program politics reflect manage. Not activity force.
Trial think across set western look. True air leg support operation pretty again.",17:13:44,CHEQUE
CUHL01704932377151,GB91DITZ74834780737967,4/4/2017,26476.15,100002,N,Credited,OPERA,MOBILE,Cr,20:44:27,22:55:29,7/17/2020,96508367,360.38,5,"While news remember. Feel voice home. When project fill sign team some.
City even pressure plant miss everybody.
Help enter such. Hit remember wait catch education.",21:52:14,CARDS
CUHL01704932377151,GB91DITZ74834780737967,4/4/2017,27475.91,100002,N,Credited,FF,MOBILE,Cr,4:04:50,5:27:32,7/23/2020,57644530,999.76,3,"Sense issue themselves pressure. Tree defense lot window.
Full set culture last. Heart good speak everything author western.",4:43:58,RTGS
CUHL01704932377151,GB91DITZ74834780737967,4/4/2017,28475.67,100002,N,Credited,CHROME,PC,Cr,7:27:09,9:56:35,7/23/2020,59817703,999.76,3,"Body ready save because can. Physical full keep onto. Range name city throw.
Result financial expect seek financial. Stay religious indeed over ready. Reflect professor author.",9:03:58,RTGS
CUHL01704932377151,GB91DITZ74834780737967,4/4/2017,29475.43,100002,N,Credited,SAFARI,PC,Cr,11:17:34,13:51:59,7/23/2020,18552003,999.76,5,"Difficult market soon page. Sister when summer over.
Politics Congress above score look war. Focus live raise camera lawyer him.",12:47:59,CARDS
CUHL01704932377151,GB91DITZ74834780737967,4/4/2017,30475.19,100002,N,Credited,MI,PC,Cr,15:28:57,17:45:22,7/23/2020,55330404,999.76,3,Always term right price choice. Unit military management firm they. Main nor little. Hospital knowledge citizen soon defense easy.,17:19:47,RTGS
CUHL01704932377151,GB91DITZ74834780737967,4/4/2017,31474.95,100002,N,Credited,IE,MOBILE,Cr,20:08:53,22:48:07,7/23/2020,97496557,999.76,1,"History control class financial feel power. Modern seven write affect. Area trial east.
Debate method seven must I respond result. Stuff take machine cost. Difference why listen population.",21:19:43,NEFT
CUHL01704932377151,GB91DITZ74834780737967,4/4/2017,31094.5,100002,Y,Personal Care,IE,POS,Dr,9:25:46,12:34:27,7/28/2020,6757403,380.45,4,"Now professor huge notice. Measure suffer order worker.
Turn a PM group throughout spring before. Foreign stuff arrive production response. Never produce size hair stand red.",11:28:29,UPI
CUHL01704932377151,GB91DITZ74834780737967,4/4/2017,31474.95,100002,N,Credited,FF,PC,Cr,13:37:31,15:53:06,7/28/2020,38374852,380.45,7,"Suddenly me expect party decision type data. Ground generation eight produce debate. North including change treat.
Sea dog set religious scientist report.",14:38:52,DD
CUHL01704932377151,GB91DITZ74834780737967,4/4/2017,31855.4,100002,N,Credited,OPERA,PC,Cr,18:32:10,22:43:49,7/28/2020,25384345,380.45,5,"Skin though even cup. Present hour future money him exist across. Success word ball land. Exactly responsibility join election phone senior way.
Clearly outside young plan.",19:59:04,CARDS
CUHL01704932377151,GB91DITZ74834780737967,4/4/2017,30399.95,100002,Y,Rent,IE,PC,Dr,4:29:12,5:57:13,7/30/2020,74360871,1455.45,2,Respond bring southern newspaper customer public forget. First four say body baby open give. Before guy what forget often.,5:25:02,IMPS
CUHL01704932377151,GB91DITZ74834780737967,4/4/2017,28944.5,100002,Y,Personal Care,FF,PC,Dr,8:37:55,10:57:46,7/30/2020,89940747,1455.45,5,Central tell candidate science us agency message. Clearly third be southern become. Floor happen measure author put.,10:10:46,CARDS
CUHL01704932377151,GB91DITZ74834780737967,4/4/2017,27489.05,100002,Y,Utilities,IE,POS,Dr,14:50:51,16:09:23,7/30/2020,11029649,1455.45,4,"Common garden low beat. Itself during fire positive fast pretty.
From sure number goal. Forget central marriage head late drop. Rich group manage magazine.",15:36:49,UPI
CUHL01704932377151,GB91DITZ74834780737967,4/4/2017,28944.5,100002,N,Credited,FF,PC,Cr,15:25:44,18:36:16,7/30/2020,36787678,1455.45,6,"Who politics president keep power cell. General clear stage be. Forward federal sign couple film source.
Name provide they head.",16:51:14,CHEQUE
CUHL01704932377151,GB91DITZ74834780737967,4/4/2017,30399.95,100002,N,Credited,EDGE,POS,Cr,19:06:15,22:08:41,7/30/2020,27974131,1455.45,3,"Back factor sit choose sit happen his. Heavy glass character build ask.
Institution owner woman short someone check. When Mr character until report. Unit know character later more wide.",20:36:00,RTGS
CUHL01704932377151,GB91DITZ74834780737967,4/4/2017,32178.3,100002,N,Credited,FF,MOBILE,Cr,8:07:04,12:01:20,8/7/2020,40653952,1778.35,4,"Break spring affect set. Wrong office phone beautiful specific power.
Resource life suggest man way likely. Budget it must guy society second. Call natural eight season factor exist unit sister.",9:35:22,UPI
CUHL01704932377151,GB91DITZ74834780737967,4/4/2017,30399.95,100002,Y,Online Shopping,IE,PC,Dr,14:09:18,18:46:00,8/7/2020,9229365,1778.35,2,"Prove fine store. Edge draw result thing crime when hand occur. Those matter sing.
Defense by food score number state never thank. Shoulder guy tax not purpose parent interesting.",16:43:11,IMPS
CUHL01704932377151,GB91DITZ74834780737967,4/4/2017,32178.3,100002,N,Credited,EDGE,PC,Cr,21:03:13,24:25:11,8/7/2020,13299873,1778.35,4,"What return tell hospital water clearly hold member. Sing reality others war.
Realize quickly me consumer. Meet safe stuff vote skill drug mouth.",23:35:18,UPI
CUHL01704932377151,GB91DITZ74834780737967,4/4/2017,34114.8,100002,N,Credited,OPERA,MOBILE,Cr,2:44:40,5:05:12,8/8/2020,32136692,1936.5,3,Security sometimes service around thousand several. Its cultural local offer employee chance. Beyond charge enough age better everybody.,4:39:48,RTGS
CUHL01704932377151,GB91DITZ74834780737967,4/4/2017,36051.3,100002,N,Credited,CHROME,MOBILE,Cr,10:17:23,12:48:06,8/8/2020,76087608,1936.5,2,"Believe computer take kid likely. Improve let year environment federal wall surface.
Available similar light wall husband my check. Traditional dream produce other. Board weight business discussion.",10:57:58,IMPS
CUHL01704932377151,GB91DITZ74834780737967,4/4/2017,37987.8,100002,N,Credited,FF,MOBILE,Cr,14:11:28,16:20:33,8/8/2020,49621891,1936.5,2,"Probably report ever. Quality eight include then our serve. Either pull item understand others us. Hit often responsibility draw.
Alone director experience customer. Apply less quality chair test.",15:07:35,IMPS
CUHL01704932377151,GB91DITZ74834780737967,4/4/2017,39924.3,100002,N,Credited,SAFARI,POS,Cr,15:58:15,18:56:47,8/8/2020,36631834,1936.5,7,"Worry wide group though end majority project ready. Choice my toward school. Development strategy here agree evening through.
Ten difference trip fall fire suggest. Two plan stand foot.",17:14:01,DD
CUHL01704932377151,GB91DITZ74834780737967,4/4/2017,37987.8,100002,Y,Medicals,CHROME,POS,Dr,19:30:53,22:28:43,8/8/2020,64385846,1936.5,7,Member authority modern single participant. Consider talk benefit long be.,20:53:28,DD
CUHL01704932377151,GB91DITZ74834780737967,4/4/2017,38020.33,100002,N,Credited,SAFARI,MOBILE,Cr,4:26:28,7:23:36,8/15/2020,74520350,32.53,1,Chair number here real method. Sport national success listen very order ask door. Join now father subject environment family forget.,5:29:43,NEFT
CUHL01704932377151,GB91DITZ74834780737967,4/4/2017,37987.8,100002,Y,Personal Care,EDGE,PC,Dr,13:02:12,15:05:24,8/15/2020,70232264,32.53,7,"Break scientist level evidence. Last stop ok administration memory success too. Mouth decision line call laugh.
Station example would service notice on. Local member green team owner let see present.",13:34:29,DD
CUHL01704932377151,GB91DITZ74834780737967,4/4/2017,38020.33,100002,N,Credited,EDGE,PC,Cr,16:11:53,17:35:57,8/15/2020,71870915,32.53,5,"Model amount fill station author itself fire.
Democrat offer international such true information happy. Large suddenly oil trip figure.",17:00:16,CARDS
CUHL01704932377151,GB91DITZ74834780737967,4/4/2017,38052.86,100002,N,Credited,SAFARI,MOBILE,Cr,20:36:07,25:04:21,8/15/2020,9516441,32.53,5,"Tonight fast across few accept. Spend rate to notice list side bill. Probably politics occur doctor.
Job follow production wife. Subject and forget apply use concern note.",22:56:50,CARDS
CUHL01704932377151,GB91DITZ74834780737967,4/4/2017,36874.67,100002,Y,Insurance,IE,MOBILE,Dr,3:38:53,6:53:39,8/22/2020,6080273,1178.19,4,"Military thank hope phone home. And return goal describe song change author. Laugh boy shoulder turn.
Find rate camera customer huge. Within wall perform score. Wish tough writer maybe onto go.",5:25:12,UPI
CUHL01704932377151,GB91DITZ74834780737967,4/4/2017,35696.48,100002,Y,Dining,EDGE,MOBILE,Dr,12:39:17,13:41:43,8/22/2020,96374078,1178.19,1,"Religious movement feeling gas. Report drug your this.
Common short allow down pattern affect stay just.",13:11:56,NEFT
CUHL01704932377151,GB91DITZ74834780737967,4/4/2017,36874.67,100002,N,Credited,IE,POS,Cr,14:53:04,16:37:36,8/22/2020,72653258,1178.19,3,Side show only unit avoid yard. Nothing many over another next risk. Subject few itself sell per hard let.,15:22:54,RTGS
CUHL01704932377151,GB91DITZ74834780737967,4/4/2017,38052.86,100002,N,Credited,MI,PC,Cr,22:01:09,25:39:07,8/22/2020,81318452,1178.19,7,Feeling just take billion white once. Record walk dinner almost stage charge those. Six beat red cultural cup cell.,23:22:33,DD
CUHL01704932377151,GB91DITZ74834780737967,4/4/2017,39458.55,100002,N,Credited,CHROME,MOBILE,Cr,5:23:16,7:00:36,8/23/2020,62335416,1405.69,2,Clearly industry statement billion. Learn marriage action stop. Range major easy suggest agency.,6:03:53,IMPS
CUHL01704932377151,GB91DITZ74834780737967,4/4/2017,40864.24,100002,N,Credited,FF,PC,Cr,12:44:02,15:44:18,8/23/2020,9553651,1405.69,5,"Information easy first short term defense. Line world trip over some.
Early so reality majority we attack. Level pattern economic know.",14:23:37,CARDS
CUHL01704932377151,GB91DITZ74834780737967,4/4/2017,39458.55,100002,Y,Groceries,EDGE,MOBILE,Dr,14:50:16,17:42:50,8/23/2020,13797607,1405.69,1,"Change firm better require store. Report find method grow consider.
Up upon interest space radio must.",16:53:08,NEFT
CUHL01704932377151,GB91DITZ74834780737967,4/4/2017,38052.86,100002,Y,Groceries,SAFARI,PC,Dr,18:59:23,23:20:09,8/23/2020,47954816,1405.69,3,"Production ready you foot. Hit action baby community. Trade scientist produce attorney.
Throughout ten help attack organization respond. Month measure themselves end life especially.",21:10:41,RTGS
CUHL01704932377151,GB91DITZ74834780737967,4/4/2017,38787.43,100002,N,Credited,EDGE,POS,Cr,3:52:29,6:01:38,8/28/2020,1216684,734.57,3,"Charge court hair. Write south size tend rich must.
Provide difficult one later oil music. Beat door keep just own. Almost social happy our land.",5:29:50,RTGS
CUHL01704932377151,GB91DITZ74834780737967,4/4/2017,38052.86,100002,Y,Personal Care,OPERA,PC,Dr,10:41:21,14:10:44,8/28/2020,50769247,734.57,7,Experience quite people there continue method tonight. Election something to step. Anyone house certainly here house evening.,12:17:20,DD
CUHL01704932377151,GB91DITZ74834780737967,4/4/2017,38787.43,100002,N,Credited,SAFARI,PC,Cr,16:27:08,20:33:54,8/28/2020,99832957,734.57,4,"Too suddenly care.
Rise reality single newspaper suggest represent ever. Story compare likely its. Minute performance find discuss.",18:50:21,UPI
CUHL01704932377151,GB91DITZ74834780737967,4/4/2017,38052.86,100002,Y,Dining,FF,PC,Dr,19:50:48,23:29:22,8/28/2020,32931082,734.57,3,"Avoid note middle put according who. Product foreign not serve.
Safe represent start skin share maybe image. Kind rather beyond maintain allow me feeling.",22:00:28,RTGS
CUHL01704932377151,GB91DITZ74834780737967,4/4/2017,37890.78,100002,Y,Online Shopping,CHROME,PC,Dr,7:04:50,8:51:56,8/30/2020,81750481,162.08,5,"My fall west sure. Child bad similar the. Account capital yard call image month easy.
Stage movie same company practice PM. Describe walk court.",7:53:46,CARDS
CUHL01704932377151,GB91DITZ74834780737967,4/4/2017,37728.7,100002,Y,Online Shopping,EDGE,POS,Dr,13:33:09,15:16:09,8/30/2020,45186875,162.08,4,"Population federal show bad hundred. Form gun citizen pretty leg sport.
Even yeah site fire reason beautiful stand after. Company room page here second history. Onto report room price.",14:15:01,UPI
CUHL01704932377151,GB91DITZ74834780737967,4/4/2017,37566.62,100002,Y,Personal Care,IE,PC,Dr,18:34:52,20:42:47,8/30/2020,20417598,162.08,4,"Ground across dream security ago either turn. Leave by should crime make most. Realize usually point keep. Argue yet former look.
Food pattern ok water dark they director.",19:06:16,UPI
CUHL01704932377151,GB91DITZ74834780737967,4/4/2017,37728.7,100002,N,Credited,FF,MOBILE,Cr,18:33:36,19:47:29,8/30/2020,19160603,162.08,7,Chair discuss south. Yard music drug. Tough put seven eat determine. Mention cause order way.,19:15:13,DD
CUHL01704932377151,GB91DITZ74834780737967,4/4/2017,36950.91,100002,Y,Transportation,IE,PC,Dr,10:07:19,13:20:56,9/1/2020,61039032,777.79,3,"Scene lay mind road bed out each. Kitchen other personal fire.
Discussion pressure her stage include number. Sometimes reason shoulder industry use. Employee you heavy tonight speech Mr fill.",11:31:31,RTGS
CUHL01704932377151,GB91DITZ74834780737967,4/4/2017,36173.12,100002,Y,Utilities,EDGE,POS,Dr,14:37:30,16:52:50,9/1/2020,67492497,777.79,4,Picture since song manager try why southern. Near war ahead foot newspaper test account. Letter among lead treatment success than.,15:42:08,UPI
CUHL01704932377151,GB91DITZ74834780737967,4/4/2017,35395.33,100002,Y,Rent,SAFARI,POS,Dr,19:24:24,22:46:44,9/1/2020,4729914,777.79,3,Blood require present may happen those same. Blue politics the information answer sometimes in. Actually teacher impact court agreement prevent authority.,21:18:27,RTGS
CUHL01704932377151,GB91DITZ74834780737967,4/4/2017,34210.28,100002,Y,Dining,MI,PC,Dr,4:49:15,8:39:21,9/6/2020,40263717,1185.05,5,Network road hundred site operation name off after. Television college fall manage beautiful can rock. Strong work behavior wide yeah.,6:45:11,CARDS
CUHL01704932377151,GB91DITZ74834780737967,4/4/2017,33025.23,100002,Y,Household Consumables,IE,PC,Dr,13:36:48,16:25:13,9/6/2020,44750831,1185.05,3,"Tell sometimes eye cup reach any culture.
Agreement practice local fast again night. Recent town final itself worry assume.
Concern onto vote us life. Determine loss talk.",14:22:31,RTGS
CUHL01704932377151,GB91DITZ74834780737967,4/4/2017,31840.18,100002,Y,Insurance,FF,POS,Dr,15:41:48,18:26:01,9/6/2020,29676842,1185.05,3,"Cover watch business whatever. Drive between weight production change.
Effort around great. Least many community responsibility country prepare. Amount surface growth smile wonder of both.",17:26:24,RTGS
CUHL01704932377151,GB91DITZ74834780737967,4/4/2017,30655.13,100002,Y,Household Consumables,FF,PC,Dr,17:20:48,20:51:07,9/6/2020,85587076,1185.05,5,"Team stage day letter even. Prepare control tend behavior fish wrong.
A within cold probably either agree. Street alone east night without.",19:36:05,CARDS
CUHL01704932377151,GB91DITZ74834780737967,4/4/2017,30702.65,100002,N,Credited,CHROME,PC,Cr,9:15:55,15:31:09,9/7/2020,37867430,47.52,4,"Treat hit soon all. Perform laugh everyone play fund knowledge strong design.
Bit seven send four civil decade life. Why main structure.",13:16:37,UPI
CUHL01704932377151,GB91DITZ74834780737967,4/4/2017,29959.25,100002,Y,Insurance,SAFARI,PC,Dr,4:52:31,8:26:02,9/13/2020,55055451,743.4,5,"Say too act such us fear. Relationship wife decision practice them big.
Herself for place back among will real. Important west stage wait.",6:16:48,CARDS
CUHL01704932377151,GB91DITZ74834780737967,4/4/2017,29215.85,100002,Y,Online Shopping,FF,PC,Dr,9:40:55,13:38:54,9/13/2020,71684499,743.4,1,"Team at song four. Interesting image computer fill open statement event agree.
Get degree owner price.
Service its serious before guy summer. Turn article clearly arrive.",12:27:06,NEFT
CUHL01704932377151,GB91DITZ74834780737967,4/4/2017,28472.45,100002,Y,Groceries,IE,POS,Dr,22:02:00,25:48:38,9/13/2020,68822125,743.4,4,Man how food walk surface. Safe who speech recent result. Rather improve help think capital.,23:54:45,UPI
CUHL01704932377151,GB91DITZ74834780737967,4/4/2017,27553.1,100002,Y,Entertainment,SAFARI,POS,Dr,6:05:59,7:42:12,9/18/2020,90073090,919.35,2,"Team technology page subject call yourself. Main same something because.
Change analysis run television rule. Property somebody throughout.
Determine tell word follow.",6:47:07,IMPS
CUHL01704932377151,GB91DITZ74834780737967,4/4/2017,26633.75,100002,Y,Utilities,OPERA,PC,Dr,11:03:03,12:59:37,9/18/2020,96299265,919.35,2,Yet religious real whole head include method firm. Meeting theory security dog walk movement data. Church discover agreement number give.,11:46:05,IMPS
CUHL01704932377151,GB91DITZ74834780737967,4/4/2017,25714.4,100002,Y,Dining,FF,MOBILE,Dr,14:50:07,16:29:27,9/18/2020,31562720,919.35,2,Reach movement group far thousand. Soon work agreement financial. Will event travel easy experience bank woman.,15:52:11,IMPS
CUHL01704932377151,GB91DITZ74834780737967,4/4/2017,24795.05,100002,Y,Online Shopping,IE,PC,Dr,15:50:11,18:01:54,9/18/2020,47872974,919.35,5,"Issue price trial it.
Memory run where political drive. Difference red quality high building. Attorney sing whether else analysis.",16:46:39,CARDS
CUHL01704932377151,GB91DITZ74834780737967,4/4/2017,25714.4,100002,N,Credited,FF,POS,Cr,19:45:14,22:17:12,9/18/2020,43962518,919.35,2,State ground style mouth. Mention college night right early.,20:30:03,IMPS
CUHL01704932377151,GB91DITZ74834780737967,4/4/2017,25083.37,100002,Y,Groceries,OPERA,PC,Dr,7:34:09,9:13:21,9/19/2020,69419997,631.03,6,Night approach free rise think develop end. Between enter end difficult fine them. Step still that while their role green.,8:22:40,CHEQUE
CUHL01704932377151,GB91DITZ74834780737967,4/4/2017,24452.34,100002,Y,Dining,FF,POS,Dr,10:36:18,12:16:38,9/19/2020,33394015,631.03,6,"Degree investment bed trouble. Dog local treat entire step. Skill through ask age.
Appear event question. Rate explain laugh.",11:40:34,CHEQUE
CUHL01704932377151,GB91DITZ74834780737967,4/4/2017,23821.31,100002,Y,Household Consumables,FF,MOBILE,Dr,16:34:49,19:47:14,9/19/2020,24347402,631.03,6,"Mission race almost. Generation think new far. Which goal when myself.
Happen sit ten game doctor eye some. Common how agreement book may write offer. Face why with parent include fast.",18:55:15,CHEQUE
CUHL01704932377151,GB91DITZ74834780737967,4/4/2017,23190.28,100002,Y,Dining,MI,PC,Dr,18:16:41,21:56:36,9/19/2020,34618172,631.03,7,"Difficult loss if government usually four. Side score pay recognize.
Already song rather of hospital decide. Method various remember score talk leave meet difficult.",20:08:31,DD
CUHL01704932377151,GB91DITZ74834780737967,4/4/2017,23871.65,100002,N,Credited,MI,POS,Cr,22:21:07,25:42:00,9/25/2020,16383074,681.37,5,Hand claim sister body fund million. Until entire history car.,23:43:29,CARDS
CUHL01704932377151,GB91DITZ74834780737967,4/4/2017,24648.62,100002,N,Credited,FF,MOBILE,Cr,4:58:54,6:47:28,9/28/2020,28158752,776.97,3,"May be meeting between too attorney school.
Yard remember price theory letter budget various. Issue check federal message organization.",5:48:16,RTGS
CUHL01704932377151,GB91DITZ74834780737967,4/4/2017,23871.65,100002,Y,Insurance,SAFARI,POS,Dr,8:47:14,11:51:51,9/28/2020,8555373,776.97,5,"Painting year show magazine fight yard test. After life yeah central.
Foot yourself security form. Culture later order election kid for stay like.",9:49:27,CARDS
CUHL01704932377151,GB91DITZ74834780737967,4/4/2017,23094.68,100002,Y,Groceries,FF,PC,Dr,17:08:03,19:59:10,9/28/2020,29819966,776.97,2,Indeed human international pay respond involve friend. Hair attention little wait reduce catch fast.,18:30:56,IMPS
CUHL01704932377151,GB91DITZ74834780737967,4/4/2017,22317.71,100002,Y,Entertainment,EDGE,POS,Dr,19:51:15,23:20:45,9/28/2020,54459830,776.97,1,"Financial listen everyone notice tonight. Society story meeting consumer culture middle. Car hit eat.
Which order professor successful. Ago walk notice language expert.",21:10:03,NEFT
CUHL01704932377151,GB91DITZ74834780737967,4/4/2017,21966.49,100002,Y,Dining,IE,PC,Dr,11:07:35,15:10:23,10/10/2020,68392604,351.22,2,"North mission group affect former especially apply. Military bank to knowledge. Budget else strategy report.
Choose shoulder win report pick. Trouble describe consider. Summer never key election.",14:02:32,IMPS
CUHL01704932377151,GB91DITZ74834780737967,4/4/2017,21615.27,100002,Y,Medicals,OPERA,MOBILE,Dr,19:24:07,25:13:11,10/10/2020,55030571,351.22,2,Edge line and drug their. Face sure operation you remain power remember.,22:23:10,IMPS
CUHL01704932377151,GB91DITZ74834780737967,4/4/2017,22228.79,100002,N,Credited,IE,PC,Cr,8:03:42,10:18:17,10/12/2020,66669807,613.52,1,"Ever amount TV. Risk could speech season thus. Administration discussion tax by early worker or think.
Mean old have heart we. Stock traditional dog thing. Minute political reason maybe me wrong.",9:32:14,NEFT
CUHL01704932377151,GB91DITZ74834780737967,4/4/2017,22842.31,100002,N,Credited,FF,MOBILE,Cr,11:34:53,14:34:31,10/12/2020,23727595,613.52,3,Member national his heart. Office responsibility bar region step. Loss cultural still single.,12:36:48,RTGS
CUHL01704932377151,GB91DITZ74834780737967,4/4/2017,22228.79,100002,Y,Online Shopping,FF,POS,Dr,13:43:30,15:44:44,10/12/2020,63003697,613.52,3,"Weight no west raise pass stop. Near second gun piece stand.
Behind often explain add smile notice month. Picture yet outside right campaign.",14:27:23,RTGS
CUHL01704932377151,GB91DITZ74834780737967,4/4/2017,21615.27,100002,Y,Dining,OPERA,MOBILE,Dr,21:24:44,25:11:44,10/12/2020,12937813,613.52,5,His glass respond today. Single lead red protect school pattern before. Benefit chance it represent idea necessary choose.,23:37:41,CARDS
CUHL01704932377151,GB91DITZ74834780737967,4/4/2017,21234.81,100002,Y,Household Consumables,CHROME,POS,Dr,5:59:49,9:33:27,10/14/2020,13162016,380.46,5,"Team work plan hair dinner. Area hair federal Democrat.
About offer fine base traditional recently. Conference trade financial board.",7:27:55,CARDS
CUHL01704932377151,GB91DITZ74834780737967,4/4/2017,20854.35,100002,Y,Dining,OPERA,POS,Dr,11:55:51,14:25:54,10/14/2020,9171855,380.46,1,"Across great color he economy lay figure. Out safe doctor together yes between.
Theory relate seek garden. Yard drug concern believe. Model send our.",13:43:25,NEFT
CUHL01704932377151,GB91DITZ74834780737967,4/4/2017,21234.81,100002,N,Credited,CHROME,PC,Cr,16:01:06,20:32:00,10/14/2020,88034874,380.46,7,"Happy determine evidence. Authority color anything away family each art.
Indeed interest budget east. Cover whose hot today bed suddenly. Poor team energy why.",18:21:44,DD
CUHL01704932377151,GB91DITZ74834780737967,4/4/2017,20854.35,100002,Y,Household Consumables,SAFARI,MOBILE,Dr,20:05:54,22:53:50,10/14/2020,54868403,380.46,6,"Discover couple expect peace seem government. Expert general a meet.
Rather politics building person process shoulder. Current few you home during situation. Cell film feeling what ok.",20:43:59,CHEQUE
CUHL01704932377151,GB91DITZ74834780737967,4/4/2017,22262.73,100002,N,Credited,MI,PC,Cr,12:27:45,18:20:37,10/17/2020,92406513,1408.38,3,"Manager us research senior. Management floor exist loss. Mention police pressure.
Natural attorney age son.
Religious realize company type pretty beyond. Above sort low.",15:01:12,RTGS
CUHL01704932377151,GB91DITZ74834780737967,4/4/2017,20854.35,100002,Y,Transportation,EDGE,MOBILE,Dr,16:22:06,21:09:02,10/17/2020,60790330,1408.38,3,Although represent break might operation wear about. People protect must it peace but truth.,17:58:28,RTGS
CUHL01704932377151,GB91DITZ74834780737967,4/4/2017,21916.36,100002,N,Credited,MI,PC,Cr,22:17:28,28:07:57,10/27/2020,71879772,1062.01,6,"Administration yard stock. View audience break out indicate action reflect last. Rule court interest phone our.
Large expert team beautiful cultural everything dark city.
Coach his resource make.",23:54:30,CHEQUE
CUHL01704932377151,GB91DITZ74834780737967,4/4/2017,20809.36,100002,Y,Entertainment,CHROME,PC,Dr,4:58:05,6:03:54,11/2/2020,52052057,1107,5,Ready place idea start tough skin. Explain study yet place dark rule opportunity.,5:23:02,CARDS
CUHL01704932377151,GB91DITZ74834780737967,4/4/2017,19702.36,100002,Y,Groceries,FF,POS,Dr,8:55:41,11:33:57,11/2/2020,92466074,1107,4,Member not through poor life. Choice appear blue car message. Recent career skill return have mother. Create identify tough.,9:45:28,UPI
CUHL01704932377151,GB91DITZ74834780737967,4/4/2017,20809.36,100002,N,Credited,MI,POS,Cr,10:41:58,12:41:27,11/2/2020,24508476,1107,1,War hour trade coach suffer get weight respond. Listen military well bed price move story. Its work by knowledge professional.,12:13:57,NEFT
CUHL01704932377151,GB91DITZ74834780737967,4/4/2017,21916.36,100002,N,Credited,OPERA,POS,Cr,16:15:19,19:29:25,11/2/2020,23055544,1107,1,"Bar animal arrive detail fine truth he. Each base center establish save country.
Hospital catch give next organization. Let nice throughout alone Democrat.",18:04:21,NEFT
CUHL01704932377151,GB91DITZ74834780737967,4/4/2017,23023.36,100002,N,Credited,MI,MOBILE,Cr,20:43:20,22:39:54,11/2/2020,40156699,1107,1,"Business it adult prepare medical. Down say skin audience finally age leave. Million house herself true.
Officer seek appear more born add. Low follow born have nice serious where.",21:45:29,NEFT
CUHL01704932377151,GB91DITZ74834780737967,4/4/2017,24912.5,100002,N,Credited,EDGE,PC,Cr,8:27:23,13:41:49,11/23/2020,58593776,1889.14,1,Strategy wish benefit forward. Young born buy plan call debate inside skill. Little care positive trouble authority require. News seven matter.,11:06:32,NEFT
CUHL01704932377151,GB91DITZ74834780737967,4/4/2017,26801.64,100002,N,Credited,MI,MOBILE,Cr,10:55:18,13:23:02,11/23/2020,97365990,1889.14,5,"Set possible foreign simply big sister. Production each whether mouth international hit down. Shoulder guess reflect road such.
Magazine although way name pull. Major appear seem ask share.",12:36:23,CARDS
CUHL01704932377151,GB91DITZ74834780737967,4/4/2017,28690.78,100002,N,Credited,SAFARI,PC,Cr,20:20:44,24:23:01,11/23/2020,29392568,1889.14,3,"While character couple usually. Across test read major strategy until. Never most whatever happy.
Level protect this. Next civil politics big writer stop.",23:00:08,RTGS
CUHL01704932377151,GB91DITZ74834780737967,4/4/2017,27583.01,100002,Y,Groceries,OPERA,PC,Dr,7:01:18,10:36:04,11/25/2020,70486308,1107.77,3,"Southern factor study wear say.
Whatever despite time right state energy alone. Majority notice list action before should ability. Game pattern capital.",9:18:27,RTGS
CUHL01704932377151,GB91DITZ74834780737967,4/4/2017,28690.78,100002,N,Credited,FF,MOBILE,Cr,13:07:28,16:19:09,11/25/2020,15580351,1107.77,4,"Bank room according never lay message. Employee break news.
Individual stage nor fine. Different parent apply service.",14:02:59,UPI
CUHL01704932377151,GB91DITZ74834780737967,4/4/2017,29798.55,100002,N,Credited,OPERA,PC,Cr,15:01:06,16:59:30,11/25/2020,4860754,1107.77,5,Particular loss may thousand military best generation. Defense direction to send share national apply effect. Here both trouble old from particularly. Have around wonder here.,16:20:13,CARDS
CUHL01704932377151,GB91DITZ74834780737967,4/4/2017,30906.32,100002,N,Credited,FF,PC,Cr,18:22:13,20:40:39,11/25/2020,65578773,1107.77,4,"Rule single Mr per leave. From movie to talk win exist.
Sign season various.
Hotel doctor glass good generation some to bad. Begin about arm find shake act sort.",19:47:46,UPI
CUHL01704932377151,GB91DITZ74834780737967,4/4/2017,30289.82,100002,Y,Online Shopping,FF,MOBILE,Dr,4:10:12,8:19:11,12/1/2020,68768003,616.5,5,Almost on represent start site painting generation happy. Child let change build audience later year join. Create avoid success lawyer good born. Then tell you national career recognize them.,6:06:25,CARDS
CUHL01704932377151,GB91DITZ74834780737967,4/4/2017,30906.32,100002,N,Credited,FF,POS,Cr,12:37:29,14:39:27,12/1/2020,60856081,616.5,5,"Public page it standard. Activity well list character call its himself.
Season machine left. Around too home. Popular first science size.
Require ahead successful red.",13:49:34,CARDS
CUHL01704932377151,GB91DITZ74834780737967,4/4/2017,31522.82,100002,N,Credited,MI,MOBILE,Cr,16:29:30,19:22:43,12/1/2020,63811018,616.5,7,Represent name cause station president so. Science traditional cost put be. Career material coach color paper.,17:16:02,DD
CUHL01704932377151,GB91DITZ74834780737967,4/4/2017,30906.32,100002,Y,Dining,IE,POS,Dr,20:10:22,22:31:43,12/1/2020,59069638,616.5,5,"Suggest present animal improve part third. Friend big you team research. Million marriage possible song.
Growth difficult front still. Green stay health indicate play.",20:46:56,CARDS
CUHL01704932377151,GB91DITZ74834780737967,4/4/2017,32104.57,100002,N,Credited,EDGE,PC,Cr,10:08:18,15:08:36,12/5/2020,4764656,1198.25,6,"Realize next meet pretty receive. Successful also realize possible great season language. Energy time none house.
Everybody easy shake position dog. Focus military investment cell.",13:35:47,CHEQUE
CUHL01704932377151,GB91DITZ74834780737967,4/4/2017,33302.82,100002,N,Credited,EDGE,MOBILE,Cr,14:57:09,20:11:49,12/5/2020,98738908,1198.25,7,"Final nation candidate build wind. See such include claim popular suggest history.
Weight drug television tend.",17:32:08,DD
CUHL01704932377151,GB91DITZ74834780737967,4/4/2017,32412.9,100002,Y,Insurance,MI,MOBILE,Dr,5:38:59,8:20:00,12/16/2020,36604692,889.92,1,Once involve worker staff common impact parent decide. Collection gas town too. Surface civil agency one.,7:48:10,NEFT
CUHL01704932377151,GB91DITZ74834780737967,4/4/2017,31522.98,100002,Y,Utilities,MI,POS,Dr,8:54:36,11:21:50,12/16/2020,73441540,889.92,4,Thus seven pick similar Mrs. Morning strategy laugh every tell. Tend century blue behavior note skin near.,10:20:10,UPI
CUHL01704932377151,GB91DITZ74834780737967,4/4/2017,32412.9,100002,N,Credited,OPERA,MOBILE,Cr,17:10:05,19:47:49,12/16/2020,26267173,889.92,2,"Build offer up tax possible without.
Window PM weight.
Bed true mind might. Method side at.
Action apply go technology reality. Talk people relationship simply dark particularly tell.",18:10:18,IMPS
CUHL01704932377151,GB91DITZ74834780737967,4/4/2017,31522.98,100002,Y,Entertainment,CHROME,MOBILE,Dr,20:01:27,22:33:25,12/16/2020,75866648,889.92,6,"Visit mind heart serve. Collection ask score possible.
Radio keep population help appear. Will without spend.
Source or evening none coach. Professional stock ok decade site only accept.",21:55:33,CHEQUE
CUHL01704932377151,GB91DITZ74834780737967,4/4/2017,31636.51,100002,N,Credited,FF,PC,Cr,5:32:52,7:43:07,12/19/2020,94097757,113.53,4,No consider it practice officer benefit both mean. Avoid physical statement condition send baby land. Analysis hold prevent develop whole research toward.,6:49:37,UPI
CUHL01704932377151,GB91DITZ74834780737967,4/4/2017,31522.98,100002,Y,Insurance,FF,MOBILE,Dr,15:14:18,18:51:58,12/19/2020,61188549,113.53,3,Think situation teach. Amount push significant seven century picture strategy. Economic tough activity Congress long total fish. There watch there but religious nice great save.,16:42:33,RTGS
CUHL01704932377151,GB91DITZ74834780737967,4/4/2017,31636.51,100002,N,Credited,MI,POS,Cr,21:42:42,24:09:50,12/19/2020,98288359,113.53,7,"Even from rock expert. Majority traditional PM level. Many your beyond. Activity former many move do way let.
Quite read enjoy assume pass. Be former so. Attack low tend per.",22:52:45,DD
CUHL01704932377151,GB91DITZ74834780737967,4/4/2017,29776.76,100002,Y,Groceries,IE,POS,Dr,17:05:09,26:16:15,12/20/2020,96924792,1859.75,3,Those popular loss low cut begin. Maintain family some what. Full small camera bring over.,22:36:56,RTGS
CUHL01704932377151,GB91DITZ74834780737967,4/4/2017,27779.09,100002,Y,Dining,FF,MOBILE,Dr,7:08:45,12:52:43,1/5/2021,87252231,1997.67,4,"Pull realize figure her. Base week black scientist common. Continue story woman.
Bag between reason hold after. Shoulder night prepare some.",10:05:09,UPI
CUHL01704932377151,GB91DITZ74834780737967,4/4/2017,29776.76,100002,N,Credited,OPERA,POS,Cr,12:11:54,17:00:15,1/5/2021,85647862,1997.67,3,"Amount necessary visit theory accept sister. One defense reason far. This kid audience street next certainly.
Movie effort as network.",14:41:50,RTGS
CUHL01704932377151,GB91DITZ74834780737967,4/4/2017,27779.09,100002,Y,Insurance,OPERA,PC,Dr,18:23:31,22:32:36,1/5/2021,23308718,1997.67,5,"Region behind purpose cause movie. Animal reach will.
Able data without receive base top. American maintain send pick. Let cost contain similar worry coach join.",20:51:44,CARDS
CUHL01704932377151,GB91DITZ74834780737967,4/4/2017,27599.57,100002,Y,Entertainment,MI,PC,Dr,3:18:27,6:40:55,1/6/2021,66854326,179.52,5,"Ahead major college paper make meeting professor. Boy consumer each.
Price money from writer save. Despite traditional president officer painting box. Foot spend watch including budget.",5:03:56,CARDS
CUHL01704932377151,GB91DITZ74834780737967,4/4/2017,27420.05,100002,Y,Rent,EDGE,MOBILE,Dr,8:59:18,11:01:06,1/6/2021,53099365,179.52,1,"Mother site vote.
Forget quite perhaps recent party back. Surface student which plan his.
Follow because behavior take drive dog.",9:48:41,NEFT
CUHL01704932377151,GB91DITZ74834780737967,4/4/2017,27599.57,100002,N,Credited,SAFARI,MOBILE,Cr,13:09:56,15:47:10,1/6/2021,61920668,179.52,2,"Box information federal hundred special operation. Result million huge adult national win.
Rise wonder too morning. Garden those everybody especially.",14:56:26,IMPS
CUHL01704932377151,GB91DITZ74834780737967,4/4/2017,27779.09,100002,N,Credited,SAFARI,PC,Cr,15:33:10,18:21:02,1/6/2021,84724670,179.52,4,"Like left employee understand can pretty local. Together success line parent.
That million fast as agency Congress. Account expect south.",17:08:10,UPI
CUHL01704932377151,GB91DITZ74834780737967,4/4/2017,27599.57,100002,Y,Groceries,CHROME,MOBILE,Dr,22:12:23,24:42:39,1/6/2021,8683649,179.52,5,Budget black international bank. Majority outside side around.,23:01:08,CARDS
CUHL01704932377151,GB91DITZ74834780737967,4/4/2017,27936.11,100002,N,Credited,FF,MOBILE,Cr,7:11:48,11:02:26,1/11/2021,27183496,336.54,7,"Program especially believe center society gas. Claim least time health sometimes.
Here others level program nice line. Along politics show once space collection benefit.",9:07:30,DD
CUHL01704932377151,GB91DITZ74834780737967,4/4/2017,27599.57,100002,Y,Groceries,FF,POS,Dr,12:29:53,14:30:33,1/11/2021,86772426,336.54,7,"Of bill scene. Tough involve too stock standard behind story.
Participant direction start page ok. Should world realize just message without inside. Cost fight husband.",13:23:23,DD
CUHL01704932377151,GB91DITZ74834780737967,4/4/2017,27936.11,100002,N,Credited,IE,MOBILE,Cr,16:28:21,19:14:34,1/11/2021,24038638,336.54,6,"Inside real thus clear. Camera service technology. Trip real well stop garden.
Miss her manage range whether exist color.",17:30:43,CHEQUE
CUHL01704932377151,GB91DITZ74834780737967,4/4/2017,27599.57,100002,Y,Medicals,IE,POS,Dr,17:33:33,21:51:00,1/11/2021,4672029,336.54,7,Teacher kind the. Magazine respond computer test term one show huge. Which American character real.,19:47:33,DD
CUHL01704932377151,GB91DITZ74834780737967,4/4/2017,27844.98,100002,N,Credited,IE,MOBILE,Cr,6:59:17,8:58:15,1/19/2021,49799651,245.41,4,"Their represent ever benefit manage. Floor interview business clearly ground. Yeah social cold detail.
Tough recently story nice. Our born race trial. Forward right give see.",7:29:15,UPI
CUHL01704932377151,GB91DITZ74834780737967,4/4/2017,27599.57,100002,Y,Online Shopping,OPERA,PC,Dr,10:21:51,13:26:43,1/19/2021,87827934,245.41,7,"Company affect small. Attorney deal decade piece.
School nature be every. Rock third offer lay production.
White decade trip form. After day identify during part per charge.",11:30:32,DD
CUHL01704932377151,GB91DITZ74834780737967,4/4/2017,27844.98,100002,N,Credited,CHROME,POS,Cr,15:31:25,16:59:00,1/19/2021,73859505,245.41,4,"Foreign similar paper. Reduce reality involve growth brother common.
Travel writer strong increase. Step college consider avoid. Read child important law audience.",15:57:28,UPI
CUHL01704932377151,GB91DITZ74834780737967,4/4/2017,27599.57,100002,Y,Online Shopping,SAFARI,MOBILE,Dr,17:40:51,18:56:34,1/19/2021,22775481,245.41,3,"Outside meeting investment wife travel. Clear miss benefit.
Off second its. Buy concern goal movement. Else most husband impact research because without.",18:14:43,RTGS
CUHL01704932377151,GB91DITZ74834780737967,4/4/2017,27844.98,100002,N,Credited,SAFARI,POS,Cr,19:07:28,20:59:03,1/19/2021,70582482,245.41,5,Walk surface exist meet thus ground easy. Nation already sign part low down. Trade fine field artist.,20:01:33,CARDS
CUHL01704932377151,GB91DITZ74834780737967,4/4/2017,28541.31,100002,N,Credited,MI,MOBILE,Cr,6:02:14,8:37:24,1/21/2021,81865901,696.33,3,Product traditional conference smile scientist learn. Whom owner week official machine something change. Type old western focus parent present any.,7:51:05,RTGS
CUHL01704932377151,GB91DITZ74834780737967,4/4/2017,29237.64,100002,N,Credited,FF,PC,Cr,8:44:46,11:24:56,1/21/2021,9980136,696.33,1,"Often need decade move firm almost. Action begin mother nothing hour want. General eight face require.
Brother stuff study group ask.",9:41:39,NEFT
CUHL01704932377151,GB91DITZ74834780737967,4/4/2017,28541.31,100002,Y,Dining,IE,PC,Dr,12:14:29,15:09:07,1/21/2021,57915708,696.33,3,"Will reflect everything miss guy. Factor information heart news entire prevent weight. Bank commercial have prepare.
Policy where discuss many class. Hair answer through near let.",14:12:21,RTGS
CUHL01704932377151,GB91DITZ74834780737967,4/4/2017,29237.64,100002,N,Credited,SAFARI,PC,Cr,14:44:27,17:51:26,1/21/2021,36750474,696.33,2,"Admit toward treat local protect also. Like first stage explain meet.
Through federal responsibility whom finally the.
Half live the message. There meet often citizen contain clearly ready.",16:11:23,IMPS
CUHL01704932377151,GB91DITZ74834780737967,4/4/2017,29933.97,100002,N,Credited,MI,MOBILE,Cr,19:30:20,21:21:03,1/21/2021,60404251,696.33,2,"Charge next resource real still floor author.
Blue all cause establish statement. Former investment perhaps successful half begin fill.",20:27:11,IMPS
CUHL01704932377151,GB91DITZ74834780737967,4/4/2017,31308.2,100002,N,Credited,OPERA,POS,Cr,16:45:02,25:44:24,1/25/2021,25106114,1374.23,1,"Ask citizen PM reduce write.
American spring present because off. Buy whom thought company society series.",21:18:48,NEFT
CUHL01704932377151,GB91DITZ74834780737967,4/4/2017,32491.45,100002,N,Credited,CHROME,POS,Cr,5:35:09,9:41:27,2/2/2021,13554019,1183.25,7,"Traditional option those lose.
Movie response often not.
Inside to that audience. Center director bed far many green maintain attorney. Wall indicate agreement thus.",7:48:53,DD
CUHL01704932377151,GB91DITZ74834780737967,4/4/2017,31308.2,100002,Y,Entertainment,OPERA,PC,Dr,11:57:51,13:54:05,2/2/2021,11804178,1183.25,7,"Available can site thought. Peace believe line. Down throughout those high open.
Apply simple business garden by and. Speech reflect common away. Keep call sing relationship most strategy.",12:46:32,DD
CUHL01704932377151,GB91DITZ74834780737967,4/4/2017,32491.45,100002,N,Credited,FF,POS,Cr,19:32:34,22:44:39,2/2/2021,74688982,1183.25,2,Just wish capital behavior call. Tough true lot performance wall both plan. Pressure agreement stay major miss pull pick.,21:54:21,IMPS
CUHL01704932377151,GB91DITZ74834780737967,4/4/2017,32243.61,100002,Y,Personal Care,OPERA,PC,Dr,4:24:58,7:59:20,2/7/2021,30343863,247.84,5,Character determine second vote later interest lay. Analysis total political listen. Control fly free leave leave her.,5:40:12,CARDS
CUHL01704932377151,GB91DITZ74834780737967,4/4/2017,32491.45,100002,N,Credited,IE,MOBILE,Cr,8:48:29,11:56:25,2/7/2021,2951010,247.84,2,Fine report project spring unit age why cover. Few area store wife sell store success nice.,10:52:05,IMPS
CUHL01704932377151,GB91DITZ74834780737967,4/4/2017,32243.61,100002,Y,Insurance,FF,MOBILE,Dr,16:55:40,20:04:48,2/7/2021,45851889,247.84,4,"With matter shoulder really market. Nor rule eye meet development.
Everyone research subject public race most. That ok Congress pressure reflect. Make meeting past during detail.",18:47:07,UPI
CUHL01704932377151,GB91DITZ74834780737967,4/4/2017,31995.77,100002,Y,Transportation,SAFARI,PC,Dr,17:41:28,21:43:22,2/7/2021,69236846,247.84,2,Work provide material risk responsibility. Star front enter nation stay food meet fire. Pm suggest customer personal large usually like million. Source home media for several easy window participant.,20:02:51,IMPS
CUHL01704932377151,GB91DITZ74834780737967,4/4/2017,31441.3,100002,Y,Online Shopping,OPERA,MOBILE,Dr,6:11:23,8:45:25,2/8/2021,93024525,554.47,4,"Fish page today different their central. Bad likely serious line attack item dark. Instead bag impact country she world.
Coach role any agree be. Memory husband over range appear perhaps once.",7:49:25,UPI
CUHL01704932377151,GB91DITZ74834780737967,4/4/2017,31995.77,100002,N,Credited,FF,PC,Cr,8:10:35,10:38:05,2/8/2021,99844103,554.47,3,"Why public per perform expert pattern alone boy. Condition director project marriage thank want address.
Include win raise worker next. Else Congress world. Father deal serve experience late.",10:05:46,RTGS
CUHL01704932377151,GB91DITZ74834780737967,4/4/2017,31441.3,100002,Y,Medicals,MI,MOBILE,Dr,14:44:24,17:09:05,2/8/2021,79404204,554.47,1,"Write major have inside three west animal each. West thought cell occur sometimes size season.
Student news fast sea reduce have answer question. Stand add strong full over.",15:18:02,NEFT
CUHL01704932377151,GB91DITZ74834780737967,4/4/2017,31995.77,100002,N,Credited,IE,POS,Cr,16:37:24,18:34:41,2/8/2021,23248144,554.47,4,"Boy lot fly explain run star. Series field use stay actually list school.
Trouble sometimes cut no site. Put speak together.",17:05:01,UPI
CUHL01704932377151,GB91DITZ74834780737967,4/4/2017,31441.3,100002,Y,Personal Care,CHROME,MOBILE,Dr,20:11:23,22:00:22,2/8/2021,26517933,554.47,5,"Activity technology audience tonight create. Risk air dog low among every.
Order lay away others shoulder paper raise range. Edge room technology current music news political right.",21:12:39,CARDS
CUHL01704932377151,GB91DITZ74834780737967,4/4/2017,29631.83,100002,Y,Insurance,SAFARI,PC,Dr,5:00:02,6:23:22,2/11/2021,31681650,1809.47,4,"Religious clear bring employee. Read draw notice general.
Mother hear American into. Congress course himself picture hard education. Why term oil activity nice.",5:24:33,UPI
CUHL01704932377151,GB91DITZ74834780737967,4/4/2017,27822.36,100002,Y,Insurance,EDGE,MOBILE,Dr,10:07:07,11:39:25,2/11/2021,50372744,1809.47,1,"Care choice physical together. Cultural surface popular them east material.
Computer until community skill attention instead development. Wall full enjoy music point enough plan.",10:45:40,NEFT
CUHL01704932377151,GB91DITZ74834780737967,4/4/2017,29631.83,100002,N,Credited,CHROME,PC,Cr,11:36:41,13:51:31,2/11/2021,73726753,1809.47,6,"Quality administration training expect. Religious start fund save media bank amount around.
Both should thought try give foot. Store pretty cut when compare wish toward.",12:33:00,CHEQUE
CUHL01704932377151,GB91DITZ74834780737967,4/4/2017,31441.3,100002,N,Credited,SAFARI,MOBILE,Cr,16:55:19,19:09:37,2/11/2021,26849041,1809.47,3,"Girl attorney spring commercial media. Majority phone necessary training community. Data require at thousand.
Price others face result manager natural enough. Debate reason chair history.",17:54:18,RTGS
CUHL01704932377151,GB91DITZ74834780737967,4/4/2017,29631.83,100002,Y,Utilities,CHROME,MOBILE,Dr,19:56:04,23:13:18,2/11/2021,55106184,1809.47,1,Nothing begin little star since. Know make none account become. World strong tax threat.,21:13:53,NEFT
CUHL01704932377151,GB91DITZ74834780737967,4/4/2017,27875.94,100002,Y,Entertainment,EDGE,POS,Dr,11:33:09,18:12:38,2/16/2021,96389331,1755.89,3,"Skill than nice clear just several. Process measure unit trip. Responsibility hard my wind compare black together.
Model far picture human history more. Song social any high.",15:25:23,RTGS
CUHL01704932377151,GB91DITZ74834780737967,4/4/2017,26120.05,100002,Y,Medicals,OPERA,MOBILE,Dr,22:43:59,25:54:40,2/16/2021,16597044,1755.89,4,System political particularly successful. Study along party effort indeed nor well. Here pull reason perhaps likely culture.,23:50:49,UPI
CUHL01704932377151,GB91DITZ74834780737967,4/4/2017,28014.09,100002,N,Credited,OPERA,POS,Cr,3:24:28,7:35:04,2/17/2021,81066063,1894.04,4,"Teacher treatment spend and son total police close. Allow eye forward. Within small thing because nor.
Daughter head name town politics affect continue guess. Central green woman. Lead late front.",5:42:33,UPI
CUHL01704932377151,GB91DITZ74834780737967,4/4/2017,29908.13,100002,N,Credited,MI,PC,Cr,11:27:45,14:08:11,2/17/2021,78185487,1894.04,6,"Still story finally wear I special instead. Avoid yet many drug I young. Lay piece then.
Forward country remember camera. Girl success president nature major interesting.",12:46:18,CHEQUE
CUHL01704932377151,GB91DITZ74834780737967,4/4/2017,31802.17,100002,N,Credited,CHROME,PC,Cr,16:25:19,20:02:05,2/17/2021,10208656,1894.04,6,Seven traditional imagine performance your yet recognize summer. Tend just within former girl friend.,18:35:41,CHEQUE
CUHL01704932377151,GB91DITZ74834780737967,4/4/2017,33696.21,100002,N,Credited,IE,MOBILE,Cr,18:04:54,21:56:48,2/17/2021,29876365,1894.04,5,"Rate away voice price. Member federal box mean finally. Off future occur any region.
Dog ok contain understand us. Later social range lay last material else.",19:53:33,CARDS
CUHL01704932377151,GB91DITZ74834780737967,4/4/2017,31745.05,100002,Y,Personal Care,MI,PC,Dr,10:41:47,15:45:57,2/19/2021,23438507,1951.16,7,Election since truth recent. Couple certain meeting health.,13:37:20,DD
CUHL01704932377151,GB91DITZ74834780737967,4/4/2017,29793.89,100002,Y,Utilities,OPERA,POS,Dr,20:53:48,26:18:51,2/19/2021,14911019,1951.16,7,Effect security contain card season money speech. Often knowledge return another mouth some but. Save join paper protect friend.,23:15:14,DD
CUHL01704932377151,GB91DITZ74834780737967,4/4/2017,30049.84,100002,N,Credited,IE,POS,Cr,3:03:33,5:50:53,2/27/2021,7711084,255.95,5,Material voice drop plant shake recently feeling. Class maintain management do reduce. Special dinner around travel participant statement. Little agreement hotel animal system return include.,4:10:12,CARDS
CUHL01704932377151,GB91DITZ74834780737967,4/4/2017,30305.79,100002,N,Credited,EDGE,PC,Cr,7:51:01,10:02:53,2/27/2021,29832934,255.95,2,"Unit image coach toward put ten yard. Rather make light other attention.
Pick former big. Central draw get strong test.",8:49:32,IMPS
CUHL01704932377151,GB91DITZ74834780737967,4/4/2017,30049.84,100002,Y,Medicals,CHROME,MOBILE,Dr,12:00:15,14:06:40,2/27/2021,30343283,255.95,3,"Write point audience unit. Across total a.
Administration fly player wall. Special discussion good behind allow meet.",12:24:35,RTGS
CUHL01704932377151,GB91DITZ74834780737967,4/4/2017,30305.79,100002,N,Credited,CHROME,PC,Cr,14:51:54,18:11:55,2/27/2021,34598320,255.95,1,"Reach sound feel move window run home.
Test factor parent again training leave very event. Wall four each.
Suddenly girl truth role court. Physical performance measure can three.",16:32:54,NEFT
CUHL01704932377151,GB91DITZ74834780737967,4/4/2017,30561.74,100002,N,Credited,CHROME,POS,Cr,20:56:47,23:34:23,2/27/2021,14594120,255.95,1,"Player how attorney win other improve. Approach skill value feeling.
Keep reason a increase list. Shoulder tough Republican continue guess.",22:11:55,NEFT
CUHL01704932377151,GB91DITZ74834780737967,4/4/2017,30230.41,100002,Y,Dining,FF,POS,Dr,3:20:39,5:12:36,2/28/2021,60809308,331.33,7,"Herself science early price. Different it enough American day. So president agency fear serve seek west mission.
Especially picture total catch special rule. Though remain wide account ok.",4:40:24,DD
CUHL01704932377151,GB91DITZ74834780737967,4/4/2017,30561.74,100002,N,Credited,EDGE,PC,Cr,8:01:37,9:57:00,2/28/2021,65330081,331.33,6,"Sister amount need throw somebody thing. His eight manager which performance.
Cup indeed design get.
Risk site thank fish discuss. Chance work order. Fund pay available activity there.",8:32:20,CHEQUE
CUHL01704932377151,GB91DITZ74834780737967,4/4/2017,30893.07,100002,N,Credited,MI,MOBILE,Cr,14:08:01,15:46:55,2/28/2021,72322314,331.33,2,"Back unit market. Figure short door you clear dinner friend boy. Message enter serious.
Consumer customer operation prevent glass main cost. Computer church return.",15:07:27,IMPS
CUHL01704932377151,GB91DITZ74834780737967,4/4/2017,30561.74,100002,Y,Entertainment,OPERA,MOBILE,Dr,17:38:24,18:40:44,2/28/2021,39363480,331.33,1,Identify up science always air. Black speech star reflect water firm. Serious food suffer most apply dream.,18:04:08,NEFT
CUHL01704932377151,GB91DITZ74834780737967,4/4/2017,30230.41,100002,Y,Dining,CHROME,MOBILE,Dr,21:36:19,24:44:14,2/28/2021,3669556,331.33,6,"Tend edge fine long before executive suddenly. Rest watch quality affect listen win word must.
Expect from there. News reduce just space kitchen capital. Resource between her.",23:08:13,CHEQUE
CUHL01704932377151,GB91DITZ74834780737967,4/4/2017,31251.94,100002,N,Credited,EDGE,POS,Cr,14:26:27,21:35:29,3/8/2021,40520780,1021.53,5,"Budget feeling happy worker.
Activity long third light stuff personal. One plan kid. Carry address two week may senior prepare.",16:52:04,CARDS
CUHL01704932377151,GB91DITZ74834780737967,4/4/2017,32684.96,100002,N,Credited,FF,PC,Cr,6:15:19,8:41:11,3/9/2021,61779839,1433.02,4,Company product attack from but region. Direction much nature health. Hard young chair even unit fall as. Professor election nation hard building president.,7:33:51,UPI
CUHL01704932377151,GB91DITZ74834780737967,4/4/2017,34117.98,100002,N,Credited,SAFARI,MOBILE,Cr,8:38:07,10:28:14,3/9/2021,77988522,1433.02,7,"Never evening last young building another impact. Consumer around wear strategy difference. Myself western business full adult.
Even about answer attack. Traditional everyone run reach everyone key.",9:51:49,DD
CUHL01704932377151,GB91DITZ74834780737967,4/4/2017,35551,100002,N,Credited,MI,MOBILE,Cr,12:21:36,15:22:44,3/9/2021,5636914,1433.02,7,"Might red bank big sense. Coach could north miss. Discuss free force.
Almost reflect space answer weight put citizen.
Site care cause result. Rate thank sing situation clearly on.",14:04:17,DD
CUHL01704932377151,GB91DITZ74834780737967,4/4/2017,34117.98,100002,Y,Transportation,MI,PC,Dr,17:42:45,18:46:24,3/9/2021,585682,1433.02,6,"Free rather he thus. Themselves finally produce middle media only. Do figure great first stock sure.
Lawyer help start try never source seat. Those pass fill analysis health may fund.",18:13:31,CHEQUE
CUHL01704932377151,GB91DITZ74834780737967,4/4/2017,32684.96,100002,Y,Rent,CHROME,POS,Dr,21:55:57,24:02:09,3/9/2021,15480705,1433.02,6,"Field action thank.
Truth defense close above. Somebody lot threat here similar number. Hotel just view.
Enjoy respond defense. Wait story conference prevent sometimes produce.",23:22:17,CHEQUE
CUHL01704932377151,GB91DITZ74834780737967,4/4/2017,34089.04,100002,N,Credited,FF,PC,Cr,6:28:56,10:14:19,3/10/2021,61765689,1404.08,1,"Our power program benefit force morning. Newspaper down region. I eight today test.
Find traditional movement young. Tax miss every position speak each. At picture kid political fall keep.",8:17:25,NEFT
CUHL01704932377151,GB91DITZ74834780737967,4/4/2017,32684.96,100002,Y,Transportation,CHROME,POS,Dr,14:49:50,17:56:45,3/10/2021,38080517,1404.08,2,"Management every perhaps rule everything yard surface wait.
Hospital hard finish financial. Person budget one create focus brother will.",17:09:26,IMPS
CUHL01704932377151,GB91DITZ74834780737967,4/4/2017,31280.88,100002,Y,Rent,SAFARI,PC,Dr,16:21:26,20:37:27,3/10/2021,89830642,1404.08,1,"Rate number likely modern. International even tax.
Sure stay customer. Site issue foot medical. Sport clearly parent agency executive could name.",19:02:29,NEFT
CUHL01704932377151,GB91DITZ74834780737967,4/4/2017,30674.85,100002,Y,Dining,CHROME,MOBILE,Dr,8:03:39,12:26:11,3/17/2021,51667740,606.03,3,"Charge alone theory. Many bill start summer town.
Short no night stage quickly. Single unit apply.
Mother among half success soon without language note.",10:15:29,RTGS
CUHL01704932377151,GB91DITZ74834780737967,4/4/2017,30068.82,100002,Y,Entertainment,MI,POS,Dr,11:24:44,14:42:44,3/17/2021,39427502,606.03,3,Consider occur military since election through TV. Structure public mother unit I research born. Strong according suffer head.,13:03:37,RTGS
CUHL01704932377151,GB91DITZ74834780737967,4/4/2017,29462.79,100002,Y,Dining,EDGE,POS,Dr,18:12:07,21:28:25,3/17/2021,62519373,606.03,2,"Professional yeah reduce for prepare necessary customer.
Class image whole brother forward. Avoid important word my. Voice require bring more phone.
Have base avoid.",19:45:39,IMPS
CUHL01704932377151,GB91DITZ74834780737967,4/4/2017,29565.73,100002,N,Credited,EDGE,MOBILE,Cr,4:17:09,6:53:14,3/23/2021,22068088,102.94,1,"Me ball daughter if special sell.
Off contain including get. Local nothing size already experience. Cultural bar lawyer experience he.
Amount power partner. Prevent series soon play image alone any.",6:04:26,NEFT
CUHL01704932377151,GB91DITZ74834780737967,4/4/2017,29668.67,100002,N,Credited,IE,MOBILE,Cr,7:10:56,9:56:28,3/23/2021,3640012,102.94,3,"Clear hospital hard argue collection red already. Budget upon lay result one realize under. Think until avoid national turn artist fill.
History then why agent structure girl.",8:05:35,RTGS
CUHL01704932377151,GB91DITZ74834780737967,4/4/2017,29771.61,100002,N,Credited,CHROME,POS,Cr,11:23:34,12:34:46,3/23/2021,13299828,102.94,5,"From spend him use. Fast accept so list model boy attorney citizen. Success doctor evening anyone range machine difference.
Though southern building four treat behind. Local close like.",12:09:56,CARDS
CUHL01704932377151,GB91DITZ74834780737967,4/4/2017,29874.55,100002,N,Credited,MI,POS,Cr,16:31:23,19:43:38,3/23/2021,55866408,102.94,7,"Maintain history Democrat similar more while employee. More increase each forget. Book on work want sure send network.
Rest quickly help. Ability story recognize.",18:18:01,DD
CUHL01704932377151,GB91DITZ74834780737967,4/4/2017,29771.61,100002,Y,Personal Care,FF,PC,Dr,22:44:39,25:49:08,3/23/2021,41037263,102.94,5,Theory former check effort memory too kitchen. Enjoy think develop yourself great camera.,23:50:37,CARDS
CUHL01704932377151,GB91DITZ74834780737967,4/4/2017,28088.3,100002,Y,Medicals,CHROME,POS,Dr,12:15:53,16:07:38,4/2/2021,84436450,1683.31,3,"Democratic tax growth color difficult. Always several address. Yes drop image involve relationship question.
Leave help fear whole history affect. Win write my house record fast throughout.",13:25:17,RTGS
CUHL01704932377151,GB91DITZ74834780737967,4/4/2017,29771.61,100002,N,Credited,IE,POS,Cr,16:29:18,20:54:58,4/2/2021,5097036,1683.31,4,"Better wide about let stand. Study former across wife. Cultural consumer forward what have involve.
Recent wall their maintain theory strategy. Event specific travel development.",18:37:20,UPI
CUHL01704932377151,GB91DITZ74834780737967,4/4/2017,29684.84,100002,Y,Entertainment,FF,MOBILE,Dr,4:40:27,8:39:18,4/7/2021,45321733,86.77,3,"Thus suffer of success land forward. Tell office hold likely pretty. Call quickly night station.
Stand partner rule smile. Not provide message article play manage ground.",7:14:21,RTGS
CUHL01704932377151,GB91DITZ74834780737967,4/4/2017,29598.07,100002,Y,Medicals,IE,MOBILE,Dr,12:51:40,17:38:23,4/7/2021,36006427,86.77,4,Suffer several within reduce herself opportunity professor. Cover to daughter girl from.,15:10:12,UPI
CUHL01704932377151,GB91DITZ74834780737967,4/4/2017,29684.84,100002,N,Credited,IE,MOBILE,Cr,20:41:10,25:22:11,4/7/2021,7493935,86.77,5,Source show administration. Loss deal necessary player. Card natural sure affect citizen various.,22:55:55,CARDS
CUHL01704932377151,GB91DITZ74834780737967,4/4/2017,30821.09,100002,N,Credited,FF,POS,Cr,3:59:51,7:52:29,4/8/2021,40823461,1136.25,2,Water mission only building hundred executive.,5:54:54,IMPS
CUHL01704932377151,GB91DITZ74834780737967,4/4/2017,31957.34,100002,N,Credited,FF,MOBILE,Cr,8:49:23,13:17:54,4/8/2021,58672815,1136.25,2,South skin old success capital statement. Employee would month away oil physical wind. Mission sometimes at system. Describe human relationship two.,11:11:37,IMPS
CUHL01704932377151,GB91DITZ74834780737967,4/4/2017,33093.59,100002,N,Credited,MI,POS,Cr,14:34:53,17:03:44,4/8/2021,95295473,1136.25,4,General figure prove. Must role person season interview. Specific become organization sea. Nor next question.,15:33:08,UPI
CUHL01704932377151,GB91DITZ74834780737967,4/4/2017,31957.34,100002,Y,Groceries,IE,MOBILE,Dr,21:30:14,24:43:21,4/8/2021,35816317,1136.25,3,Push whose unit cell. Operation building stuff environmental price that present. School entire leave low music certainly apply by.,22:31:15,RTGS
CUHL01704932377151,GB91DITZ74834780737967,4/4/2017,31314.94,100002,Y,Groceries,CHROME,PC,Dr,5:14:02,8:22:29,4/13/2021,32545920,642.4,7,Again school throughout everyone you different. Push ten part film through growth. Increase others research fast better. Require use official simple figure economic study.,6:11:23,DD
CUHL01704932377151,GB91DITZ74834780737967,4/4/2017,31957.34,100002,N,Credited,OPERA,PC,Cr,14:19:03,17:27:56,4/13/2021,93529570,642.4,1,"Yeah any serious yeah. Course far figure type spring son relate accept.
Down sign another letter. Realize across near item research. Perform different remain participant road reality whole culture.",15:17:10,NEFT
CUHL01704932377151,GB91DITZ74834780737967,4/4/2017,32599.74,100002,N,Credited,EDGE,MOBILE,Cr,16:17:18,18:44:38,4/13/2021,36241804,642.4,2,Bank might strategy than law buy material. Toward bill pass able. Seat event article nice forget different teach line.,18:06:39,IMPS
CUHL01704932377151,GB91DITZ74834780737967,4/4/2017,30890.16,100002,Y,Groceries,EDGE,POS,Dr,14:40:14,20:48:44,4/14/2021,65884263,1709.58,1,"Ask medical bar dog mind PM. Their appear true several.
Stop young live bank economy total network. Single again trade process recent very. Article design they beautiful generation.",19:33:05,NEFT
CUHL01704932377151,GB91DITZ74834780737967,4/4/2017,30563.75,100002,Y,Medicals,OPERA,PC,Dr,3:29:04,7:23:05,5/8/2021,25822595,326.41,5,"Green their politics position any ask design. Position fact keep it show training.
Risk economy tough store. Between keep over top degree Mr. Property black recent skill morning.
Bed down cause line.",5:13:21,CARDS
CUHL01704932377151,GB91DITZ74834780737967,4/4/2017,30890.16,100002,N,Credited,OPERA,PC,Cr,8:23:44,11:59:39,5/8/2021,6817824,326.41,3,"Occur girl hit feeling professional. Boy there whose. Office star spend sister interview.
Cause above stand once she once never. Standard to fall when military.",10:07:44,RTGS
CUHL01704932377151,GB91DITZ74834780737967,4/4/2017,30563.75,100002,Y,Household Consumables,OPERA,POS,Dr,16:20:55,19:31:11,5/8/2021,43354450,326.41,5,Management executive threat knowledge. Institution voice world until win stage at. Learn new your building.,18:38:23,CARDS
CUHL01704932377151,GB91DITZ74834780737967,4/4/2017,30237.34,100002,Y,Personal Care,CHROME,MOBILE,Dr,19:45:26,21:41:21,5/8/2021,37125875,326.41,2,Enough he brother never may. Also drive performance effort reflect shoulder. Skill human coach. Network line teacher stock result.,20:18:50,IMPS
CUHL01704932377151,GB91DITZ74834780737967,4/4/2017,29584.59,100002,Y,Household Consumables,SAFARI,POS,Dr,6:07:36,11:12:33,5/10/2021,69280269,652.75,6,"Budget agreement current voice light. Resource many knowledge cover wish. Central note strong leg analysis Democrat test.
Give drop key capital.",8:26:26,CHEQUE
CUHL01704932377151,GB91DITZ74834780737967,4/4/2017,28931.84,100002,Y,Insurance,IE,PC,Dr,15:31:26,22:21:14,5/10/2021,42568896,652.75,7,"Several now garden improve. Lose partner ask. Along common six.
Look light measure candidate skin within. Life support base.
Fill might think knowledge these.",19:07:37,DD
CUHL01704932377151,GB91DITZ74834780737967,4/4/2017,29199.88,100002,N,Credited,IE,POS,Cr,3:27:01,7:57:28,5/12/2021,56230598,268.04,3,"Whom simple benefit church. Others president bank sign age. So good down.
Newspaper major son probably lose. Someone interesting suddenly social whom lay.",5:47:45,RTGS
CUHL01704932377151,GB91DITZ74834780737967,4/4/2017,29467.92,100002,N,Credited,EDGE,POS,Cr,9:07:15,11:17:44,5/12/2021,28582175,268.04,7,"Ago week sea age explain. Now dinner information rest.
Institution majority voice record actually minute. Degree opportunity particularly first then.",10:39:29,DD
CUHL01704932377151,GB91DITZ74834780737967,4/4/2017,29735.96,100002,N,Credited,SAFARI,POS,Cr,14:18:16,16:39:43,5/12/2021,60254917,268.04,1,"Able Mr might factor dark hospital. American piece project boy attorney environmental million.
Character day how sort system expect group on. Ready million investment wind.",16:10:10,NEFT
CUHL01704932377151,GB91DITZ74834780737967,4/4/2017,30004,100002,N,Credited,EDGE,MOBILE,Cr,21:26:37,24:53:05,5/12/2021,75743154,268.04,7,"Guy actually full until speech size party. Cost cost popular candidate resource the.
Cause friend whole stage price. Near blue week hold cause last southern.",22:54:41,DD
CUHL01704932377151,GB91DITZ74834780737967,4/4/2017,28976.1,100002,Y,Household Consumables,SAFARI,MOBILE,Dr,8:11:16,12:23:25,5/15/2021,98632701,1027.9,3,"Range agree case argue. Door fish occur him firm Mrs beyond. Up seem door.
Step field quite someone information energy direction offer. Account number glass accept interest model can hold.",10:56:17,RTGS
CUHL01704932377151,GB91DITZ74834780737967,4/4/2017,27948.2,100002,Y,Medicals,CHROME,POS,Dr,18:23:38,22:49:11,5/15/2021,35604198,1027.9,4,"Billion risk street last. Note data could process hold probably only. Security she yes.
Office laugh evidence offer power. Write plant rather. Voice opportunity pull then color.",19:34:28,UPI
CUHL01704932377151,GB91DITZ74834780737967,4/4/2017,29170.6,100002,N,Credited,SAFARI,PC,Cr,7:22:52,9:01:09,5/19/2021,43062119,1222.4,4,Large return best hit explain matter. Wrong occur building man how fund enough ahead.,8:01:30,UPI
CUHL01704932377151,GB91DITZ74834780737967,4/4/2017,27948.2,100002,Y,Groceries,EDGE,MOBILE,Dr,14:15:54,19:08:35,5/19/2021,39263995,1222.4,5,"Past much note organization analysis personal.
Stop research sea building. Themselves kind from although.",17:00:38,CARDS
CUHL01704932377151,GB91DITZ74834780737967,4/4/2017,29170.6,100002,N,Credited,FF,POS,Cr,17:08:56,21:33:43,5/19/2021,45079016,1222.4,3,Difficult area expect support west. Market tree arm reality with small focus part. Country during let. Let receive east what recent bar action.,19:01:09,RTGS
CUHL01704932377151,GB91DITZ74834780737967,4/4/2017,30254.8,100002,N,Credited,MI,MOBILE,Cr,12:59:04,18:10:03,5/22/2021,23202924,1084.2,7,Democratic personal quite no strategy. Represent item that ago letter writer. Common visit far ahead issue.,16:02:54,DD
CUHL01704932377151,GB91DITZ74834780737967,4/4/2017,29883.06,100002,Y,Dining,IE,POS,Dr,12:14:09,14:05:06,5/28/2021,6395322,371.74,3,Bag building fact. After nation indicate white value. Several wall fill imagine. Summer official commercial high.,13:13:03,RTGS
CUHL01704932377151,GB91DITZ74834780737967,4/4/2017,29511.32,100002,Y,Rent,OPERA,POS,Dr,20:07:18,23:17:59,5/28/2021,13674588,371.74,3,Place rate picture become check hope. Exactly score hand sure meeting administration next door.,21:40:30,RTGS
CUHL01704932377151,GB91DITZ74834780737967,4/4/2017,30212.44,100002,N,Credited,EDGE,PC,Cr,5:06:50,8:11:30,5/31/2021,9353022,701.12,2,Family economic law night. Food face where rock cell.,6:22:00,IMPS
CUHL01704932377151,GB91DITZ74834780737967,4/4/2017,29511.32,100002,Y,Household Consumables,OPERA,PC,Dr,8:25:20,10:07:17,5/31/2021,4037163,701.12,2,Move paper southern year. Unit something believe quickly face your answer. Discover support become professor.,9:43:13,IMPS
CUHL01704932377151,GB91DITZ74834780737967,4/4/2017,30212.44,100002,N,Credited,EDGE,MOBILE,Cr,12:41:22,15:02:47,5/31/2021,79636599,701.12,1,"We main detail agreement take. Drop when in game coach.
Future operation control hair. Main value serve.",13:46:18,NEFT
CUHL01704932377151,GB91DITZ74834780737967,4/4/2017,29511.32,100002,Y,Insurance,FF,POS,Dr,15:22:38,18:17:47,5/31/2021,33085845,701.12,3,"Benefit write industry old end enter road. Big bar cover court fish account make. Whole piece indeed another on.
Before record require meeting senior writer.",17:07:03,RTGS
CUHL01704932377151,GB91DITZ74834780737967,4/4/2017,28810.2,100002,Y,Utilities,EDGE,POS,Dr,22:08:43,25:40:42,5/31/2021,12495436,701.12,3,Figure meet particularly responsibility thank. Officer know bill world activity. Hand method American nor clearly perhaps begin movie.,23:58:39,RTGS
CUHL01704932377151,GB91DITZ74834780737967,4/4/2017,29634.95,100002,N,Credited,FF,POS,Cr,5:14:40,8:20:13,6/12/2021,2266695,824.75,4,"It church business popular. Size kind food realize east option.
East economic relate war.",6:21:00,UPI
CUHL01704932377151,GB91DITZ74834780737967,4/4/2017,28810.2,100002,Y,Medicals,FF,POS,Dr,7:20:34,10:06:10,6/12/2021,21877964,824.75,4,"Him assume certainly moment nor all ability model.
Lot buy enter kind explain. Total art the home indeed from toward. Pm officer raise well tend. View thus thousand body.",8:50:26,UPI
CUHL01704932377151,GB91DITZ74834780737967,4/4/2017,29634.95,100002,N,Credited,OPERA,POS,Cr,11:46:59,14:04:46,6/12/2021,93667715,824.75,6,Professor second short many energy. South beyond understand computer easy lead even. Produce attack save ask nation production interview large.,13:21:40,CHEQUE
CUHL01704932377151,GB91DITZ74834780737967,4/4/2017,28810.2,100002,Y,Groceries,EDGE,MOBILE,Dr,15:55:57,17:22:43,6/12/2021,82110192,824.75,4,Play least care myself office maybe unit. Third against apply human culture recognize suddenly. Front short gas fill group team cover. Case market throughout only.,16:58:40,UPI
CUHL01704932377151,GB91DITZ74834780737967,4/4/2017,27985.45,100002,Y,Utilities,OPERA,PC,Dr,19:29:42,21:09:39,6/12/2021,13540760,824.75,1,Case paper follow yeah place talk adult. Knowledge production all throughout may shoulder peace. Interview different individual safe appear focus mind.,20:11:07,NEFT
CUHL01704932377151,GB91DITZ74834780737967,4/4/2017,29867.76,100002,N,Credited,FF,PC,Cr,5:05:01,7:58:29,6/16/2021,36900244,1882.31,2,"Draw difference pattern success season network. Group safe wrong.
Anything do pick a sense bill prepare. Stock even most product success. Cold about join begin community control.",7:15:23,IMPS
CUHL01704932377151,GB91DITZ74834780737967,4/4/2017,31750.07,100002,N,Credited,SAFARI,MOBILE,Cr,10:45:28,12:44:54,6/16/2021,14413056,1882.31,1,"Generation executive better enter laugh why magazine. Experience than price education relationship help.
Maybe when source move find citizen goal tax. Fill as sing him local set different.",11:48:23,NEFT
CUHL01704932377151,GB91DITZ74834780737967,4/4/2017,33632.38,100002,N,Credited,FF,POS,Cr,17:14:09,20:21:01,6/16/2021,49258554,1882.31,4,Same body region everyone director industry stay. Read speech else training several worker. Economic fight cover hand throughout as trade. Local western serve hard campaign become brother.,17:59:46,UPI
CUHL01704932377151,GB91DITZ74834780737967,4/4/2017,31750.07,100002,Y,Groceries,IE,PC,Dr,17:50:58,21:02:12,6/16/2021,82629953,1882.31,6,Will both thank teach think those through share. Dark election their manager beyond although outside. South either agent analysis.,19:45:53,CHEQUE
CUHL01704932377151,GB91DITZ74834780737967,4/4/2017,29909.11,100002,Y,Utilities,IE,MOBILE,Dr,7:40:53,10:41:03,6/18/2021,74386475,1840.96,7,"Anyone poor life range thought different mouth. Provide attack which discuss social.
Hour family night top stand before space structure. Board officer participant able field shake.",9:34:15,DD
CUHL01704932377151,GB91DITZ74834780737967,4/4/2017,28068.15,100002,Y,Groceries,EDGE,MOBILE,Dr,7:53:15,12:09:07,6/18/2021,9212404,1840.96,3,"Later rich game size number by week.
Woman attorney he pass mention can. Conference player measure movie challenge. Hair record war according.",9:48:44,RTGS
CUHL01704932377151,GB91DITZ74834780737967,4/4/2017,29909.11,100002,N,Credited,SAFARI,MOBILE,Cr,17:05:44,19:11:14,6/18/2021,57390314,1840.96,7,Account religious important analysis business conference green idea. You more form tax. Approach physical challenge tend.,17:47:17,DD
CUHL01704932377151,GB91DITZ74834780737967,4/4/2017,31750.07,100002,N,Credited,FF,MOBILE,Cr,19:38:09,23:07:23,6/18/2021,78278905,1840.96,5,"Inside left military white spring. Grow relate walk operation.
Effect population over more world music.
Artist use case front save. Use data soldier require enjoy hotel west again.",21:54:39,CARDS
CUHL01704932377151,GB91DITZ74834780737967,4/4/2017,31245.75,100002,Y,Entertainment,SAFARI,PC,Dr,11:41:35,21:47:10,6/26/2021,68713218,504.32,5,Before article consumer run note. Race find decision represent local really because see. Suffer skin budget professor north technology likely.,17:38:27,CARDS
CUHL01704932377151,GB91DITZ74834780737967,4/4/2017,32906.32,100002,N,Credited,CHROME,MOBILE,Cr,4:10:26,6:59:38,6/27/2021,47791671,1660.57,2,Professional minute statement. Of receive act ground race ever audience. Improve movie home late shake compare yard. Chair course its step spring move same million.,5:53:48,IMPS
CUHL01704932377151,GB91DITZ74834780737967,4/4/2017,34566.89,100002,N,Credited,OPERA,PC,Cr,10:33:28,13:31:33,6/27/2021,68711436,1660.57,4,"Reality program wrong effect. Certain forget third loss. Student past international may walk.
Three help appear somebody how off crime song. Bed side effect beat.",11:36:04,UPI
CUHL01704932377151,GB91DITZ74834780737967,4/4/2017,32906.32,100002,Y,Online Shopping,CHROME,PC,Dr,14:43:59,16:23:23,6/27/2021,97174561,1660.57,6,"Operation our whatever general dog only think.
Song generation indicate total stock network perform. Page business news ball want join create. Suddenly top budget herself imagine Republican.",15:11:53,CHEQUE
CUHL01704932377151,GB91DITZ74834780737967,4/4/2017,31245.75,100002,Y,Entertainment,FF,MOBILE,Dr,15:34:01,17:38:42,6/27/2021,78280052,1660.57,5,"Happy tax condition left upon Democrat. Short land research fish own effort.
Station true national memory. Yes cultural professor ok. Piece natural purpose effort edge ask.",16:11:39,CARDS
CUHL01704932377151,GB91DITZ74834780737967,4/4/2017,29585.18,100002,Y,Household Consumables,EDGE,MOBILE,Dr,18:59:02,21:34:17,6/27/2021,88102573,1660.57,4,"Respond possible event career certain. Article few senior standard run computer.
Outside seek story political. Star study ever read.
Pretty may happy to third military. Raise early respond center.",20:27:07,UPI
CUHL01704932377151,GB91DITZ74834780737967,4/4/2017,28652.35,100002,Y,Insurance,EDGE,POS,Dr,5:50:28,6:53:36,7/6/2021,91134646,932.83,3,"Attention star force fear treatment inside.
Surface one continue write particular question. Growth star tree now production fact focus imagine.",6:14:29,RTGS
CUHL01704932377151,GB91DITZ74834780737967,4/4/2017,29585.18,100002,N,Credited,IE,MOBILE,Cr,8:43:37,10:34:56,7/6/2021,71421865,932.83,4,Message suggest new indicate matter. Bring put performance certain change. Author finally could stand most hot authority.,9:56:22,UPI
CUHL01704932377151,GB91DITZ74834780737967,4/4/2017,30518.01,100002,N,Credited,EDGE,MOBILE,Cr,14:29:29,15:57:06,7/6/2021,60902740,932.83,5,"Activity television sister series. System weight strategy his.
Me believe low accept cause. Wish vote factor writer. Material itself price tough eat heavy relationship.",15:18:33,CARDS
CUHL01704932377151,GB91DITZ74834780737967,4/4/2017,29585.18,100002,Y,Medicals,IE,POS,Dr,18:05:24,19:38:04,7/6/2021,90294723,932.83,3,"Government answer music whom practice. Give themselves begin loss trip.
Them already bag approach. Middle bad big free quickly remain home. Head teacher administration rule dream.",19:08:55,RTGS
CUHL01704932377151,GB91DITZ74834780737967,4/4/2017,28652.35,100002,Y,Utilities,SAFARI,PC,Dr,19:58:34,22:01:59,7/6/2021,78307766,932.83,4,"City above order subject especially fly floor score.
Seek mouth training since marriage most even. Range most behavior represent part same relationship.",20:53:17,UPI
CUHL01704932377151,GB91DITZ74834780737967,4/4/2017,30387.94,100002,N,Credited,MI,PC,Cr,3:02:46,5:37:36,7/9/2021,81242672,1735.59,1,"Area Mrs ready. Security spend before so suddenly.
Factor ahead sea become term owner. Campaign culture effort.
Artist either institution behind. Edge sit minute build less.",4:56:12,NEFT
CUHL01704932377151,GB91DITZ74834780737967,4/4/2017,28652.35,100002,Y,Utilities,EDGE,POS,Dr,9:01:19,10:20:46,7/9/2021,38133725,1735.59,3,"Rest future follow. Sell back single ten TV.
However future beat show. Exist area part authority.
Nature who dark nothing long attack.
Rest his for candidate development. First admit place low.",9:28:44,RTGS
CUHL01704932377151,GB91DITZ74834780737967,4/4/2017,30387.94,100002,N,Credited,CHROME,POS,Cr,14:25:12,16:10:04,7/9/2021,13809683,1735.59,6,"Huge woman first success. Table fight to anyone show can onto. Member family subject any return sister.
Enough these become garden keep table. As understand marriage face put less.",15:26:24,CHEQUE
CUHL01704932377151,GB91DITZ74834780737967,4/4/2017,28652.35,100002,Y,Household Consumables,SAFARI,PC,Dr,15:48:28,18:21:51,7/9/2021,99573607,1735.59,2,"Rich debate summer tough Congress.
Model store be trouble ten common kind. Book itself real million score authority. Individual some social any.",17:07:22,IMPS
CUHL01704932377151,GB91DITZ74834780737967,4/4/2017,30387.94,100002,N,Credited,SAFARI,MOBILE,Cr,20:03:19,22:23:05,7/9/2021,57228457,1735.59,1,"View forget cup time hotel. Degree purpose experience democratic very reduce.
Mention center culture morning mention successful. In trouble make never want.",21:44:43,NEFT
CUHL01704932377151,GB91DITZ74834780737967,4/4/2017,28908.07,100002,Y,Personal Care,FF,MOBILE,Dr,16:56:10,23:21:20,7/18/2021,61386679,1479.87,3,"Former should contain story pull partner song. Million and middle no only gas.
Speak well ahead apply wear important. Choose happy few race. Age trial strong.",19:32:50,RTGS
CUHL01704932377151,GB91DITZ74834780737967,4/4/2017,27288.69,100002,Y,Dining,OPERA,PC,Dr,5:28:18,9:06:52,7/19/2021,75861094,1619.38,5,"Head however professional best. Eat action health tonight film your. Chair them rule close.
Policy past try base. Challenge season oil result. Close environment possible enjoy necessary.",7:33:42,CARDS
CUHL01704932377151,GB91DITZ74834780737967,4/4/2017,25669.31,100002,Y,Transportation,CHROME,MOBILE,Dr,11:13:47,13:46:23,7/19/2021,2124926,1619.38,1,"If arm seven go. Institution space sort interesting development technology else long. Role foreign people under central must.
Set into marriage. Say truth TV appear my. Deep morning song.",12:38:54,NEFT
CUHL01704932377151,GB91DITZ74834780737967,4/4/2017,27288.69,100002,N,Credited,CHROME,POS,Cr,15:16:17,17:32:31,7/19/2021,83690754,1619.38,5,Others finish call ball. Between put strong me. Off share poor reach camera cup impact.,16:54:13,CARDS
CUHL01704932377151,GB91DITZ74834780737967,4/4/2017,25669.31,100002,Y,Medicals,SAFARI,POS,Dr,22:07:37,24:33:24,7/19/2021,62372190,1619.38,4,"Table election purpose fund.
Put think ahead. Fall age pressure care particular.
Almost us for career. Total industry computer build each.",23:53:23,UPI
CUHL01704932377151,GB91DITZ74834780737967,4/4/2017,23837.69,100002,Y,Utilities,FF,MOBILE,Dr,7:07:25,9:23:21,7/26/2021,53180230,1831.62,6,Ask lead may issue suggest majority treatment. Data stay star goal here.,7:45:24,CHEQUE
CUHL01704932377151,GB91DITZ74834780737967,4/4/2017,22006.07,100002,Y,Online Shopping,MI,POS,Dr,10:07:34,12:18:12,7/26/2021,25820911,1831.62,5,"But form short. Above fly picture past teacher animal.
Go building attention thank federal avoid. Successful glass environmental man full.",10:33:58,CARDS
CUHL01704932377151,GB91DITZ74834780737967,4/4/2017,23837.69,100002,N,Credited,FF,MOBILE,Cr,13:55:25,15:54:44,7/26/2021,70549584,1831.62,5,"Firm air majority medical on home already. Organization fill central outside.
Owner also cost oil. According deep collection last letter including ball.",14:42:47,CARDS
CUHL01704932377151,GB91DITZ74834780737967,4/4/2017,25669.31,100002,N,Credited,IE,PC,Cr,17:45:43,20:57:11,7/26/2021,55742078,1831.62,2,"Little up hope human process. Current foot success wind onto raise pattern.
Protect five officer gun see.
Him head answer teach baby. Real involve today century all item.",19:04:26,IMPS
CUHL01704932377151,GB91DITZ74834780737967,4/4/2017,23837.69,100002,Y,Online Shopping,SAFARI,PC,Dr,20:43:20,23:01:42,7/26/2021,82066093,1831.62,1,Travel hold compare anything industry. Art feeling reflect hear American seven. Treat alone give five job charge also.,22:15:45,NEFT
CUHL01704932377151,GB91DITZ74834780737967,4/4/2017,23406.52,100002,Y,Utilities,CHROME,PC,Dr,6:21:32,9:08:45,7/28/2021,6724054,431.17,3,"Meeting trip friend prevent nothing organization number. We fact last address this which police.
About investment trial song really. In series pick far. Project across staff hand reason.",7:46:15,RTGS
CUHL01704932377151,GB91DITZ74834780737967,4/4/2017,23837.69,100002,N,Credited,MI,POS,Cr,9:49:59,13:47:10,7/28/2021,507608,431.17,4,Stage prepare group travel cover. Parent market sing front consider in. Model life common worker generation glass official. Yourself people hear six sound bring father.,12:02:02,UPI
CUHL01704932377151,GB91DITZ74834780737967,4/4/2017,23406.52,100002,Y,Insurance,MI,PC,Dr,15:05:16,16:15:25,7/28/2021,16201507,431.17,7,"Avoid thousand participant find kid possible. Leg nation on wind.
Store drive medical indicate. Art glass begin peace media process reduce.",15:43:14,DD
CUHL01704932377151,GB91DITZ74834780737967,4/4/2017,22975.35,100002,Y,Transportation,IE,PC,Dr,20:55:07,25:01:35,7/28/2021,72527832,431.17,6,"Gas visit poor national network.
Yeah ago plan possible spend. Class technology health read stock. Piece trouble fire respond.",22:42:20,CHEQUE
CUHL01704932377151,GB91DITZ74834780737967,4/4/2017,24296.45,100002,N,Credited,FF,POS,Cr,3:12:46,7:01:32,7/29/2021,78663718,1321.1,3,Design record treatment culture stuff. Most memory color sense radio doctor why to. Different more call song quite one environment gun. Different feeling others lead book shoulder collection.,5:12:43,RTGS
CUHL01704932377151,GB91DITZ74834780737967,4/4/2017,22975.35,100002,Y,Household Consumables,MI,MOBILE,Dr,8:53:01,11:01:23,7/29/2021,24386043,1321.1,4,"Weight risk long thank middle loss. Future set sister others choice. Pressure set safe boy stop.
Risk role expect sort fight figure tree.",10:21:20,UPI
CUHL01704932377151,GB91DITZ74834780737967,4/4/2017,21654.25,100002,Y,Dining,SAFARI,POS,Dr,12:10:30,14:20:58,7/29/2021,32524765,1321.1,7,"Thus end stand which data visit white. Before key sing by specific save follow.
Throughout baby court fast.
Almost minute prepare wall enough always point. Table building mouth.",13:19:38,DD
CUHL01704932377151,GB91DITZ74834780737967,4/4/2017,22975.35,100002,N,Credited,SAFARI,PC,Cr,18:59:44,20:28:15,7/29/2021,74808823,1321.1,2,"Oil score scientist nation inside.
Pass mean produce strong experience deal camera. Save itself thing everybody.",19:39:54,IMPS
CUHL01704932377151,GB91DITZ74834780737967,4/4/2017,21654.25,100002,Y,Entertainment,IE,PC,Dr,21:26:23,23:57:59,7/29/2021,97348061,1321.1,2,"Serve police during. Collection foreign nice sign about.
Task environmental chair country real. Talk section community significant. Someone street take its machine discover. Culture shake wrong risk.",23:22:26,IMPS
CUHL01704932377151,GB91DITZ74834780737967,4/4/2017,21566.35,100002,Y,Groceries,SAFARI,PC,Dr,10:41:25,21:46:37,8/9/2021,14307270,87.9,3,"Gas during should direction program woman.
Cold whom while hospital artist position technology. President left ahead author condition treatment.",16:35:55,RTGS
CUHL01704932377151,GB91DITZ74834780737967,4/4/2017,19976.84,100002,Y,Insurance,IE,POS,Dr,7:33:47,9:48:50,8/11/2021,27851531,1589.51,4,"Way include tell ok deal office degree. Head southern decide into choose. Cup field husband woman into could somebody.
Book popular each bank series lot great. Every race talk really.",9:01:52,UPI
CUHL01704932377151,GB91DITZ74834780737967,4/4/2017,21566.35,100002,N,Credited,EDGE,POS,Cr,11:38:30,14:12:25,8/11/2021,92712997,1589.51,3,"Safe ball writer not goal. Money staff work affect race action.
Key final peace great style opportunity.",13:08:16,RTGS
CUHL01704932377151,GB91DITZ74834780737967,4/4/2017,19976.84,100002,Y,Transportation,OPERA,MOBILE,Dr,16:39:21,20:34:50,8/11/2021,82299255,1589.51,4,"Magazine international measure spring. Car lay once final write her. If manage agreement party real.
Thus toward pressure hot industry. Yard fight once first themselves real.",18:32:31,UPI
CUHL01704932377151,GB91DITZ74834780737967,4/4/2017,18387.33,100002,Y,Rent,CHROME,PC,Dr,19:29:08,22:44:18,8/11/2021,10695814,1589.51,3,East various give guess consider paper share. Whatever social article modern. Front deep note TV thought administration.,21:27:42,RTGS
CUHL01704932377151,GB91DITZ74834780737967,4/4/2017,19674.09,100002,N,Credited,OPERA,POS,Cr,13:52:37,17:33:13,8/13/2021,16829633,1286.76,6,Hold life tree include hard discussion little. Concern situation ability whose. Road speak spring role provide. Debate many really she address result.,15:38:46,CHEQUE
CUHL01704932377151,GB91DITZ74834780737967,4/4/2017,20960.85,100002,N,Credited,IE,MOBILE,Cr,15:47:31,17:32:09,8/13/2021,54683952,1286.76,3,Police particularly perform along full radio sort. Majority economy can station capital base interest. Threat table especially local ability yet low.,16:42:34,RTGS
CUHL01704932377151,GB91DITZ74834780737967,4/4/2017,20746.7,100002,Y,Medicals,IE,MOBILE,Dr,3:40:46,6:58:47,8/17/2021,74396481,214.15,3,"Relate collection reach decision left type west role. Whom guess represent dark care writer part generation.
Design room kid recent hand. Fast thousand season provide.",5:11:49,RTGS
CUHL01704932377151,GB91DITZ74834780737967,4/4/2017,20960.85,100002,N,Credited,OPERA,POS,Cr,8:13:22,11:19:02,8/17/2021,36927975,214.15,6,"Court various either his base young. Avoid local say know. Senior front war president guess cost house better.
Phone change movie although body city consider. Player born that view language window.",9:56:00,CHEQUE
CUHL01704932377151,GB91DITZ74834780737967,4/4/2017,21175,100002,N,Credited,FF,POS,Cr,12:23:52,15:29:46,8/17/2021,70631975,214.15,2,Generation pay civil memory drug office likely. Industry send soldier. Mean Republican yet TV worker remain.,13:43:35,IMPS
CUHL01704932377151,GB91DITZ74834780737967,4/4/2017,21389.15,100002,N,Credited,MI,PC,Cr,17:56:06,20:50:34,8/17/2021,98168637,214.15,6,Buy art marriage for food old. Bring no defense red others. Which once or marriage politics sometimes certainly.,19:52:42,CHEQUE
CUHL01704932377151,GB91DITZ74834780737967,4/4/2017,21603.3,100002,N,Credited,CHROME,POS,Cr,21:54:07,24:40:42,8/17/2021,56232943,214.15,1,"Degree nor provide meeting. Stand return if American call serve anyone. Beautiful interview within think off think.
Join everybody plant fine. Hold section go within why benefit begin.",23:40:51,NEFT
CUHL01704932377151,GB91DITZ74834780737967,4/4/2017,21924.36,100002,N,Credited,IE,POS,Cr,7:44:35,17:06:38,8/23/2021,30851283,321.06,3,"Glass call nearly foreign car same. Live per if hit choose.
Far read enjoy. Office us production away night high. Pressure sister eight standard dinner.",13:08:58,RTGS
CUHL01704932377151,GB91DITZ74834780737967,4/4/2017,23856.49,100002,N,Credited,IE,MOBILE,Cr,5:15:02,8:28:40,8/26/2021,40026152,1932.13,6,"Management enter body song management candidate according. Project itself go Congress hard full large anything.
Team accept about evening commercial painting. Blue network available color rock.",6:14:06,CHEQUE
CUHL01704932377151,GB91DITZ74834780737967,4/4/2017,25788.62,100002,N,Credited,FF,MOBILE,Cr,9:24:55,11:40:02,8/26/2021,7910678,1932.13,7,"Suffer control media ago sound. Prepare would degree may bit hope.
Item officer bag so late I. Citizen stop life bed also small. And including lawyer until.",10:52:01,DD
CUHL01704932377151,GB91DITZ74834780737967,4/4/2017,23856.49,100002,Y,Utilities,CHROME,POS,Dr,16:05:06,17:08:54,8/26/2021,53225689,1932.13,1,Pattern skin open occur first speech. Life within manage nothing. Some someone draw remain happen trial still. Number church unit recent.,16:35:38,NEFT
CUHL01704932377151,GB91DITZ74834780737967,4/4/2017,25788.62,100002,N,Credited,SAFARI,MOBILE,Cr,17:28:48,20:55:52,8/26/2021,91513465,1932.13,6,"Not sound shake thing see pick leg. Wait seek to. Whatever lead approach word adult.
Look almost me soldier pressure police that. Gas foreign within easy take contain.",19:46:23,CHEQUE
CUHL01704932377151,GB91DITZ74834780737967,4/4/2017,27355.96,100002,N,Credited,FF,MOBILE,Cr,13:42:21,17:07:53,9/13/2021,51007843,1567.34,3,"Official production someone provide into. Cost find whole scene.
Lawyer PM central system determine authority wonder. View bad yeah water. Relate yard bank capital soldier.",15:24:29,RTGS
CUHL01704932377151,GB91DITZ74834780737967,4/4/2017,25788.62,100002,Y,Entertainment,CHROME,PC,Dr,18:24:26,22:14:08,9/13/2021,22866356,1567.34,5,"Animal business pull standard young. Film industry situation suffer.
Act arrive author art traditional. Huge almost school.",21:24:06,CARDS
CUHL01704932377151,GB91DITZ74834780737967,4/4/2017,24648.23,100002,Y,Household Consumables,IE,MOBILE,Dr,6:34:35,10:05:17,9/17/2021,81566679,1140.39,2,Reach plant picture strong ground memory successful. Similar eye sea national another usually teacher.,7:12:12,IMPS
CUHL01704932377151,GB91DITZ74834780737967,4/4/2017,23507.84,100002,Y,Rent,SAFARI,PC,Dr,15:13:53,19:04:37,9/17/2021,65727263,1140.39,3,"Animal product term human research even. Reduce policy boy most.
Risk why oil begin along energy. Between among arm east black. Exist know enjoy thousand. Bed compare more news everything place bed.",16:58:29,RTGS
CUHL01704932377151,GB91DITZ74834780737967,4/4/2017,22367.45,100002,Y,Groceries,SAFARI,PC,Dr,20:40:15,23:09:38,9/17/2021,82247089,1140.39,7,"Heart into however central treat.
Professor glass manage political nearly himself important. Blood note oil wish health positive.",21:25:59,DD
CUHL01704932377151,GB91DITZ74834780737967,4/4/2017,24023.4,100002,N,Credited,CHROME,PC,Cr,4:01:01,7:30:42,9/18/2021,83751691,1655.95,4,"Want character miss direction able pattern. Turn yourself can right part mission sport determine.
Across whose dog. Field issue military price.",5:47:45,UPI
CUHL01704932377151,GB91DITZ74834780737967,4/4/2017,25679.35,100002,N,Credited,FF,POS,Cr,9:14:44,11:37:18,9/18/2021,31145312,1655.95,2,Thus form mean world report light. Least better star early respond again. Late quickly answer mind tough almost.,9:53:29,IMPS
CUHL01704932377151,GB91DITZ74834780737967,4/4/2017,27335.3,100002,N,Credited,OPERA,PC,Cr,11:52:15,15:07:32,9/18/2021,8817860,1655.95,7,"Child and foreign perform seven nice majority. Music assume main able speech.
Teacher organization radio task report. No argue because character tough friend.",13:20:24,DD
CUHL01704932377151,GB91DITZ74834780737967,4/4/2017,28991.25,100002,N,Credited,CHROME,POS,Cr,15:37:46,18:43:44,9/18/2021,61136250,1655.95,7,Reduce human by through five of. Thought argue option structure foot however meet. Meet majority score.,17:06:46,DD
CUHL01704932377151,GB91DITZ74834780737967,4/4/2017,30647.2,100002,N,Credited,FF,PC,Cr,20:27:09,23:50:39,9/18/2021,21959783,1655.95,3,"National dark discover mind free. Give if another.
Challenge cover build a. Page letter work relate really star.",22:10:51,RTGS
CUHL01704932377151,GB91DITZ74834780737967,4/4/2017,29314.97,100002,Y,Medicals,IE,POS,Dr,6:55:02,9:51:43,9/21/2021,3352748,1332.23,7,"Reveal mouth decide surface behind outside tend soldier.
Perhaps reality expect person point just. In feel change.
Happy mention level. Kind want few outside career real be plant.",7:35:07,DD
CUHL01704932377151,GB91DITZ74834780737967,4/4/2017,30647.2,100002,N,Credited,SAFARI,PC,Cr,12:27:07,15:35:32,9/21/2021,28572787,1332.23,2,Manage now increase may. Actually contain professional girl probably could form. Down place everything item yard tonight administration.,14:16:36,IMPS
CUHL01704932377151,GB91DITZ74834780737967,4/4/2017,31979.43,100002,N,Credited,MI,POS,Cr,15:48:19,19:44:02,9/21/2021,28815891,1332.23,5,Visit matter environment federal stop bit why. Bit market magazine experience along affect want. Western better like create.,17:47:41,CARDS
CUHL01704932377151,GB91DITZ74834780737967,4/4/2017,33311.66,100002,N,Credited,IE,MOBILE,Cr,18:27:21,21:37:28,9/21/2021,47008458,1332.23,5,"Join teacher least room conference eat stage.
Effort car place. Some question necessary including child.",19:28:52,CARDS
CUHL01704932377151,GB91DITZ74834780737967,4/4/2017,33107.24,100002,Y,Personal Care,OPERA,POS,Dr,7:31:38,9:34:15,10/4/2021,78016620,204.42,5,Money blue evening space though per. Wind return rule option. Draw response though a. Technology lot executive understand art military.,8:16:53,CARDS
CUHL01704932377151,GB91DITZ74834780737967,4/4/2017,32902.82,100002,Y,Medicals,EDGE,MOBILE,Dr,9:24:32,12:08:12,10/4/2021,65055175,204.42,5,"Word film process. Some task must.
Them tree line like.
Summer already back she line he. Property image popular.
Nothing color most degree let care. Finally hope nothing despite.",11:13:25,CARDS
CUHL01704932377151,GB91DITZ74834780737967,4/4/2017,32698.4,100002,Y,Online Shopping,FF,POS,Dr,17:22:55,20:03:42,10/4/2021,83135880,204.42,7,Church leader its leave industry. Court change discuss media where. Alone several ability recently worry friend.,18:25:27,DD
CUHL01704932377151,GB91DITZ74834780737967,4/4/2017,32902.82,100002,N,Credited,EDGE,PC,Cr,19:34:52,21:59:33,10/4/2021,59588382,204.42,5,Speak certain win of direction work. Son law town. Small including red west. Watch place those scientist card difference.,21:10:12,CARDS
CUHL01704932377151,GB91DITZ74834780737967,4/4/2017,31395.97,100002,Y,Insurance,FF,POS,Dr,11:35:46,15:54:18,10/10/2021,49520736,1506.85,7,"Event enjoy inside surface must close place. Side pick once blue.
News although former give southern. Box draw through say take one speak.",12:59:12,DD
ZEZC96782790610481,GB65LENL00340791361820,3/14/2018,5909.2,100002,Y,Groceries,EDGE,MOBILE,Dr,4:57:27,6:44:42,3/25/2018,87649390,82.88,6,"Guy serve someone government ball big. South knowledge natural way deal.
Paper action although life once. Full deal understand recognize economic himself report within.",5:46:57,CHEQUE
ZEZC96782790610481,GB65LENL00340791361820,3/14/2018,5992.08,100002,N,Credited,MI,PC,Cr,9:42:29,12:24:20,3/25/2018,26449906,82.88,1,"About nearly his must. My discussion whose.
Which range blue citizen everyone billion inside understand. Your raise sound course say.",11:28:24,NEFT
ZEZC96782790610481,GB65LENL00340791361820,3/14/2018,6074.96,100002,N,Credited,IE,MOBILE,Cr,13:47:21,17:00:43,3/25/2018,74927791,82.88,7,Officer before mother home good east run. Rule color reason a forward including.,15:47:15,DD
ZEZC96782790610481,GB65LENL00340791361820,3/14/2018,5992.08,100002,Y,Groceries,FF,POS,Dr,17:42:13,20:09:24,3/25/2018,99978624,82.88,2,"Face finish tree. Avoid left ten eat. Player physical service store eat thing lot.
Say draw fly form. Note medical there idea else seem near.",18:47:24,IMPS
ZEZC96782790610481,GB65LENL00340791361820,3/14/2018,5909.2,100002,Y,Dining,OPERA,MOBILE,Dr,22:49:37,24:01:02,3/25/2018,64855295,82.88,3,"Since husband company yet fight. Teach somebody option white per guy have.
Left window this. Help experience southern TV pick.",23:26:34,RTGS
ZEZC96782790610481,GB65LENL00340791361820,3/14/2018,6583.93,100002,N,Credited,CHROME,PC,Cr,4:08:33,5:06:20,3/30/2018,25679038,674.73,1,Play improve talk television. Dinner whose just by western fear action. Huge scientist project life help community ten.,4:35:35,NEFT
ZEZC96782790610481,GB65LENL00340791361820,3/14/2018,5909.2,100002,Y,Rent,IE,POS,Dr,7:43:13,10:39:16,3/30/2018,47888944,674.73,7,"Fund foreign fish also control election upon. Late election throw boy house various next.
Crime example ok then. Increase my inside people.
Top call red also act clearly.",9:11:25,DD
ZEZC96782790610481,GB65LENL00340791361820,3/14/2018,5234.47,100002,Y,Insurance,EDGE,POS,Dr,13:18:41,15:26:10,3/30/2018,87690491,674.73,7,Safe he real long newspaper season radio. Floor show true evidence. Education property wall nice wide director.,14:36:26,DD
ZEZC96782790610481,GB65LENL00340791361820,3/14/2018,4559.74,100002,Y,Entertainment,EDGE,MOBILE,Dr,15:26:36,17:45:05,3/30/2018,68970215,674.73,4,According policy establish study. Property collection sister than send. Bag lot risk condition.,16:17:51,UPI
ZEZC96782790610481,GB65LENL00340791361820,3/14/2018,5234.47,100002,N,Credited,EDGE,MOBILE,Cr,21:21:39,23:37:31,3/30/2018,3656020,674.73,5,Five artist nearly agreement study address. Particularly wind real policy. Kid executive whose indicate sound our management.,23:04:11,CARDS
ZEZC96782790610481,GB65LENL00340791361820,3/14/2018,6539.08,100002,N,Credited,CHROME,MOBILE,Cr,6:48:22,9:34:47,3/31/2018,66834885,1304.61,6,"View example stage least save. Health list work talk.
Low manage movie ready guess near. Person join many theory real. Opportunity adult commercial news top. Simply worry television news suddenly if.",8:55:15,CHEQUE
ZEZC96782790610481,GB65LENL00340791361820,3/14/2018,7843.69,100002,N,Credited,OPERA,PC,Cr,11:10:45,15:58:08,3/31/2018,52188916,1304.61,7,"Summer name first television industry idea traditional my. Sport Democrat fear focus use.
Town city three their. Skill next subject whole across sometimes.",13:03:25,DD
ZEZC96782790610481,GB65LENL00340791361820,3/14/2018,9148.3,100002,N,Credited,MI,MOBILE,Cr,19:24:56,24:14:24,3/31/2018,32879506,1304.61,1,"Door recently different all where also food. Have parent themselves occur.
Alone wife send enjoy. Despite resource myself in.",22:22:36,NEFT
ZEZC96782790610481,GB65LENL00340791361820,3/14/2018,10007.73,100002,N,Credited,EDGE,POS,Cr,13:28:20,23:24:48,4/5/2018,13480707,859.43,6,Live cover more true near easy management art. Short good much rule ago wish family adult. Establish scene beat face agent win medical.,18:09:39,CHEQUE
ZEZC96782790610481,GB65LENL00340791361820,3/14/2018,11824.13,100002,N,Credited,CHROME,MOBILE,Cr,6:56:43,10:16:08,4/7/2018,48375092,1816.4,3,Just place page think both. Picture and page window cultural successful floor. With decade summer.,8:18:13,RTGS
ZEZC96782790610481,GB65LENL00340791361820,3/14/2018,13640.53,100002,N,Credited,IE,POS,Cr,8:37:46,11:00:38,4/7/2018,99120993,1816.4,2,Believe child stock adult section sign. Compare interview drop democratic go.,10:05:53,IMPS
ZEZC96782790610481,GB65LENL00340791361820,3/14/2018,15456.93,100002,N,Credited,MI,POS,Cr,14:39:05,16:40:02,4/7/2018,84952950,1816.4,3,"Could American chair available clear. Information big strong try different recent. Good interest fine large according these teach.
Marriage also not decision. Attack course should.",15:36:47,RTGS
ZEZC96782790610481,GB65LENL00340791361820,3/14/2018,17273.33,100002,N,Credited,SAFARI,POS,Cr,19:05:55,23:15:52,4/7/2018,22154668,1816.4,4,"Small cultural site late long. Career bit onto his operation.
Idea customer own heavy focus project decade.
Half court your. Low especially two green brother.",21:13:18,UPI
ZEZC96782790610481,GB65LENL00340791361820,3/14/2018,15390.67,100002,Y,Medicals,FF,POS,Dr,3:07:52,6:35:43,4/10/2018,40016887,1882.66,3,"Move evening page citizen fact. Let sea face like wait executive meeting.
Government amount sing much. Herself certainly voice us maintain.",5:26:43,RTGS
ZEZC96782790610481,GB65LENL00340791361820,3/14/2018,13508.01,100002,Y,Utilities,SAFARI,PC,Dr,9:25:23,12:56:20,4/10/2018,82483722,1882.66,4,"Party top information. Democratic him those think project military build. List across American role.
Continue citizen stage car seem enough.
Gun near fine drive around task. Receive research cut.",11:24:14,UPI
ZEZC96782790610481,GB65LENL00340791361820,3/14/2018,11625.35,100002,Y,Household Consumables,EDGE,PC,Dr,15:57:23,18:59:22,4/10/2018,1520583,1882.66,6,"Young national many trade suffer style huge.
Town person bar attorney. Deal red future fall key whose.
Unit appear agent. Should chance here real no customer develop.",17:01:21,CHEQUE
ZEZC96782790610481,GB65LENL00340791361820,3/14/2018,9742.69,100002,Y,Utilities,SAFARI,POS,Dr,21:58:59,25:45:00,4/10/2018,75693879,1882.66,7,"Market lose whole alone draw from energy century. Listen miss meeting reach several color. Color before security half learn.
Let market next wall must good small. Safe military letter matter.",23:49:47,DD
ZEZC96782790610481,GB65LENL00340791361820,3/14/2018,9097.64,100002,Y,Personal Care,OPERA,MOBILE,Dr,8:21:21,11:38:23,4/12/2018,67178223,645.05,5,Son rock these design. Skin modern turn conference on lead. Current nothing middle. Interest dream cell argue more together.,10:36:20,CARDS
ZEZC96782790610481,GB65LENL00340791361820,3/14/2018,9742.69,100002,N,Credited,MI,MOBILE,Cr,14:15:34,16:43:09,4/12/2018,16536104,645.05,6,Who anything money hour campaign care especially want. Ok respond table difficult great during view cultural. Father you including. Show meet prevent always.,15:20:10,CHEQUE
ZEZC96782790610481,GB65LENL00340791361820,3/14/2018,10387.74,100002,N,Credited,EDGE,MOBILE,Cr,19:01:41,24:20:42,4/12/2018,12888740,645.05,4,"Race law someone lose catch me. Myself similar couple.
Represent seek direction. Material become month program quite forget. Consider strategy human never even evening.",21:52:57,UPI
ZEZC96782790610481,GB65LENL00340791361820,3/14/2018,12180.86,100002,N,Credited,FF,PC,Cr,7:09:38,11:23:54,4/20/2018,87514797,1793.12,1,"Behind carry result recent everyone. True military life. Method newspaper analysis part forward listen.
Of treat choose market. Down sometimes especially director hit administration.",9:29:26,NEFT
ZEZC96782790610481,GB65LENL00340791361820,3/14/2018,10387.74,100002,Y,Household Consumables,OPERA,MOBILE,Dr,21:24:03,26:29:08,4/20/2018,87155044,1793.12,4,"Too month wonder. Expect sing sense within. Soldier game mother pick.
Perhaps behind require number state choice.",23:16:58,UPI
ZEZC96782790610481,GB65LENL00340791361820,3/14/2018,10078.54,100002,Y,Medicals,IE,MOBILE,Dr,6:59:33,11:36:58,4/21/2018,30101081,309.2,2,Direction job reality. Fast similar thing learn within beat. Avoid walk order possible century including.,9:17:33,IMPS
ZEZC96782790610481,GB65LENL00340791361820,3/14/2018,9769.34,100002,Y,Utilities,FF,POS,Dr,18:25:25,25:03:39,4/21/2018,12081011,309.2,6,"Alone despite necessary table night black.
Lose kitchen keep recently question since. Site skin then it. American per defense agent these receive.",21:43:04,CHEQUE
ZEZC96782790610481,GB65LENL00340791361820,3/14/2018,11695.03,100002,N,Credited,FF,PC,Cr,5:29:41,7:53:16,4/22/2018,83943041,1925.69,2,"Hospital soldier church experience. Base kid security become nature fight.
Physical wait according. Other call lose maintain particular.",6:52:22,IMPS
ZEZC96782790610481,GB65LENL00340791361820,3/14/2018,9769.34,100002,Y,Groceries,IE,MOBILE,Dr,13:35:35,18:14:12,4/22/2018,16642874,1925.69,4,"View simply performance against action movement board. Probably table various return.
Ball entire cell peace data important want. Get food life head Congress result. Natural west issue.",16:22:36,UPI
ZEZC96782790610481,GB65LENL00340791361820,3/14/2018,7843.65,100002,Y,Insurance,SAFARI,POS,Dr,17:38:38,21:33:04,4/22/2018,82305871,1925.69,4,"Skin like figure clearly state. Think ahead business card level skin government.
Health if sell walk.",20:16:48,UPI
ZEZC96782790610481,GB65LENL00340791361820,3/14/2018,6721.27,100002,Y,Personal Care,MI,MOBILE,Dr,17:21:00,23:02:53,4/29/2018,19311784,1122.38,1,"Tree follow back few stage area forward. Anything sound contain there special forward.
Physical attorney tough answer truth ever enough. Appear list before explain product strong.",21:26:51,NEFT
ZEZC96782790610481,GB65LENL00340791361820,3/14/2018,7230.51,100002,N,Credited,FF,MOBILE,Cr,4:40:24,6:33:50,5/1/2018,82246525,509.24,2,"Organization will without attorney. Sea question raise issue information drop wide. Important mind make away door really result.
Deep program hundred off.",5:55:50,IMPS
ZEZC96782790610481,GB65LENL00340791361820,3/14/2018,6721.27,100002,Y,Insurance,MI,MOBILE,Dr,9:09:48,10:40:48,5/1/2018,32908534,509.24,4,"Evening many by technology clearly. Theory as daughter popular.
Feel cost actually decision. Amount practice message pressure. Attack officer statement realize another us.",9:43:13,UPI
ZEZC96782790610481,GB65LENL00340791361820,3/14/2018,7230.51,100002,N,Credited,EDGE,POS,Cr,11:50:13,13:49:07,5/1/2018,96450475,509.24,5,Offer analysis condition next coach. Give public visit gas history training. Ten different six others.,12:52:09,CARDS
ZEZC96782790610481,GB65LENL00340791361820,3/14/2018,6721.27,100002,Y,Medicals,CHROME,MOBILE,Dr,15:04:53,18:06:24,5/1/2018,82657505,509.24,2,Letter military admit father respond goal. Decade reflect father. Upon source mouth event across yeah above.,16:09:30,IMPS
ZEZC96782790610481,GB65LENL00340791361820,3/14/2018,7230.51,100002,N,Credited,MI,PC,Cr,22:20:41,23:41:39,5/1/2018,23707108,509.24,7,Any magazine visit information seven thought. Represent street collection relate agreement age through. There save specific bank movie smile share.,23:10:44,DD
ZEZC96782790610481,GB65LENL00340791361820,3/14/2018,8284.29,100002,N,Credited,FF,POS,Cr,3:36:38,7:27:22,5/3/2018,77981783,1053.78,7,"Him plant become join deal. Former learn possible company. Focus not black on forward condition.
Commercial pull maintain actually. Sell sometimes tax try too hold everything student.",5:23:31,DD
ZEZC96782790610481,GB65LENL00340791361820,3/14/2018,9338.07,100002,N,Credited,FF,PC,Cr,9:50:12,12:25:41,5/3/2018,41993866,1053.78,5,Give describe city air although watch carry. Work fast seem trip do safe. Economy thus wonder safe data.,10:46:58,CARDS
ZEZC96782790610481,GB65LENL00340791361820,3/14/2018,8284.29,100002,Y,Transportation,IE,MOBILE,Dr,15:17:18,19:11:00,5/3/2018,83641732,1053.78,4,Identify system table administration. Marriage either power particularly follow.,17:11:01,UPI
ZEZC96782790610481,GB65LENL00340791361820,3/14/2018,7230.51,100002,Y,Household Consumables,MI,MOBILE,Dr,19:16:21,22:01:53,5/3/2018,72580608,1053.78,6,Successful race beautiful positive stop road. Like government often crime create man only. Oil note they drive recently discuss weight.,20:57:52,CHEQUE
ZEZC96782790610481,GB65LENL00340791361820,3/14/2018,7299.83,100002,N,Credited,OPERA,POS,Cr,6:09:47,8:56:35,5/20/2018,43136087,69.32,5,However you approach enough mean. Message figure road actually turn this including.,7:01:28,CARDS
ZEZC96782790610481,GB65LENL00340791361820,3/14/2018,7369.15,100002,N,Credited,EDGE,PC,Cr,11:06:26,15:00:49,5/20/2018,94143348,69.32,1,"Various character west morning fall book cost. Crime quickly hope could.
Feel voice simply quite enjoy per stay. Interest probably book say choose sea.
Power budget cost figure rise face.",13:30:32,NEFT
ZEZC96782790610481,GB65LENL00340791361820,3/14/2018,7299.83,100002,Y,Insurance,FF,POS,Dr,18:17:42,21:42:51,5/20/2018,39537317,69.32,7,Think item determine open you surface. Hard none into close stage and always.,20:47:09,DD
ZEZC96782790610481,GB65LENL00340791361820,3/14/2018,7177.51,100002,Y,Online Shopping,CHROME,MOBILE,Dr,10:12:56,13:41:35,5/27/2018,20496197,122.32,6,"Structure there officer reality radio street risk. Final employee front.
Accept peace here ok particular. Church mention especially computer fact arm.",12:05:23,CHEQUE
ZEZC96782790610481,GB65LENL00340791361820,3/14/2018,7299.83,100002,N,Credited,CHROME,POS,Cr,16:38:26,21:21:22,5/27/2018,77348128,122.32,5,"Build morning fine effort. Others manage east. There suddenly stay east fish manage sport toward. Hour late set line.
Card national decide happy language. Professor loss development nation.",17:47:52,CARDS
ZEZC96782790610481,GB65LENL00340791361820,3/14/2018,5439.99,100002,Y,Online Shopping,FF,MOBILE,Dr,11:49:05,15:31:33,6/6/2018,62948555,1859.84,3,"Sea whatever public else. Large adult man bag. Cell or rest security run.
Perform interesting call value. Another region general yeah these tough. Perhaps try away say.",14:07:06,RTGS
ZEZC96782790610481,GB65LENL00340791361820,3/14/2018,5230.48,100002,Y,Rent,MI,PC,Dr,6:37:09,7:42:20,6/10/2018,41198346,209.51,6,"Number discover start argue physical information me according. Total across yet.
Past voice available modern daughter say son simple.",7:03:50,CHEQUE
ZEZC96782790610481,GB65LENL00340791361820,3/14/2018,5020.97,100002,Y,Online Shopping,SAFARI,MOBILE,Dr,7:29:47,10:43:35,6/10/2018,73087397,209.51,1,Situation sense various conference read need project Mrs. Four ball newspaper structure across however give program. Six us throw they however.,9:25:04,NEFT
ZEZC96782790610481,GB65LENL00340791361820,3/14/2018,5230.48,100002,N,Credited,FF,PC,Cr,11:34:16,13:59:21,6/10/2018,6611156,209.51,5,"Too beat wrong not economy career cultural. Camera model information usually else.
Sense play case remember. East party well occur history though. And half cover.",13:05:31,CARDS
ZEZC96782790610481,GB65LENL00340791361820,3/14/2018,5439.99,100002,N,Credited,FF,PC,Cr,15:58:42,17:57:43,6/10/2018,63392333,209.51,3,"Beautiful break prevent art character lead add big.
Enjoy up edge true can visit meet product. Mind member also record hear. Information whether thousand realize particularly no.",17:14:53,RTGS
ZEZC96782790610481,GB65LENL00340791361820,3/14/2018,5230.48,100002,Y,Entertainment,CHROME,PC,Dr,21:14:01,23:23:17,6/10/2018,18694123,209.51,7,"Ahead win civil pattern truth deep building. Personal goal news rather.
Can product treatment but watch. Dream which likely assume always.
Half tree service work Mrs of strategy determine.",22:37:44,DD
ZEZC96782790610481,GB65LENL00340791361820,3/14/2018,5745.79,100002,N,Credited,CHROME,PC,Cr,6:47:08,10:07:22,6/12/2018,52659256,515.31,2,"Save because population rather with be everything evening.
None either unit college almost last speak. None turn buy condition two course.",8:07:34,IMPS
ZEZC96782790610481,GB65LENL00340791361820,3/14/2018,5230.48,100002,Y,Personal Care,OPERA,PC,Dr,13:42:45,14:58:06,6/12/2018,10328231,515.31,4,"Clearly worry whatever. Spring can church look seat resource miss. Off then east listen base.
Share firm Mr perform pick compare lawyer others. Simple team accept. South hand story person watch.",14:15:53,UPI
ZEZC96782790610481,GB65LENL00340791361820,3/14/2018,5745.79,100002,N,Credited,OPERA,PC,Cr,12:24:26,15:33:52,6/12/2018,76654176,515.31,7,"Among market yourself travel evidence student.
Manager his others. Production film program she when.
Their stay remember player democratic. Break develop send outside work difficult yard.",14:25:30,DD
ZEZC96782790610481,GB65LENL00340791361820,3/14/2018,5230.48,100002,Y,Personal Care,IE,POS,Dr,19:33:27,21:27:56,6/12/2018,69723810,515.31,3,Pm board front yet task my rock. Available clearly on state strategy statement. Your treat indeed ball fast throughout. School situation tonight identify against.,20:46:20,RTGS
ZEZC96782790610481,GB65LENL00340791361820,3/14/2018,4212.97,100002,Y,Rent,MI,PC,Dr,8:58:35,11:29:05,7/2/2018,28398707,1017.51,1,Name study something quality life myself. Court talk so wear picture friend surface. Girl hotel focus.,9:58:54,NEFT
ZEZC96782790610481,GB65LENL00340791361820,3/14/2018,5230.48,100002,N,Credited,SAFARI,PC,Cr,13:10:17,17:02:28,7/2/2018,772396,1017.51,4,"Something account clear surface nice actually serious. Media resource edge put low cut.
Employee establish south follow. Lose front owner itself dinner and.",15:16:39,UPI
ZEZC96782790610481,GB65LENL00340791361820,3/14/2018,6247.99,100002,N,Credited,MI,PC,Cr,19:02:41,21:20:05,7/2/2018,10708408,1017.51,3,"Imagine against language lay color for culture as. Parent fill could reduce pretty effect win large.
Break another either boy quickly win seven.
Every who worry enjoy.",20:08:38,RTGS
ZEZC96782790610481,GB65LENL00340791361820,3/14/2018,4743.11,100002,Y,Entertainment,IE,PC,Dr,7:35:48,11:14:55,7/12/2018,12693337,1504.88,7,"Argue on sell not time sing build. Expect behind change consider imagine until little page.
Continue reflect team lot opportunity. Eight mention go nature case. Low yard save car event.",8:22:26,DD
ZEZC96782790610481,GB65LENL00340791361820,3/14/2018,6247.99,100002,N,Credited,EDGE,POS,Cr,14:47:43,16:33:37,7/12/2018,15945662,1504.88,3,Professional suffer about soon line structure. Include benefit seat here risk. Approach need most born.,15:46:01,RTGS
ZEZC96782790610481,GB65LENL00340791361820,3/14/2018,4743.11,100002,Y,Groceries,FF,PC,Dr,16:40:13,21:09:13,7/12/2018,94585728,1504.88,2,"Oil nor write. Open do central both leave.
Better its similar size series we do. Family name crime teacher around throw.",18:34:09,IMPS
ZEZC96782790610481,GB65LENL00340791361820,3/14/2018,5190.84,100002,N,Credited,OPERA,MOBILE,Cr,2:52:09,5:08:38,7/21/2018,30904187,447.73,5,"They head blood operation finally. System nothing nation bill.
Old food poor black. Information many why meeting himself.",4:04:05,CARDS
ZEZC96782790610481,GB65LENL00340791361820,3/14/2018,5638.57,100002,N,Credited,EDGE,PC,Cr,9:10:22,11:24:59,7/21/2018,42776956,447.73,7,Month Mrs study myself no option from. Central goal couple against thank statement attention. Reality fine threat price to item man.,10:02:03,DD
ZEZC96782790610481,GB65LENL00340791361820,3/14/2018,6086.3,100002,N,Credited,FF,PC,Cr,13:11:39,15:30:32,7/21/2018,59205852,447.73,3,Window home different food trade relationship. List personal management free loss increase simple at. Job single gas more. Number girl job free good action.,14:09:04,RTGS
ZEZC96782790610481,GB65LENL00340791361820,3/14/2018,6534.03,100002,N,Credited,FF,PC,Cr,18:24:04,20:00:31,7/21/2018,31432085,447.73,1,Page bar industry seat involve realize our study. Task hope top strategy brother what ok. Produce career us apply happen actually police.,19:03:25,NEFT
ZEZC96782790610481,GB65LENL00340791361820,3/14/2018,6981.76,100002,N,Credited,MI,PC,Cr,20:59:16,24:12:52,7/21/2018,23087569,447.73,1,"Half read bag down. Her quite apply throughout responsibility tell. Trip worker will successful this.
Term expert must.
Learn forget threat avoid cost around back. Product as else thank.",22:25:03,NEFT
ZEZC96782790610481,GB65LENL00340791361820,3/14/2018,5746.98,100002,Y,Rent,OPERA,POS,Dr,11:25:17,20:15:04,8/3/2018,92442726,1234.78,3,Dream everything thousand large. Very technology her analysis up model water. Share coach behind market hard fight.,16:05:53,RTGS
ZEZC96782790610481,GB65LENL00340791361820,3/14/2018,6748.84,100002,N,Credited,CHROME,MOBILE,Cr,4:41:34,8:26:57,8/18/2018,50948178,1001.86,3,"North report make yard station. Father practice stage color cause. Suddenly mean place nearly issue. End lawyer go resource could.
Box hour let no hit. Citizen fear involve today.",7:03:56,RTGS
ZEZC96782790610481,GB65LENL00340791361820,3/14/2018,7750.7,100002,N,Credited,FF,MOBILE,Cr,15:27:15,17:30:47,8/18/2018,79324526,1001.86,1,"Medical media deep ready run should plan decade.
Way special turn case parent. Term truth test keep provide method remain. Nearly former feeling particularly hotel friend.",16:41:03,NEFT
ZEZC96782790610481,GB65LENL00340791361820,3/14/2018,6748.84,100002,Y,Utilities,MI,PC,Dr,20:54:54,25:34:23,8/18/2018,61471733,1001.86,6,"Action act today you while left region. Case Mr kitchen attention. Involve week fine reach wrong white attorney.
Them manage site ten PM plan. Figure drive often true live woman.",23:53:09,CHEQUE
ZEZC96782790610481,GB65LENL00340791361820,3/14/2018,5052.26,100002,Y,Utilities,MI,MOBILE,Dr,7:25:15,12:10:11,8/28/2018,37910068,1696.58,6,Job will state just teach trial law either. Picture parent prepare study vote store. Return among loss morning administration.,10:11:56,CHEQUE
ZEZC96782790610481,GB65LENL00340791361820,3/14/2018,3355.68,100002,Y,Rent,CHROME,MOBILE,Dr,16:08:10,18:12:36,8/28/2018,71082035,1696.58,7,"Send loss kid friend visit.
End medical middle popular. Boy candidate set third. Interesting discuss democratic whole.",16:46:15,DD
ZEZC96782790610481,GB65LENL00340791361820,3/14/2018,5052.26,100002,N,Credited,MI,PC,Cr,17:41:35,22:08:48,8/28/2018,85681606,1696.58,7,"Picture pay section company affect left purpose. Cold protect range stay. Buy might practice.
Job officer practice guess happen.",20:07:58,DD
ZEZC96782790610481,GB65LENL00340791361820,3/14/2018,5016.78,100002,Y,Household Consumables,IE,PC,Dr,19:31:27,27:18:59,9/9/2018,40701899,35.48,1,"Let cold music care once. Represent finally feel choose watch alone television.
Itself image peace more may. Tax involve sea field. Know program which as.",23:48:41,NEFT
ZEZC96782790610481,GB65LENL00340791361820,3/14/2018,3107.06,100002,Y,Transportation,OPERA,MOBILE,Dr,8:14:54,9:48:37,9/12/2018,16826809,1909.72,5,"Item cause too. Not manager enough lose place.
Claim enough record couple raise time grow. Condition major assume very member for community.
Outside too seven each unit. Let fly pressure they.",8:52:07,CARDS
ZEZC96782790610481,GB65LENL00340791361820,3/14/2018,1197.34,100002,Y,Groceries,EDGE,MOBILE,Dr,14:52:12,17:47:13,9/12/2018,58949948,1909.72,7,"Concern someone all. Support least usually language why a business pick.
Appear another large door know child. Born many key road have case.",15:47:22,DD
ZEZC96782790610481,GB65LENL00340791361820,3/14/2018,761.27,100002,Y,Household Consumables,OPERA,PC,Dr,15:16:12,19:40:35,9/14/2018,58580462,436.07,7,"Position identify institution.
Them truth reality hope describe. Generation financial adult. Personal with wife film drug.",16:59:45,DD
ZEZC96782790610481,GB65LENL00340791361820,3/14/2018,2459.41,100002,N,Credited,EDGE,PC,Cr,17:06:52,21:14:35,9/19/2018,85172401,1698.14,4,"Memory mean difficult enjoy yourself land.
Boy international follow pretty process. Along night fund growth by improve.",18:15:06,UPI
ZEZC96782790610481,GB65LENL00340791361820,3/14/2018,932.49,100002,Y,Entertainment,OPERA,MOBILE,Dr,4:39:40,7:40:15,9/25/2018,36913077,1526.92,5,"Operation capital station two. Read finally fire family world.
Front team movement see media accept. Town democratic mention box less. On education direction catch recognize we program.",5:58:17,CARDS
ZEZC96782790610481,GB65LENL00340791361820,3/14/2018,2459.41,100002,N,Credited,OPERA,PC,Cr,11:06:25,14:11:24,9/25/2018,10583913,1526.92,6,"Cultural year a cold cause. Society feel whether old language enter.
Name oil door southern.",11:54:36,CHEQUE
ZEZC96782790610481,GB65LENL00340791361820,3/14/2018,3986.33,100002,N,Credited,FF,POS,Cr,18:11:28,19:57:38,9/25/2018,11535843,1526.92,4,Have heart among often else contain throughout. Discussion pretty dream serious it traditional.,18:55:15,UPI
ZEZC96782790610481,GB65LENL00340791361820,3/14/2018,2459.41,100002,Y,Groceries,SAFARI,POS,Dr,22:58:49,25:27:40,9/25/2018,16668706,1526.92,1,Require candidate heavy theory least agreement may. Maintain vote try later movie offer why. Reason will professor rest cut mouth common.,23:59:29,NEFT
ZEZC96782790610481,GB65LENL00340791361820,3/14/2018,4129.08,100002,N,Credited,IE,POS,Cr,13:16:01,20:27:46,10/2/2018,20999025,1669.67,5,Western animal reason recognize by become between. Late buy send fill thank else rather. Them community age three within minute which personal.,17:49:31,CARDS
ZEZC96782790610481,GB65LENL00340791361820,3/14/2018,3304.63,100002,Y,Online Shopping,EDGE,POS,Dr,6:21:31,9:54:09,10/8/2018,17743259,824.45,4,"Specific picture mouth realize together radio mention gun.
Perhaps apply tonight boy treat. Instead class scientist investment. Peace imagine rate how say.",8:21:58,UPI
ZEZC96782790610481,GB65LENL00340791361820,3/14/2018,2480.18,100002,Y,Medicals,FF,PC,Dr,12:19:46,14:23:22,10/8/2018,78611481,824.45,2,Stay whom particularly question very read sell threat. Participant with lay sometimes strategy hot. Western window series daughter loss person box.,13:06:29,IMPS
ZEZC96782790610481,GB65LENL00340791361820,3/14/2018,1655.73,100002,Y,Personal Care,IE,POS,Dr,16:26:01,19:49:22,10/8/2018,33711096,824.45,5,"Action require entire notice. Wind boy many. Project father while less one information market.
Crime fact stop. Work teach hundred finally while enough actually.",18:16:43,CARDS
ZEZC96782790610481,GB65LENL00340791361820,3/14/2018,831.28,100002,Y,Medicals,MI,MOBILE,Dr,21:19:44,23:46:30,10/8/2018,85098350,824.45,5,"Part newspaper happen into able majority. Media score to party. Add least field thing.
Likely wrong discussion. Future them ok lose. Career college since kind how major decade.",22:16:51,CARDS
ZEZC96782790610481,GB65LENL00340791361820,3/14/2018,1579.12,100002,N,Credited,IE,MOBILE,Cr,18:50:07,25:30:25,10/17/2018,46185365,747.84,5,"Around feeling table draw. Responsibility list various recently believe.
Far concern billion form. Too effort though term go visit. Paper us exactly near son few case get.",23:38:59,CARDS
ZEZC96782790610481,GB65LENL00340791361820,3/14/2018,3441.04,100002,N,Credited,MI,PC,Cr,6:15:29,11:15:32,10/21/2018,17873376,1861.92,4,"Certain same use. Almost water oil population health spring how.
Role ball have including perform. Occur finish brother.",8:03:18,UPI
ZEZC96782790610481,GB65LENL00340791361820,3/14/2018,1579.12,100002,Y,Insurance,SAFARI,POS,Dr,21:34:36,25:06:02,10/21/2018,84882592,1861.92,4,Although explain computer role his. Range town bed today chair sister rate color. Mrs industry draw wall part discussion wide.,23:26:13,UPI
ZEZC96782790610481,GB65LENL00340791361820,3/14/2018,2451.71,100002,N,Credited,OPERA,PC,Cr,8:23:29,19:21:29,10/22/2018,60920560,872.59,1,Force course stop believe grow crime. Sea city charge read everybody culture commercial low. Home billion artist international bar.,13:28:30,NEFT
ZEZC96782790610481,GB65LENL00340791361820,3/14/2018,2115.06,100002,Y,Rent,SAFARI,PC,Dr,6:29:46,11:50:02,10/25/2018,86583862,336.65,3,Conference month wind catch. Weight must allow open positive network doctor. Necessary prove threat officer city fall. Save information somebody trouble thus.,9:12:45,RTGS
ZEZC96782790610481,GB65LENL00340791361820,3/14/2018,2451.71,100002,N,Credited,SAFARI,PC,Cr,13:07:30,15:13:42,10/25/2018,72605547,336.65,3,Prove reflect necessary. Hundred later surface name size way team. Financial admit general trial science three.,13:45:19,RTGS
ZEZC96782790610481,GB65LENL00340791361820,3/14/2018,2115.06,100002,Y,Online Shopping,CHROME,POS,Dr,17:29:49,20:49:15,10/25/2018,53956576,336.65,6,Cost room test office suggest lead environmental. Together blood back.,20:05:08,CHEQUE
ZEZC96782790610481,GB65LENL00340791361820,3/14/2018,645.69,100002,Y,Entertainment,IE,POS,Dr,6:07:04,8:10:42,10/26/2018,67971534,1469.37,7,Reason with plant attention. Far doctor bring speech Congress something. Nothing teach wear many together theory. Keep maintain city decade require play watch stuff.,7:17:23,DD
ZEZC96782790610481,GB65LENL00340791361820,3/14/2018,2115.06,100002,N,Credited,CHROME,PC,Cr,15:29:15,18:48:26,10/26/2018,83710544,1469.37,1,Act shoulder onto decision director along chair. Assume along drug author along from. Game front environmental bit mouth. Forget card step appear again simple book place.,17:29:31,NEFT
ZEZC96782790610481,GB65LENL00340791361820,3/14/2018,645.69,100002,Y,Entertainment,OPERA,MOBILE,Dr,22:58:09,25:52:46,10/26/2018,27077627,1469.37,6,"Scene first sound down include minute color paper. Require student involve bad offer. Center enjoy author size beyond.
Wonder three their. These let on.",23:45:24,CHEQUE
ZEZC96782790610481,GB65LENL00340791361820,3/14/2018,1963.95,100002,N,Credited,CHROME,MOBILE,Cr,12:24:21,22:25:23,11/23/2018,55783989,1318.26,7,"Maintain effect community these later question tend. Accept road learn few.
Stuff yourself decide against.",18:19:02,DD
ZEZC96782790610481,GB65LENL00340791361820,3/14/2018,117.11,100002,Y,Dining,FF,MOBILE,Dr,7:43:05,12:03:14,12/8/2018,51764494,1846.84,7,Fine often reason nice look money. Teach institution out treatment politics meet during push.,9:17:30,DD
ZEZC96782790610481,GB65LENL00340791361820,3/14/2018,1963.95,100002,N,Credited,SAFARI,PC,Cr,14:33:10,16:53:40,12/8/2018,74771417,1846.84,2,"Seek stay everyone great. Strong theory spend least hot like remember. Quite view this use.
Education organization yes food common along family. Person act sit daughter back western.",16:14:40,IMPS
ZEZC96782790610481,GB65LENL00340791361820,3/14/2018,3810.79,100002,N,Credited,FF,POS,Cr,21:28:53,24:26:40,12/8/2018,76441462,1846.84,6,"No quite can support entire.
Decision policy sign image action reflect police. Worry movement daughter figure kid report note. Remember people decide head right history.",22:54:46,CHEQUE
ZEZC96782790610481,GB65LENL00340791361820,3/14/2018,2162.12,100002,Y,Utilities,EDGE,PC,Dr,6:16:46,10:25:02,12/16/2018,54070493,1648.67,6,"Step smile although stage economy lawyer. Kitchen thank west radio southern. Company town century attention.
Actually future politics cell. Color realize cost ago realize.",8:39:40,CHEQUE
ZEZC96782790610481,GB65LENL00340791361820,3/14/2018,513.45,100002,Y,Household Consumables,SAFARI,MOBILE,Dr,13:59:43,17:48:32,12/16/2018,71821689,1648.67,3,Side finally entire. Size boy information although. Everybody Congress together bit.,16:03:49,RTGS
ZEZC96782790610481,GB65LENL00340791361820,3/14/2018,2044.84,100002,N,Credited,OPERA,PC,Cr,8:08:59,14:04:31,12/19/2018,95428482,1531.39,7,"Money sure cultural billion. Maintain feel worry entire shake.
Likely think without move several walk. Person ready name style. Time baby stand move feeling drop.",10:57:58,DD
ZEZC96782790610481,GB65LENL00340791361820,3/14/2018,513.45,100002,Y,Dining,FF,MOBILE,Dr,15:53:12,19:12:14,12/19/2018,65974919,1531.39,1,"Chance true feeling just item. Draw arm I century provide check. Turn among tree set.
Movie able tough.
Old mission deal language appear watch image. Argue pull network work above more.",18:06:57,NEFT
ZEZC96782790610481,GB65LENL00340791361820,3/14/2018,2159.62,100002,N,Credited,IE,POS,Cr,11:42:28,14:17:48,1/9/2019,23613409,1646.17,1,"City nothing nor job home. History after set he study difference far.
Probably all song almost. Money move many analysis term outside sell.",13:21:02,NEFT
ZEZC96782790610481,GB65LENL00340791361820,3/14/2018,3805.79,100002,N,Credited,OPERA,PC,Cr,17:46:26,21:18:23,1/9/2019,70486193,1646.17,1,"World know follow wall design majority together. Condition war line quickly total strong pull also.
Expect admit movement just. Grow cost nearly. Activity affect water assume such table choice.",19:08:09,NEFT
ZEZC96782790610481,GB65LENL00340791361820,3/14/2018,1931.96,100002,Y,Dining,MI,MOBILE,Dr,4:31:25,6:42:00,1/12/2019,18637281,1873.83,6,"Building often community interest.
Visit instead prepare type group environmental season. Black similar shake sing we thousand test pick. Pattern scientist at all indicate close training.",4:57:48,CHEQUE
ZEZC96782790610481,GB65LENL00340791361820,3/14/2018,3805.79,100002,N,Credited,OPERA,MOBILE,Cr,9:45:20,11:42:30,1/12/2019,75815745,1873.83,6,"Paper rule business leave. Instead radio community feeling. Spend approach whole push why.
Eat many southern. Arrive still table bad actually term center.",10:17:03,CHEQUE
ZEZC96782790610481,GB65LENL00340791361820,3/14/2018,1931.96,100002,Y,Household Consumables,MI,MOBILE,Dr,13:51:53,17:01:13,1/12/2019,17586986,1873.83,2,"Their stay investment eye risk artist. Floor second effect in.
Human represent drug few. Grow painting decide oil.",15:47:04,IMPS
ZEZC96782790610481,GB65LENL00340791361820,3/14/2018,58.13,100002,Y,Transportation,IE,PC,Dr,15:48:14,17:30:20,1/12/2019,10472682,1873.83,3,Mission car light half dog last. Certain production support community record class finally. Attention available lay.,16:32:45,RTGS
ZEZC96782790610481,GB65LENL00340791361820,3/14/2018,836.25,100002,N,Credited,SAFARI,MOBILE,Cr,6:16:21,12:25:10,1/23/2019,94058505,778.12,7,"With throughout draw usually product town. Eat toward simple feel simple.
Listen name put interesting during citizen. Together daughter minute billion charge. Under benefit reveal clear.",10:00:43,DD
ZEZC96782790610481,GB65LENL00340791361820,3/14/2018,1614.37,100002,N,Credited,CHROME,POS,Cr,16:32:46,23:22:41,1/23/2019,17361552,778.12,4,Usually determine throw present success good put. Building full according room sell goal. Yet wide pattern travel wrong. Yeah might last compare reduce every.,19:51:05,UPI
ZEZC96782790610481,GB65LENL00340791361820,3/14/2018,198.51,100002,Y,Personal Care,IE,POS,Dr,20:08:42,24:47:24,1/24/2019,54332034,1415.86,2,"Truth better trouble open send. Always billion economic sister small century.
Continue thank nation type building your. Speak check agent kitchen stand. Old reduce sound authority.",23:29:05,IMPS
ZEZC96782790610481,GB65LENL00340791361820,3/14/2018,2157.74,100002,N,Credited,OPERA,PC,Cr,9:55:10,11:55:32,2/1/2019,77742421,1959.23,5,Home kind deep son teach alone your. Thought Republican buy common share develop ask. Case business technology mean table.,10:32:47,CARDS
ZEZC96782790610481,GB65LENL00340791361820,3/14/2018,198.51,100002,Y,Entertainment,EDGE,MOBILE,Dr,10:43:18,13:15:33,2/1/2019,96249314,1959.23,7,"Field view election contain pretty open our share. Too simple sort teach land.
Address suddenly board property officer town. Toward success economy report.",12:18:33,DD
ZEZC96782790610481,GB65LENL00340791361820,3/14/2018,2157.74,100002,N,Credited,FF,MOBILE,Cr,16:58:26,18:54:10,2/1/2019,61034372,1959.23,3,"Police feel product physical.
Interest easy move stage discover kind range recently. Program end child career region.",17:50:09,RTGS
ZEZC96782790610481,GB65LENL00340791361820,3/14/2018,198.51,100002,Y,Entertainment,IE,MOBILE,Dr,20:14:30,23:22:31,2/1/2019,14551352,1959.23,7,Hit firm campaign society school. Office account large involve behavior. Product appear onto sure medical strategy. Should mother now many space whatever fish guy.,22:11:16,DD
ZEZC96782790610481,GB65LENL00340791361820,3/14/2018,163.22,100002,Y,Insurance,MI,PC,Dr,8:00:06,14:10:45,2/4/2019,33008257,35.29,3,"Direction though personal news him. New room foreign well this back appear.
Put perhaps compare southern. Discover best yeah term small. Yourself weight ground part modern room must.",11:39:39,RTGS
ZEZC96782790610481,GB65LENL00340791361820,3/14/2018,127.93,100002,Y,Household Consumables,SAFARI,MOBILE,Dr,15:22:28,19:41:44,2/4/2019,5781393,35.29,2,Similar finish whether per fear member use past. Possible station green check without common then. Pattern hand local woman election.,18:03:36,IMPS
ZEZC96782790610481,GB65LENL00340791361820,3/14/2018,1234.26,100002,N,Credited,MI,PC,Cr,13:44:42,21:20:40,2/16/2019,48020183,1106.33,2,"Their voice father parent now. Expect peace action with country alone.
Ago trip field section spend design girl. Create nature station decide.",18:15:23,IMPS
ZEZC96782790610481,GB65LENL00340791361820,3/14/2018,1568.06,100002,N,Credited,MI,PC,Cr,11:52:20,17:06:48,3/16/2019,36864881,333.8,6,"Service fire song mean. Traditional dog around unit reduce fast. Wait give control authority cold pattern.
Reason few hundred training off pick. End really evidence list decade position many.",14:30:25,CHEQUE
ZEZC96782790610481,GB65LENL00340791361820,3/14/2018,1785.03,100002,N,Credited,CHROME,POS,Cr,5:47:08,7:52:56,3/20/2019,52392931,216.97,1,Security third scientist issue camera those. International new reason game make onto real. Laugh fill a traditional final heavy floor season.,7:01:33,NEFT
ZEZC96782790610481,GB65LENL00340791361820,3/14/2018,2002,100002,N,Credited,EDGE,POS,Cr,6:24:34,9:56:04,3/20/2019,89751893,216.97,1,"Art work majority bring trial here. Win consider lose need sure economic. List employee write bag moment.
Its professional red. Better when organization draw fact. True chair his window face act.",8:08:57,NEFT
ZEZC96782790610481,GB65LENL00340791361820,3/14/2018,1785.03,100002,Y,Insurance,IE,PC,Dr,13:16:12,14:21:27,3/20/2019,20077150,216.97,6,Week rich soon anything thought newspaper not network. Tell majority major wide.,13:51:26,CHEQUE
ZEZC96782790610481,GB65LENL00340791361820,3/14/2018,2002,100002,N,Credited,MI,PC,Cr,18:42:19,21:11:56,3/20/2019,81499113,216.97,4,Medical kitchen carry nearly enjoy. Who television lose week soldier road. Above central arm peace.,19:18:11,UPI
ZEZC96782790610481,GB65LENL00340791361820,3/14/2018,1785.03,100002,Y,Online Shopping,SAFARI,PC,Dr,20:19:23,23:08:41,3/20/2019,64279787,216.97,5,"Heart race campaign focus find drop indeed them. Know stay friend word alone state hit.
Policy down more occur vote across young mother. Physical staff high according move manager.",21:22:08,CARDS
ZEZC96782790610481,GB65LENL00340791361820,3/14/2018,1868.43,100002,N,Credited,OPERA,MOBILE,Cr,6:46:11,11:06:55,3/25/2019,22070524,83.4,3,"Huge everyone less ahead. Drive seven detail science rather.
Air tree serious white institution public. Early add executive sit bag anyone clearly.",8:31:05,RTGS
ZEZC96782790610481,GB65LENL00340791361820,3/14/2018,1785.03,100002,Y,Insurance,OPERA,MOBILE,Dr,14:42:09,20:13:34,3/25/2019,91479969,83.4,1,"Throw five newspaper player thus memory. Without box but food less hard much. Itself weight Mr billion.
Media cover artist. Result ten eight explain research.",17:31:43,NEFT
ZEZC96782790610481,GB65LENL00340791361820,3/14/2018,1868.43,100002,N,Credited,SAFARI,PC,Cr,23:05:52,24:38:41,3/25/2019,71342092,83.4,1,Health order black someone. Design evening card water admit process particularly. Wind high later.,23:50:24,NEFT
ZEZC96782790610481,GB65LENL00340791361820,3/14/2018,2528.52,100002,N,Credited,EDGE,MOBILE,Cr,5:52:26,11:13:24,4/11/2019,65295892,660.09,6,"Boy news serve large than wide. Offer a college. Within month program professional.
Daughter church anyone. Member training manage war service behavior. Recent participant size hit clearly allow.",8:49:34,CHEQUE
ZEZC96782790610481,GB65LENL00340791361820,3/14/2018,1868.43,100002,Y,Personal Care,IE,MOBILE,Dr,10:51:02,16:03:59,4/11/2019,90348501,660.09,5,And president entire research cell. Possible game down cover recent. Travel party market. Suggest indicate mother control large white catch.,13:48:03,CARDS
ZEZC96782790610481,GB65LENL00340791361820,3/14/2018,1208.34,100002,Y,Insurance,MI,POS,Dr,21:20:20,24:03:42,4/11/2019,39543738,660.09,1,Team public time town loss mother. Red magazine store share opportunity operation. Use measure where possible development best growth. Crime adult set us technology soon.,22:13:49,NEFT
ZEZC96782790610481,GB65LENL00340791361820,3/14/2018,2525.26,100002,N,Credited,FF,POS,Cr,8:11:03,11:49:44,4/14/2019,94538366,1316.92,7,"Away then environment. Both tell success lawyer bag per cut.
Pay PM realize service. Woman give president specific similar nice.",10:07:54,DD
ZEZC96782790610481,GB65LENL00340791361820,3/14/2018,3842.18,100002,N,Credited,IE,PC,Cr,15:36:38,17:50:41,4/14/2019,34495445,1316.92,1,"Person event we happen situation hit. Short wide firm if hard consider.
Republican strong drug bit religious. Poor top piece group thing maybe responsibility hour. Series assume buy sea.",16:26:45,NEFT
ZEZC96782790610481,GB65LENL00340791361820,3/14/2018,5159.1,100002,N,Credited,IE,PC,Cr,19:30:17,22:00:55,4/14/2019,70217681,1316.92,7,"Alone continue federal last man with sing. Land inside skin.
Poor oil reason important. Nothing kitchen prepare follow minute necessary certain.",21:00:14,DD
ZEZC96782790610481,GB65LENL00340791361820,3/14/2018,4641.29,100002,Y,Insurance,MI,PC,Dr,7:28:10,11:17:32,4/19/2019,91310347,517.81,1,"Particularly response station site. Term education north often TV beautiful unit discover.
Read factor reflect house itself nearly. Federal list value consider social test friend heart.",9:07:47,NEFT
ZEZC96782790610481,GB65LENL00340791361820,3/14/2018,4123.48,100002,Y,Groceries,MI,POS,Dr,16:28:24,21:03:02,4/19/2019,30519848,517.81,6,Record sort method girl so glass. Drug pull maintain explain either. Administration politics successful manage.,19:07:57,CHEQUE
ZEZC96782790610481,GB65LENL00340791361820,3/14/2018,4074.63,100002,Y,Utilities,CHROME,MOBILE,Dr,19:53:45,29:07:49,4/20/2019,19964577,48.85,1,"Speak hospital voice both inside build. Institution PM recent north everybody some.
Yet just home Mr imagine read. Arm more safe push off.",23:14:05,NEFT
ZEZC96782790610481,GB65LENL00340791361820,3/14/2018,5845.8,100002,N,Credited,EDGE,MOBILE,Cr,5:38:12,8:19:30,4/25/2019,50702923,1771.17,3,"Particular although happen. Prevent first federal company.
Note rock throw without. Former ten in allow alone back new.",7:41:50,RTGS
ZEZC96782790610481,GB65LENL00340791361820,3/14/2018,4074.63,100002,Y,Transportation,FF,POS,Dr,11:02:42,15:06:28,4/25/2019,35671367,1771.17,3,"Official discuss hour loss staff smile professional.
Power letter develop benefit rather night. Consumer activity do hour ground manager or public.",13:14:45,RTGS
ZEZC96782790610481,GB65LENL00340791361820,3/14/2018,5845.8,100002,N,Credited,SAFARI,MOBILE,Cr,15:42:56,17:47:10,4/25/2019,19555126,1771.17,1,Land always difficult attorney accept section. Require eye how capital name fast us your. Unit civil hold finally than successful.,16:18:00,NEFT
ZEZC96782790610481,GB65LENL00340791361820,3/14/2018,4074.63,100002,Y,Personal Care,IE,PC,Dr,19:15:58,20:28:06,4/25/2019,79803045,1771.17,7,"On boy outside letter take hair cover.
Probably sort let nearly bad.
Usually write change tell include key finally. Position discover word. Rather between his success second.",19:53:33,DD
ZEZC96782790610481,GB65LENL00340791361820,3/14/2018,2924.24,100002,Y,Utilities,EDGE,MOBILE,Dr,4:32:31,8:00:57,4/26/2019,24772266,1150.39,3,Visit good imagine spend majority. Finally ago real these glass partner. Of common message about let.,6:05:50,RTGS
ZEZC96782790610481,GB65LENL00340791361820,3/14/2018,1773.85,100002,Y,Medicals,SAFARI,MOBILE,Dr,10:47:27,14:34:25,4/26/2019,52022913,1150.39,7,"American economy couple several degree card. Product with return board or tough film.
Dark particular red class view indicate. Gun billion decade president individual military kitchen.",13:26:52,DD
ZEZC96782790610481,GB65LENL00340791361820,3/14/2018,623.46,100002,Y,Rent,OPERA,PC,Dr,19:17:48,21:54:09,4/26/2019,61041882,1150.39,4,"Material live others get probably fact include allow. Dog create return energy lay can certainly sort. Participant tonight develop TV collection cold son.
Green describe like knowledge.",20:42:40,UPI
ZEZC96782790610481,GB65LENL00340791361820,3/14/2018,1816.08,100002,N,Credited,SAFARI,MOBILE,Cr,19:10:15,20:24:19,5/1/2019,13197919,1192.62,6,"Stock serve return people feeling. Myself able on class. Now yes international each daughter great final.
Opportunity find how take pressure. Room send question language determine.",19:49:19,CHEQUE
ZEZC96782790610481,GB65LENL00340791361820,3/14/2018,3008.7,100002,N,Credited,IE,MOBILE,Cr,19:21:14,21:58:32,5/1/2019,3052273,1192.62,6,"Mean create mission. Health eye number section character hotel table. Rock trade evening nearly ok table. Story me successful direction.
Environment she may challenge issue real.",21:07:58,CHEQUE
ZEZC96782790610481,GB65LENL00340791361820,3/14/2018,2440.47,100002,Y,Household Consumables,MI,PC,Dr,8:50:36,12:23:54,5/2/2019,14210211,568.23,6,Personal choose cause kitchen police option perhaps. Interest parent painting claim prevent join.,11:35:19,CHEQUE
ZEZC96782790610481,GB65LENL00340791361820,3/14/2018,1872.24,100002,Y,Online Shopping,MI,POS,Dr,11:46:16,14:30:18,5/2/2019,57170923,568.23,1,"Decide happy size laugh us affect attack. Animal purpose share work southern before.
Painting employee strategy. Large value he wonder home out natural personal.",12:42:50,NEFT
ZEZC96782790610481,GB65LENL00340791361820,3/14/2018,1304.01,100002,Y,Entertainment,IE,POS,Dr,18:30:02,20:26:49,5/2/2019,14964220,568.23,3,"Skin quality stop plan experience interest. Couple enough get especially. Budget director lead beyond on without.
Development item police manage wish worker guess.",19:37:40,RTGS
ZEZC96782790610481,GB65LENL00340791361820,3/14/2018,2317.55,100002,N,Credited,OPERA,POS,Cr,5:44:41,8:30:07,5/3/2019,73674139,1013.54,4,Far shoulder reason long modern occur number action. Three late media whatever inside my deal.,6:43:48,UPI
ZEZC96782790610481,GB65LENL00340791361820,3/14/2018,1304.01,100002,Y,Dining,FF,MOBILE,Dr,11:35:10,14:28:45,5/3/2019,65681763,1013.54,2,"Practice share environment under create. See citizen next provide.
Return almost recently. Good head once significant. Similar nearly common admit budget.",12:08:32,IMPS
ZEZC96782790610481,GB65LENL00340791361820,3/14/2018,290.47,100002,Y,Groceries,EDGE,POS,Dr,12:57:46,16:13:40,5/3/2019,69036866,1013.54,1,View data side vote. Agency agreement Democrat expert customer college drop. But get full within modern.,15:09:28,NEFT
ZEZC96782790610481,GB65LENL00340791361820,3/14/2018,1304.01,100002,N,Credited,SAFARI,MOBILE,Cr,18:16:07,20:24:43,5/3/2019,70345599,1013.54,6,Prepare join walk suffer expert country service. Debate mind discover bad debate including media doctor. Successful hour need especially. Sort prepare society happy type ten possible.,19:35:10,CHEQUE
ZEZC96782790610481,GB65LENL00340791361820,3/14/2018,1371.67,100002,N,Credited,IE,POS,Cr,6:37:15,9:56:21,5/8/2019,22367525,67.66,3,Must finish concern wait election. Drive week investment long. Modern dark day information sense however deep.,7:59:51,RTGS
ZEZC96782790610481,GB65LENL00340791361820,3/14/2018,1439.33,100002,N,Credited,IE,POS,Cr,8:16:22,10:51:33,5/8/2019,30471580,67.66,2,"Southern amount could attorney perhaps. Product current country its them bill.
Sort nothing throughout prove memory. Call build hard guy run. Yourself remain rest us sort technology.",9:35:46,IMPS
ZEZC96782790610481,GB65LENL00340791361820,3/14/2018,1371.67,100002,Y,Online Shopping,EDGE,POS,Dr,12:36:46,15:12:43,5/8/2019,59330806,67.66,7,"Attorney candidate truth a. Thing real professional dog center piece fall head.
High run guess long that. Choose voice house whole hand area.
Without process place quality during.",13:31:05,DD
ZEZC96782790610481,GB65LENL00340791361820,3/14/2018,1439.33,100002,N,Credited,OPERA,MOBILE,Cr,17:43:26,18:52:14,5/8/2019,81562091,67.66,1,Everything people special machine go choose resource it. Part ever across child anything doctor apply suffer.,18:19:09,NEFT
ZEZC96782790610481,GB65LENL00340791361820,3/14/2018,1506.99,100002,N,Credited,SAFARI,POS,Cr,19:43:03,22:34:58,5/8/2019,94283631,67.66,5,"Everyone prove federal worker. Sure short add example all seek.
Win man explain method. Forward memory increase assume beat who experience.
Long research too feel. Hospital star hundred trouble act.",21:24:40,CARDS
ZEZC96782790610481,GB65LENL00340791361820,3/14/2018,2532.44,100002,N,Credited,FF,MOBILE,Cr,5:26:28,8:38:12,5/21/2019,68576653,1025.45,5,"Interesting because happen when compare little. Whom any money also this. Century but firm partner value health.
Property group five stuff law many follow. Society month four current act force.",7:22:55,CARDS
ZEZC96782790610481,GB65LENL00340791361820,3/14/2018,3557.89,100002,N,Credited,EDGE,PC,Cr,9:07:13,11:43:17,5/21/2019,45446627,1025.45,6,"Human both visit news Mrs. Herself season trip politics quality style. Range live ask church can security wish positive. Police other dark big impact.
Ask billion within make development two culture.",10:28:02,CHEQUE
ZEZC96782790610481,GB65LENL00340791361820,3/14/2018,2532.44,100002,Y,Medicals,CHROME,PC,Dr,16:10:06,17:40:03,5/21/2019,96498590,1025.45,7,Network commercial character feeling public. Safe hit popular response. Just allow report ask. Up future receive cost site none.,17:05:13,DD
ZEZC96782790610481,GB65LENL00340791361820,3/14/2018,1506.99,100002,Y,Entertainment,CHROME,PC,Dr,19:16:55,22:54:22,5/21/2019,89895764,1025.45,5,"Avoid year feeling let. Determine ability worry reason center.
Soldier speech call more last. Card through no. Claim executive look able attorney follow.",20:34:35,CARDS
ZEZC96782790610481,GB65LENL00340791361820,3/14/2018,3301.76,100002,N,Credited,MI,PC,Cr,9:27:47,11:10:40,5/23/2019,46238719,1794.77,6,Heart any trip. Around west ten by head six wear. Describe despite program long last public hand model.,10:34:57,CHEQUE
ZEZC96782790610481,GB65LENL00340791361820,3/14/2018,5096.53,100002,N,Credited,EDGE,PC,Cr,12:21:31,15:09:54,5/23/2019,50683611,1794.77,1,"Exactly others radio total. Country only son understand fear guess bad. Travel analysis door during customer.
Have after clearly wall. Final industry million pass simple.",13:16:58,NEFT
ZEZC96782790610481,GB65LENL00340791361820,3/14/2018,3301.76,100002,Y,Dining,IE,POS,Dr,15:00:07,18:00:37,5/23/2019,90423772,1794.77,1,"Red assume future to left always. Build year economy success site.
Choice break nearly different thousand wear. Nor cold form only social TV. Into by player try.",16:16:05,NEFT
ZEZC96782790610481,GB65LENL00340791361820,3/14/2018,1506.99,100002,Y,Utilities,FF,PC,Dr,18:41:18,20:50:49,5/23/2019,44183103,1794.77,4,"Him seem weight relate. Brother fast fact add work.
Dark heavy seat key. Western participant task industry education wish. Gun institution major attorney long force.",20:11:05,UPI
ZEZC96782790610481,GB65LENL00340791361820,3/14/2018,856.12,100002,Y,Online Shopping,CHROME,PC,Dr,8:05:16,12:43:44,5/29/2019,6277567,650.87,2,"Spend where easy benefit. Certain recently positive guess.
Meeting eat form. I follow newspaper year mention team open.",10:56:12,IMPS
ZEZC96782790610481,GB65LENL00340791361820,3/14/2018,1506.99,100002,N,Credited,IE,MOBILE,Cr,12:31:55,16:03:32,5/29/2019,64651323,650.87,7,Instead just important. Might bad answer fall certainly model race amount. Scientist question alone through minute into partner.,15:13:36,DD
ZEZC96782790610481,GB65LENL00340791361820,3/14/2018,2157.86,100002,N,Credited,SAFARI,PC,Cr,19:13:53,23:00:16,5/29/2019,38200168,650.87,3,Whole business tell window debate. Form concern detail take leave section control. Discuss daughter stuff experience.,22:11:37,RTGS
ZEZC96782790610481,GB65LENL00340791361820,3/14/2018,2938.03,100002,N,Credited,FF,PC,Cr,14:02:27,18:24:56,6/2/2019,9242272,780.17,6,Mission near evening then so base system. Firm decide floor network seat. Mind early half wife face explain. Attack share few particular.,15:58:13,CHEQUE
ZEZC96782790610481,GB65LENL00340791361820,3/14/2018,3718.2,100002,N,Credited,EDGE,POS,Cr,21:47:32,25:53:51,6/2/2019,70922783,780.17,2,Program argue none trade create action. Month simply system them friend source body sign.,23:20:29,IMPS
ZEZC96782790610481,GB65LENL00340791361820,3/14/2018,5363.1,100002,N,Credited,MI,POS,Cr,4:13:05,7:55:15,6/15/2019,53253255,1644.9,2,Discuss former door. Think wife stay final direction road some direction. Message talk some natural small last boy.,5:58:21,IMPS
ZEZC96782790610481,GB65LENL00340791361820,3/14/2018,3718.2,100002,Y,Personal Care,IE,PC,Dr,12:11:12,15:40:10,6/15/2019,3245811,1644.9,3,Member detail cover build wide daughter old. Nothing foot best thing politics.,13:49:41,RTGS
ZEZC96782790610481,GB65LENL00340791361820,3/14/2018,5363.1,100002,N,Credited,FF,PC,Cr,16:45:09,19:12:32,6/15/2019,44689124,1644.9,6,"Thus pressure me interesting. American rule health brother specific always measure. Across factor to fight song last year. Form impact real ready.
Realize fine live subject energy.",18:03:57,CHEQUE
ZEZC96782790610481,GB65LENL00340791361820,3/14/2018,7008,100002,N,Credited,CHROME,MOBILE,Cr,19:23:12,21:52:15,6/15/2019,89553657,1644.9,6,Father result white manage. Born hospital life describe star. Hand woman energy score throughout billion. Second deal ever night often with team.,20:39:48,CHEQUE
ZEZC96782790610481,GB65LENL00340791361820,3/14/2018,6367.31,100002,Y,Personal Care,CHROME,MOBILE,Dr,5:27:40,8:30:47,6/17/2019,8667427,640.69,7,Participant air tough look above certainly. Magazine maybe care police child wonder answer. Foreign floor model note many radio great.,7:32:52,DD
ZEZC96782790610481,GB65LENL00340791361820,3/14/2018,7008,100002,N,Credited,MI,POS,Cr,12:10:14,14:03:00,6/17/2019,57379289,640.69,5,"Win leave time pull. Seven story still mouth same conference evidence.
Myself not task decade create create everything. Attention seem reflect energy level boy bar.",13:14:36,CARDS
ZEZC96782790610481,GB65LENL00340791361820,3/14/2018,6367.31,100002,Y,Household Consumables,MI,PC,Dr,13:41:59,15:56:27,6/17/2019,102780,640.69,5,"Figure tend race region. Large white mention environment long no.
Idea growth up office ahead. Appear some quickly occur line against this explain. Identify lay I treatment yard.",14:45:54,CARDS
ZEZC96782790610481,GB65LENL00340791361820,3/14/2018,5726.62,100002,Y,Entertainment,FF,PC,Dr,22:32:10,24:31:17,6/17/2019,46873439,640.69,1,"Skin protect happy woman. Live draw result.
Partner fly though painting give us. Score fine perform task know off although both.",23:28:23,NEFT
ZEZC96782790610481,GB65LENL00340791361820,3/14/2018,3950.03,100002,Y,Transportation,MI,PC,Dr,17:29:00,24:56:16,6/22/2019,46005700,1776.59,5,Want great perform how behavior ground. Once hospital employee design product. Before together marriage simple life.,19:57:03,CARDS
ZEZC96782790610481,GB65LENL00340791361820,3/14/2018,3383.5,100002,Y,Dining,MI,MOBILE,Dr,6:22:50,9:28:26,7/9/2019,98340804,566.53,5,Pick remember particular far if side. Suggest those matter spend however threat. Traditional half all generation.,8:21:55,CARDS
ZEZC96782790610481,GB65LENL00340791361820,3/14/2018,3950.03,100002,N,Credited,EDGE,POS,Cr,10:51:11,15:03:47,7/9/2019,40505558,566.53,1,Ball weight church sort. War responsibility ball case market them religious. Begin benefit individual every hear second raise step.,12:18:18,NEFT
ZEZC96782790610481,GB65LENL00340791361820,3/14/2018,3383.5,100002,Y,Personal Care,OPERA,MOBILE,Dr,17:38:30,20:39:52,7/9/2019,94249590,566.53,6,"Material TV finally training establish west put. Include more job.
Anything follow book range institution. Read rule fly in enjoy.",19:54:12,CHEQUE
ZEZC96782790610481,GB65LENL00340791361820,3/14/2018,4045.74,100002,N,Credited,FF,POS,Cr,8:29:05,13:01:27,7/13/2019,96248959,662.24,6,Quite them long opportunity because usually attention. Visit month skin rock computer result. Letter prepare generation behavior.,9:51:13,CHEQUE
ZEZC96782790610481,GB65LENL00340791361820,3/14/2018,4707.98,100002,N,Credited,CHROME,MOBILE,Cr,18:12:55,21:30:00,7/13/2019,48188081,662.24,6,Marriage wait picture fall candidate. Issue lead marriage coach artist tree rather probably. Modern fight she decide land modern.,19:48:24,CHEQUE
ZEZC96782790610481,GB65LENL00340791361820,3/14/2018,6188.23,100002,N,Credited,SAFARI,POS,Cr,17:59:15,23:49:59,7/14/2019,54275249,1480.25,2,Include together student. Reveal east turn worker institution. For animal this campaign to chance.,21:03:40,IMPS
ZEZC96782790610481,GB65LENL00340791361820,3/14/2018,5796.05,100002,Y,Insurance,EDGE,POS,Dr,5:39:33,8:35:40,7/21/2019,75539726,392.18,5,"Owner drop bring adult. Discuss its thing mean live.
Effect mouth responsibility meet listen. Look news national send.
Follow probably industry next big support later.",7:18:48,CARDS
ZEZC96782790610481,GB65LENL00340791361820,3/14/2018,5403.87,100002,Y,Dining,OPERA,POS,Dr,10:02:11,11:48:05,7/21/2019,31087742,392.18,5,"Story total will. Animal series five behavior major century sport. Garden participant board cold exactly machine suggest light.
Southern remember on tonight early. Between town subject.",10:32:43,CARDS
ZEZC96782790610481,GB65LENL00340791361820,3/14/2018,5796.05,100002,N,Credited,EDGE,POS,Cr,13:51:36,17:39:52,7/21/2019,60844002,392.18,4,"White I ready single.
Manager conference government begin. Upon study we grow left agent. His animal debate standard wonder window.",15:16:39,UPI
ZEZC96782790610481,GB65LENL00340791361820,3/14/2018,6188.23,100002,N,Credited,EDGE,POS,Cr,21:04:56,24:49:41,7/21/2019,79135856,392.18,3,Reach federal stage far voice bar ten no. Performance discover cell style.,23:19:41,RTGS
ZEZC96782790610481,GB65LENL00340791361820,3/14/2018,6064.21,100002,Y,Dining,IE,PC,Dr,5:53:13,11:02:44,7/29/2019,67302062,124.02,6,"On first sell face method reduce. Attack media decade team improve treat.
Ability become other matter.",9:14:53,CHEQUE
ZEZC96782790610481,GB65LENL00340791361820,3/14/2018,6188.23,100002,N,Credited,EDGE,POS,Cr,15:48:13,22:29:20,7/29/2019,18954821,124.02,1,"Hope marriage town set design medical account. Western into turn agent.
Here remember ahead let. Its produce material chance tell. Respond sport respond nation say choose central standard.",18:43:29,NEFT
ZEZC96782790610481,GB65LENL00340791361820,3/14/2018,5603.15,100002,Y,Groceries,EDGE,POS,Dr,4:27:30,6:56:27,7/30/2019,28232476,585.08,2,Couple available necessary new grow idea. Talk sort write art company blue. Now of cause tell culture stock should.,5:06:20,IMPS
ZEZC96782790610481,GB65LENL00340791361820,3/14/2018,6188.23,100002,N,Credited,IE,POS,Cr,9:34:43,11:47:04,7/30/2019,34585221,585.08,3,"Adult either popular life evidence. Him stay agree mouth Mrs time rather. Determine risk national theory expect ten.
Play act before find power. Community to energy. Democrat yes miss people.",11:20:50,RTGS
ZEZC96782790610481,GB65LENL00340791361820,3/14/2018,6773.31,100002,N,Credited,SAFARI,MOBILE,Cr,12:14:20,14:43:58,7/30/2019,47760622,585.08,5,"Million close still this around. Push party get whatever he value. From mean throw at.
Government room child clear by. Start old close serious professional. Policy off local store.",12:48:58,CARDS
ZEZC96782790610481,GB65LENL00340791361820,3/14/2018,6188.23,100002,Y,Online Shopping,OPERA,MOBILE,Dr,16:41:50,18:10:59,7/30/2019,23529106,585.08,6,"By those board. Rock resource system step.
Blood position value item though sell need. Interesting somebody yourself those brother. You doctor sea case cultural collection argue.",17:22:32,CHEQUE
ZEZC96782790610481,GB65LENL00340791361820,3/14/2018,6773.31,100002,N,Credited,FF,MOBILE,Cr,19:24:58,21:49:13,7/30/2019,74782895,585.08,6,Public benefit effect cold arm effort talk character. Add where throw mission situation really than create. Truth laugh guess maintain nothing such. Set full growth example.,20:19:23,CHEQUE
ZEZC96782790610481,GB65LENL00340791361820,3/14/2018,8308.66,100002,N,Credited,IE,MOBILE,Cr,8:43:38,13:39:01,8/12/2019,99988340,1535.35,5,"Something all board recognize.
Ground couple trip open leave order recognize list. Politics whole knowledge pick everyone level. Husband position great best can five say.",10:30:29,CARDS
ZEZC96782790610481,GB65LENL00340791361820,3/14/2018,6773.31,100002,Y,Rent,CHROME,PC,Dr,20:28:01,25:49:56,8/12/2019,18956887,1535.35,1,"Have already her check item.
Nearly camera travel project collection reflect. Teach model rather. Visit PM one approach.",23:21:23,NEFT
ZEZC96782790610481,GB65LENL00340791361820,3/14/2018,5634.09,100002,Y,Entertainment,IE,MOBILE,Dr,12:37:36,17:51:02,8/17/2019,76766367,1139.22,4,"Company on player choice. Card trade throughout idea century candidate coach. Baby until reason focus.
Best such gas store accept. Right pick should author notice light yeah behavior.",15:17:49,UPI
ZEZC96782790610481,GB65LENL00340791361820,3/14/2018,4494.87,100002,Y,Utilities,FF,POS,Dr,20:25:36,24:59:04,8/17/2019,58810828,1139.22,6,"Off find business rock office hear. Soon page team administration. Tough drop prevent face discuss.
Pass ok player plant expert. Individual interesting third charge.",22:19:07,CHEQUE
ZEZC96782790610481,GB65LENL00340791361820,3/14/2018,5247.39,100002,N,Credited,EDGE,PC,Cr,7:38:12,10:41:20,8/23/2019,14656620,752.52,7,House sea safe him day sport win. Image direction argue hundred.,8:27:14,DD
ZEZC96782790610481,GB65LENL00340791361820,3/14/2018,5999.91,100002,N,Credited,OPERA,POS,Cr,14:52:26,19:06:41,8/23/2019,51334574,752.52,2,Member day themselves figure military what lose building. Never without artist along that station western base.,17:01:10,IMPS
ZEZC96782790610481,GB65LENL00340791361820,3/14/2018,4437.28,100002,Y,Rent,OPERA,PC,Dr,10:03:41,16:35:08,8/27/2019,42301271,1562.63,6,"Would room difference note.
Forward one society. Court activity through student bit child word.
Onto growth tax pass provide. Case culture rich specific price threat.",12:43:03,CHEQUE
ZEZC96782790610481,GB65LENL00340791361820,3/14/2018,2874.65,100002,Y,Personal Care,OPERA,PC,Dr,21:48:30,27:44:39,8/27/2019,49171464,1562.63,7,"Receive during key old anything watch spend they. Level while address take pretty.
Field recent always read. Material human focus time may garden. Gun budget the full what.",23:46:26,DD
ZEZC96782790610481,GB65LENL00340791361820,3/14/2018,4285.38,100002,N,Credited,FF,POS,Cr,4:51:44,6:54:40,9/8/2019,74308385,1410.73,1,"Expert such day page. Charge cut join must government short sister.
Partner nothing deep poor energy. Both discuss like understand beautiful.
Born actually human note last.",6:26:35,NEFT
ZEZC96782790610481,GB65LENL00340791361820,3/14/2018,2874.65,100002,Y,Transportation,OPERA,POS,Dr,9:08:15,11:54:45,9/8/2019,46081056,1410.73,2,Compare likely property market one budget far. Fear him decade treatment form. Away source may represent occur. Herself defense size stand throughout cup two their.,10:13:40,IMPS
ZEZC96782790610481,GB65LENL00340791361820,3/14/2018,4285.38,100002,N,Credited,SAFARI,PC,Cr,11:30:05,13:29:54,9/8/2019,94966787,1410.73,7,"Less account guy project enter today. Subject offer travel change.
Success behavior us lawyer central indicate future. Value whole into there themselves. Partner seek sign choice she those feel.",12:03:24,DD
ZEZC96782790610481,GB65LENL00340791361820,3/14/2018,2874.65,100002,Y,Dining,SAFARI,PC,Dr,16:32:55,18:41:24,9/8/2019,68573096,1410.73,7,Southern pattern radio here economy imagine short court. Get learn someone green sign bar. Low draw could what. Close defense long.,18:01:53,DD
ZEZC96782790610481,GB65LENL00340791361820,3/14/2018,4285.38,100002,N,Credited,CHROME,POS,Cr,19:51:36,23:44:05,9/8/2019,43713639,1410.73,2,Player yeah board project. Across party show.,21:51:13,IMPS
ZEZC96782790610481,GB65LENL00340791361820,3/14/2018,5956.3,100002,N,Credited,IE,POS,Cr,8:05:52,11:20:44,9/13/2019,78422919,1670.92,6,Particular there writer measure. Offer baby possible significant. Rock trade far law will rise term look.,9:28:49,CHEQUE
ZEZC96782790610481,GB65LENL00340791361820,3/14/2018,4285.38,100002,Y,Personal Care,MI,MOBILE,Dr,13:31:47,15:12:00,9/13/2019,94632002,1670.92,6,"Toward cold Republican hear. Two organization scientist professional.
Campaign real early have break. Green garden before huge might action inside.",14:04:41,CHEQUE
ZEZC96782790610481,GB65LENL00340791361820,3/14/2018,2614.46,100002,Y,Groceries,OPERA,MOBILE,Dr,14:14:50,17:15:18,9/13/2019,55620888,1670.92,1,"Piece friend side Mrs. Police glass production everyone well carry care.
Age defense difference forward. Decide country report glass three.",16:19:18,NEFT
ZEZC96782790610481,GB65LENL00340791361820,3/14/2018,4285.38,100002,N,Credited,SAFARI,PC,Cr,19:44:00,23:22:02,9/13/2019,41833469,1670.92,5,Parent be people writer. Staff follow key more per security whom candidate. Talk represent citizen former natural detail clear.,21:55:17,CARDS
ZEZC96782790610481,GB65LENL00340791361820,3/14/2018,2293.4,100002,Y,Medicals,FF,POS,Dr,18:07:28,27:14:12,9/27/2019,61844476,1991.98,1,Threat whole maybe public we send. Off step these we actually despite she. Gas somebody letter company subject degree. Region pretty us feeling become prevent.,21:16:58,NEFT
ZEZC96782790610481,GB65LENL00340791361820,3/14/2018,837.62,100002,Y,Utilities,SAFARI,PC,Dr,11:55:59,19:09:27,9/29/2019,81171101,1455.78,4,"Child special particular film how. Officer effort human cell phone although owner.
President glass move current leave.",14:17:08,UPI
ZEZC96782790610481,GB65LENL00340791361820,3/14/2018,2458.88,100002,N,Credited,MI,PC,Cr,21:07:41,24:56:24,10/11/2019,78982017,1621.26,7,"Fact old order fly day against interest.
Different performance late why identify change. Billion project reach ago.
Draw name represent quickly help business.",23:14:29,DD
ZEZC96782790610481,GB65LENL00340791361820,3/14/2018,2296.81,100002,Y,Entertainment,OPERA,POS,Dr,5:44:42,8:13:37,10/13/2019,78002067,162.07,4,Staff conference likely. Accept method great be authority. Resource various oil arrive well power. Billion might movie responsibility easy.,6:34:03,UPI
ZEZC96782790610481,GB65LENL00340791361820,3/14/2018,2458.88,100002,N,Credited,MI,MOBILE,Cr,8:28:51,9:47:38,10/13/2019,15167866,162.07,5,"Read suddenly late sister within phone treat. New attention short response. Wrong writer clear party.
Check thing part say require. For western could list run animal from.",9:04:23,CARDS
ZEZC96782790610481,GB65LENL00340791361820,3/14/2018,2296.81,100002,Y,Insurance,SAFARI,MOBILE,Dr,14:01:04,16:26:59,10/13/2019,61172142,162.07,3,"Far bring race opportunity happen generation. Discussion store than trouble already. Alone pressure federal learn threat listen ten.
Account bring street. Middle the enter save present notice.",14:44:49,RTGS
ZEZC96782790610481,GB65LENL00340791361820,3/14/2018,2134.74,100002,Y,Household Consumables,SAFARI,POS,Dr,15:14:34,17:19:37,10/13/2019,28745778,162.07,5,"Generation clear newspaper. Sing interesting public number wait. Woman entire finish matter break.
President nice drop impact. Cause fly fact method later front site.",16:32:09,CARDS
ZEZC96782790610481,GB65LENL00340791361820,3/14/2018,1972.67,100002,Y,Personal Care,CHROME,PC,Dr,20:46:16,22:12:03,10/13/2019,515658,162.07,4,Everybody interest point we. Seek yes around view international left. Whether attorney hot too military upon.,21:32:19,UPI
ZEZC96782790610481,GB65LENL00340791361820,3/14/2018,177.11,100002,Y,Online Shopping,FF,POS,Dr,5:11:54,11:23:01,10/20/2019,65267851,1795.56,4,Face gun rule of policy lose assume figure. Visit available under suddenly close. Writer discover never piece.,8:37:06,UPI
ZEZC96782790610481,GB65LENL00340791361820,3/14/2018,410.18,100002,N,Credited,EDGE,POS,Cr,10:25:51,14:39:25,11/8/2019,48324182,233.07,3,"Down sometimes method no such. My travel simple behavior force expect. Loss nation air return.
Write democratic pattern.
Another brother tonight remember.
Sure toward power garden system interesting.",13:07:40,RTGS
ZEZC96782790610481,GB65LENL00340791361820,3/14/2018,177.11,100002,Y,Groceries,MI,MOBILE,Dr,19:08:05,23:19:37,11/8/2019,11614470,233.07,4,"Million open ok young since. Hear police discuss. While science spring.
Then one apply professor view. Edge student fill campaign clearly.",21:20:51,UPI
ZEZC96782790610481,GB65LENL00340791361820,3/14/2018,1214.5,100002,N,Credited,SAFARI,PC,Cr,16:48:22,19:30:04,11/12/2019,49275827,1037.39,5,"Everyone all could strong away. Focus third front project same. From parent design fire trip.
Research source dream sure. Trouble eye work.",18:24:03,CARDS
ZEZC96782790610481,GB65LENL00340791361820,3/14/2018,414.14,100002,Y,Groceries,SAFARI,POS,Dr,15:33:02,23:36:44,11/14/2019,9442337,800.36,7,"Risk hard beautiful single win actually. Never rock never must. Research role her case such.
Necessary fish necessary phone so section.",21:15:01,DD
ZEZC96782790610481,GB65LENL00340791361820,3/14/2018,2375.24,100002,N,Credited,IE,PC,Cr,11:36:41,18:11:36,11/29/2019,49200072,1961.1,4,Customer least school particular drug view may. Take build worker hundred try letter. From thing avoid piece this.,15:14:35,UPI
ZEZC96782790610481,GB65LENL00340791361820,3/14/2018,4336.34,100002,N,Credited,IE,MOBILE,Cr,13:17:12,19:34:40,11/29/2019,38408168,1961.1,4,Someone fish ground establish rather either former. Ball reach visit possible campaign marriage space program. Learn coach general let get soon high.,17:10:21,UPI
ZEZC96782790610481,GB65LENL00340791361820,3/14/2018,4835.62,100002,N,Credited,CHROME,POS,Cr,9:39:54,17:11:13,12/6/2019,97241485,499.28,5,"Use national instead I. Once present song fine break set position professor.
End condition civil across power health form. Billion eat conference few. Important impact staff exactly.",14:06:18,CARDS
ZEZC96782790610481,GB65LENL00340791361820,3/14/2018,5256.89,100002,N,Credited,IE,PC,Cr,4:36:35,6:32:47,12/8/2019,22234452,421.27,7,General quite mention student. Responsibility one wrong book newspaper rock civil. Walk paper fish instead medical with plan.,5:48:09,DD
ZEZC96782790610481,GB65LENL00340791361820,3/14/2018,5678.16,100002,N,Credited,SAFARI,PC,Cr,7:32:00,10:07:01,12/8/2019,15352125,421.27,1,"Think rich better under ask fact recent. Garden play data. Expect everybody different. High seven ready act see church war law.
Some land skin establish. Her wear else add imagine five.",8:17:47,NEFT
ZEZC96782790610481,GB65LENL00340791361820,3/14/2018,6099.43,100002,N,Credited,FF,MOBILE,Cr,14:29:10,16:43:48,12/8/2019,91860569,421.27,7,Part player picture item situation point peace. Continue central effort dream. One program wait western follow ask instead trouble.,15:50:52,DD
ZEZC96782790610481,GB65LENL00340791361820,3/14/2018,5678.16,100002,Y,Rent,MI,POS,Dr,16:08:21,18:31:53,12/8/2019,56298567,421.27,4,Second such political prove society herself green. Some technology may animal time. Head region would start building Republican for.,17:31:56,UPI
ZEZC96782790610481,GB65LENL00340791361820,3/14/2018,6099.43,100002,N,Credited,CHROME,MOBILE,Cr,19:18:08,22:18:57,12/8/2019,68380526,421.27,2,Rock firm never conference. Become machine discuss measure mean education. Matter another lay reduce dog member public phone.,20:32:47,IMPS
ZEZC96782790610481,GB65LENL00340791361820,3/14/2018,6398.44,100002,N,Credited,MI,POS,Cr,20:08:07,27:17:51,12/17/2019,2998060,299.01,4,"Nothing Congress turn institution. Base could theory wide.
Shake spring establish bit bank various public. Wrong theory true everyone.",22:11:10,UPI
ZEZC96782790610481,GB65LENL00340791361820,3/14/2018,6117.78,100002,Y,Household Consumables,FF,PC,Dr,16:11:20,24:41:38,12/18/2019,48518789,280.66,3,"What bed several position business. Wear strong art leader especially stop front.
Get fund same the pretty class. Stock environmental art establish.",19:36:45,RTGS
ZEZC96782790610481,GB65LENL00340791361820,3/14/2018,6939.32,100002,N,Credited,SAFARI,MOBILE,Cr,6:08:35,7:39:02,12/19/2019,36734269,821.54,2,Article four Democrat summer join improve. Position while help training voice. Study major speech third police table nearly during.,6:53:50,IMPS
ZEZC96782790610481,GB65LENL00340791361820,3/14/2018,7760.86,100002,N,Credited,OPERA,POS,Cr,7:05:17,8:34:09,12/19/2019,45061356,821.54,4,"Whom cause institution plant nature century remain. According third character week glass over. Relationship pull region level throw.
Lawyer name charge right. North though sit too.",8:01:33,UPI
ZEZC96782790610481,GB65LENL00340791361820,3/14/2018,8582.4,100002,N,Credited,EDGE,POS,Cr,13:05:37,14:23:20,12/19/2019,13440091,821.54,5,Property deep central hospital. Film sport position clearly. Industry community church more.,13:44:41,CARDS
ZEZC96782790610481,GB65LENL00340791361820,3/14/2018,7760.86,100002,Y,Rent,OPERA,MOBILE,Dr,16:52:21,19:42:21,12/19/2019,15236227,821.54,4,Newspaper office Mr when pick director hard. Common weight knowledge station indicate performance upon guess. Series magazine three color practice.,18:35:53,UPI
ZEZC96782790610481,GB65LENL00340791361820,3/14/2018,8582.4,100002,N,Credited,OPERA,MOBILE,Cr,20:26:33,23:30:14,12/19/2019,29109036,821.54,1,"Quality position few stock likely. Leader suddenly ahead surface quality. Later able old mind.
Analysis give nature somebody. Little whom fine property situation general short.",21:40:06,NEFT
ZEZC96782790610481,GB65LENL00340791361820,3/14/2018,9715.48,100002,N,Credited,CHROME,MOBILE,Cr,4:59:41,8:20:11,12/22/2019,67480760,1133.08,1,"Own of garden size. Always short raise. Song again teach product image entire site. Election before doctor trouble national.
Price cut these. Page serious natural explain compare federal.",7:18:50,NEFT
ZEZC96782790610481,GB65LENL00340791361820,3/14/2018,10848.56,100002,N,Credited,FF,PC,Cr,10:37:03,13:31:16,12/22/2019,49448481,1133.08,2,"Hair vote main thousand too. Others interest alone water.
Day institution onto kind certain their after. Job what into laugh. Eat hear benefit store north east stand.",11:15:26,IMPS
ZEZC96782790610481,GB65LENL00340791361820,3/14/2018,11981.64,100002,N,Credited,IE,POS,Cr,17:00:15,20:59:22,12/22/2019,23012592,1133.08,4,"Management several door could. News must process foreign should.
Best crime including add.",18:51:47,UPI
ZEZC96782790610481,GB65LENL00340791361820,3/14/2018,10848.56,100002,Y,Medicals,OPERA,MOBILE,Dr,21:15:27,25:30:21,12/22/2019,31738682,1133.08,2,"Religious cup fact cold beyond. Response somebody central.
Teach however along level common two. Trouble black box author value century sport. Allow test authority.",23:26:04,IMPS
ZEZC96782790610481,GB65LENL00340791361820,3/14/2018,12471.4,100002,N,Credited,EDGE,POS,Cr,7:24:35,18:24:49,12/31/2019,90601002,1622.84,6,"Sometimes central class job before fact. Firm since already offer develop.
Institution head over.
Agency hand that. At oil bed.",13:03:07,CHEQUE
ZEZC96782790610481,GB65LENL00340791361820,3/14/2018,13869.09,100002,N,Credited,OPERA,MOBILE,Cr,6:01:23,9:31:41,1/18/2020,90660238,1397.69,7,"Number not also effect increase author environmental.
Claim glass now though read. Cultural dark fear accept cell too stock. Anyone time family anything tell.",8:08:06,DD
ZEZC96782790610481,GB65LENL00340791361820,3/14/2018,15266.78,100002,N,Credited,OPERA,PC,Cr,11:51:04,16:14:25,1/18/2020,35435624,1397.69,1,"Action support commercial trial. Husband law door pass.
Task option marriage. Truth enjoy best instead second public area.",14:01:58,NEFT
ZEZC96782790610481,GB65LENL00340791361820,3/14/2018,16664.47,100002,N,Credited,CHROME,PC,Cr,13:07:55,15:50:23,1/18/2020,25543018,1397.69,2,"Address light professor tonight require community camera. Hear among stand memory.
Since control white bag even. Boy be case strategy.",14:44:34,IMPS
ZEZC96782790610481,GB65LENL00340791361820,3/14/2018,18062.16,100002,N,Credited,EDGE,PC,Cr,20:16:33,24:12:13,1/18/2020,33477688,1397.69,3,"Marriage son decision turn so.
Least record very. Conference significant dream investment sound.
Race just may spring. Republican work say name nice company five. Mean series expert message.",22:27:37,RTGS
ZEZC96782790610481,GB65LENL00340791361820,3/14/2018,18385.22,100002,N,Credited,EDGE,POS,Cr,9:12:54,15:51:48,1/23/2020,18781472,323.06,6,Wide mouth weight not pay answer lose. Without why production gun design. Market current someone home but. Consider discover crime within.,12:01:24,CHEQUE
ZEZC96782790610481,GB65LENL00340791361820,3/14/2018,18708.28,100002,N,Credited,MI,MOBILE,Cr,17:06:30,20:30:35,1/23/2020,76255380,323.06,6,Set million customer close upon. Car control forget capital general measure responsibility style. Cause way group nice arm medical. State executive each over still writer.,18:42:26,CHEQUE
ZEZC96782790610481,GB65LENL00340791361820,3/14/2018,17172.41,100002,Y,Dining,IE,PC,Dr,5:44:17,8:37:26,2/3/2020,62377379,1535.87,1,"Herself very control success establish. Investment high by middle space vote staff. General affect sit guess before.
Trip man true general serve owner. Plant task recent cell.",7:07:15,NEFT
ZEZC96782790610481,GB65LENL00340791361820,3/14/2018,18708.28,100002,N,Credited,CHROME,POS,Cr,10:00:52,11:32:23,2/3/2020,13986476,1535.87,6,Stock Democrat four couple decision conference simply. Husband what upon peace modern.,10:28:30,CHEQUE
ZEZC96782790610481,GB65LENL00340791361820,3/14/2018,17172.41,100002,Y,Household Consumables,SAFARI,MOBILE,Dr,12:42:33,15:43:26,2/3/2020,88762920,1535.87,3,Fast exactly thus red water. Power ability building month eight tough. Movie require stop report not yard how. Employee example among.,14:17:31,RTGS
ZEZC96782790610481,GB65LENL00340791361820,3/14/2018,15636.54,100002,Y,Personal Care,SAFARI,POS,Dr,16:54:33,20:25:54,2/3/2020,63028355,1535.87,4,"Goal picture health involve suggest. Truth office new situation.
Rule street number board. Arrive success relate along.",18:45:49,UPI
ZEZC96782790610481,GB65LENL00340791361820,3/14/2018,17172.41,100002,N,Credited,IE,PC,Cr,20:23:39,21:51:42,2/3/2020,35343004,1535.87,4,"Agreement director peace three. Nation organization your simply debate.
Generation cultural order ever others least. Away others pull long just. Hope direction hot we of care.",21:05:52,UPI
ZEZC96782790610481,GB65LENL00340791361820,3/14/2018,18404.78,100002,N,Credited,OPERA,PC,Cr,7:05:47,16:38:01,2/6/2020,16351301,1232.37,6,"Movement spend ok a. Assume certainly his military model.
School seem by end member he. Candidate air avoid second school painting.",12:41:26,CHEQUE
ZEZC96782790610481,GB65LENL00340791361820,3/14/2018,20090.51,100002,N,Credited,FF,POS,Cr,5:18:18,8:24:15,2/8/2020,96677988,1685.73,1,"Who research oil open others artist. Home still who develop very ability citizen.
Ever if out teach suffer drug. Other modern member safe cover spring. Quite eat concern scientist protect kind.",7:02:07,NEFT
ZEZC96782790610481,GB65LENL00340791361820,3/14/2018,18404.78,100002,Y,Medicals,EDGE,POS,Dr,9:28:25,11:08:16,2/8/2020,82734077,1685.73,2,"Hope middle along. Force best certain audience.
Military Republican art coach other tree stand.
Through yes turn similar even wait box. Great cost during car think. Ability decade police consider.",10:00:00,IMPS
ZEZC96782790610481,GB65LENL00340791361820,3/14/2018,16719.05,100002,Y,Medicals,OPERA,POS,Dr,11:11:20,14:17:25,2/8/2020,75301828,1685.73,1,"Growth environment build final. Senior well production.
Card hour win firm single same participant citizen.
Method leg customer you science need.",12:20:08,NEFT
ZEZC96782790610481,GB65LENL00340791361820,3/14/2018,18404.78,100002,N,Credited,OPERA,MOBILE,Cr,19:12:49,20:34:56,2/8/2020,19603445,1685.73,6,"Health law must often girl name morning.
Outside girl cover probably kid like. Between give president management. Be agent service cover agency. Pattern responsibility expect bed trade deal.",19:46:23,CHEQUE
ZEZC96782790610481,GB65LENL00340791361820,3/14/2018,16719.05,100002,Y,Utilities,IE,PC,Dr,21:34:51,24:05:45,2/8/2020,4055419,1685.73,2,"Model such trouble save voice economy rich order. Effect page recognize news follow hear section. Learn herself water song.
Production quite body high. Compare to claim right keep.",22:51:41,IMPS
ZEZC96782790610481,GB65LENL00340791361820,3/14/2018,16787.2,100002,N,Credited,SAFARI,POS,Cr,6:15:15,11:25:17,3/6/2020,95348650,68.15,4,Them reduce line finally. Last life dream when. Before like cell affect.,8:57:57,UPI
ZEZC96782790610481,GB65LENL00340791361820,3/14/2018,16855.35,100002,N,Credited,EDGE,MOBILE,Cr,15:16:50,18:03:31,3/6/2020,84412492,68.15,6,"Personal culture one blue.
Then daughter billion ahead throw. Doctor child attention you identify.",16:17:08,CHEQUE
ZEZC96782790610481,GB65LENL00340791361820,3/14/2018,16405.36,100002,Y,Dining,OPERA,PC,Dr,4:45:07,8:57:23,3/18/2020,23554382,449.99,3,Or matter during bill ten bank fire. Turn clearly throw. Man add piece picture strategy daughter actually ahead. President somebody rich prove big trouble.,7:02:52,RTGS
ZEZC96782790610481,GB65LENL00340791361820,3/14/2018,16855.35,100002,N,Credited,SAFARI,POS,Cr,11:57:13,14:31:01,3/18/2020,27481158,449.99,1,"Like time within end clearly store character. Community instead check fire everyone or.
Half discuss line believe record. Party sort plan tree key single word. Any discussion travel ground less.",13:33:25,NEFT
ZEZC96782790610481,GB65LENL00340791361820,3/14/2018,16405.36,100002,Y,Dining,CHROME,POS,Dr,20:34:30,24:55:25,3/18/2020,93613521,449.99,7,"During traditional stage other letter here hold maintain. Person yard guess pick summer forward. Television effect election ability evidence us.
Financial trial fear program. I religious property.",22:36:47,DD
ZEZC96782790610481,GB65LENL00340791361820,3/14/2018,14888.33,100002,Y,Groceries,CHROME,POS,Dr,13:45:31,16:45:02,3/19/2020,23059405,1517.03,3,"Bag language office fire.
Exactly crime knowledge also. Reveal decade around. Beyond energy response.",14:49:07,RTGS
ZEZC96782790610481,GB65LENL00340791361820,3/14/2018,13371.3,100002,Y,Household Consumables,EDGE,MOBILE,Dr,18:46:00,23:22:21,3/19/2020,27072653,1517.03,7,"Owner today camera wind wonder second. Car remain impact sometimes training likely. Season clearly our other Republican.
Possible state serious deal worry guess. Spend laugh her class.",21:29:33,DD
ZEZC96782790610481,GB65LENL00340791361820,3/14/2018,13907.78,100002,N,Credited,OPERA,POS,Cr,8:53:21,12:17:33,3/20/2020,14078491,536.48,2,Ball trade like music yes. Suffer him eye each south begin star. Truth two him window continue lot remain.,10:39:26,IMPS
ZEZC96782790610481,GB65LENL00340791361820,3/14/2018,14444.26,100002,N,Credited,OPERA,PC,Cr,15:34:35,17:42:54,3/20/2020,87370348,536.48,3,"Agreement wind deep record environmental it east. Guess little money whether. Son sign between thought political news.
Sound father return thus compare well.",16:46:12,RTGS
ZEZC96782790610481,GB65LENL00340791361820,3/14/2018,14980.74,100002,N,Credited,EDGE,POS,Cr,19:52:19,22:57:44,3/20/2020,76721533,536.48,3,"Toward popular within television detail person common. Manage popular sea third.
Deep because remember discuss near my. Store it happy enter education.",22:20:29,RTGS
ZEZC96782790610481,GB65LENL00340791361820,3/14/2018,13210.61,100002,Y,Insurance,FF,POS,Dr,18:08:43,22:21:19,3/23/2020,21577253,1770.13,3,"Hundred energy fact point. Even couple nature sense concern character.
Letter accept manage tell. Point road cultural write finally. Item rule anyone girl market opportunity.",19:42:41,RTGS
ZEZC96782790610481,GB65LENL00340791361820,3/14/2018,14522.69,100002,N,Credited,MI,PC,Cr,9:09:14,13:49:30,3/25/2020,48423731,1312.08,4,"Entire identify really tax. Treatment see be card quality dream wait.
Day not professor return safe success table actually. She beyond son rest which.",10:51:20,UPI
ZEZC96782790610481,GB65LENL00340791361820,3/14/2018,13210.61,100002,Y,Insurance,MI,PC,Dr,12:16:47,16:14:05,3/25/2020,75975098,1312.08,1,Good citizen career so billion huge focus back. Need behavior off only development former here feeling. Would account business day.,14:56:02,NEFT
ZEZC96782790610481,GB65LENL00340791361820,3/14/2018,14522.69,100002,N,Credited,OPERA,MOBILE,Cr,18:53:30,23:39:52,3/25/2020,11866886,1312.08,7,"Responsibility more back charge son explain especially heavy. Board bring property look task.
Once citizen rest or budget series community. Become happy shoulder. Feeling animal different culture.",21:36:35,DD
ZEZC96782790610481,GB65LENL00340791361820,3/14/2018,15062.05,100002,N,Credited,MI,POS,Cr,13:34:43,17:55:45,4/2/2020,81507924,539.36,3,"Series wrong provide despite. Other fund involve interview close three record work. Clearly prevent decision.
But serve stuff away social single teacher. Test whom product economic huge wait.",15:18:51,RTGS
ZEZC96782790610481,GB65LENL00340791361820,3/14/2018,15601.41,100002,N,Credited,SAFARI,POS,Cr,13:13:09,17:34:29,4/2/2020,92821330,539.36,7,"Under term people radio.
Own base cold stuff discussion value. Reflect theory example hold simple oil need. Realize doctor treatment get response up. Many buy dinner bag particular appear phone.",16:03:38,DD
ZEZC96782790610481,GB65LENL00340791361820,3/14/2018,14402.65,100002,Y,Dining,CHROME,POS,Dr,6:40:57,9:21:21,4/8/2020,39691590,1198.76,5,"Fill hope source. Those yet step assume use bar.
Quickly but better. Ability government model including.
Natural know man. Human TV physical compare song start message.",7:29:46,CARDS
ZEZC96782790610481,GB65LENL00340791361820,3/14/2018,13203.89,100002,Y,Utilities,MI,MOBILE,Dr,8:29:32,11:30:20,4/8/2020,18432206,1198.76,6,Party seven accept sport rise determine general. Think answer food and run small. Phone development central close race human himself.,9:42:08,CHEQUE
ZEZC96782790610481,GB65LENL00340791361820,3/14/2018,12005.13,100002,Y,Entertainment,MI,MOBILE,Dr,13:38:05,17:45:05,4/8/2020,96667552,1198.76,6,"Hospital red prevent our end. Speech story parent program without card. Game international space message.
Him field say ok theory financial Mrs.
Decision home herself. Leader play standard identify.",15:21:20,CHEQUE
ZEZC96782790610481,GB65LENL00340791361820,3/14/2018,10806.37,100002,Y,Medicals,EDGE,PC,Dr,19:17:46,22:56:40,4/8/2020,42055563,1198.76,6,"Court involve else than matter trip many.
Success prove picture something spend. Care will sister shoulder. Against along social Mrs bring name provide.",21:29:39,CHEQUE
ZEZC96782790610481,GB65LENL00340791361820,3/14/2018,11077.05,100002,N,Credited,MI,PC,Cr,5:24:32,10:37:44,4/10/2020,89266311,270.68,6,"Message education wife federal indicate sort board. Long age everybody have lose or everything.
Over series without if opportunity determine even.",8:14:36,CHEQUE
ZEZC96782790610481,GB65LENL00340791361820,3/14/2018,10806.37,100002,Y,Personal Care,IE,POS,Dr,11:55:56,14:02:32,4/10/2020,1147094,270.68,7,Argue east information magazine. Field traditional foot available development benefit.,13:14:11,DD
ZEZC96782790610481,GB65LENL00340791361820,3/14/2018,11077.05,100002,N,Credited,OPERA,POS,Cr,18:40:59,20:23:27,4/10/2020,26236858,270.68,5,"Physical seem partner table memory. Herself win goal value camera.
Officer our small buy. Human outside security under.
Scene happen message. By seem figure shoulder. Want number to.",19:32:17,CARDS
ZEZC96782790610481,GB65LENL00340791361820,3/14/2018,11171.33,100002,N,Credited,IE,PC,Cr,5:34:16,7:59:22,4/20/2020,39734044,94.28,5,"Federal few she themselves live.
Later player I skin lead. Rich station let son view modern happy it. Anyone hard heavy television onto administration day.",6:22:19,CARDS
ZEZC96782790610481,GB65LENL00340791361820,3/14/2018,11077.05,100002,Y,Household Consumables,MI,POS,Dr,14:27:21,18:34:52,4/20/2020,4039778,94.28,1,"Foreign color question away born. Individual executive very note system. Or pressure education hair.
Quite stock wait game moment. Dog hard baby study adult.",15:49:52,NEFT
ZEZC96782790610481,GB65LENL00340791361820,3/14/2018,10982.77,100002,Y,Online Shopping,SAFARI,POS,Dr,20:27:44,23:57:28,4/20/2020,72790557,94.28,3,"About compare politics record.
Fly mind hospital. Research degree chance rich guy week. News computer space.
Law billion improve in lose site environmental. Vote at keep.",22:47:09,RTGS
ZEZC96782790610481,GB65LENL00340791361820,3/14/2018,11767.01,100002,N,Credited,CHROME,PC,Cr,4:59:41,9:20:46,4/27/2020,68694470,784.24,2,Free well two knowledge organization stock. Set heavy sense really treat born south. Sign say full first who. Leave want rise yard.,6:58:56,IMPS
ZEZC96782790610481,GB65LENL00340791361820,3/14/2018,12551.25,100002,N,Credited,MI,POS,Cr,11:03:31,14:52:55,4/27/2020,45831331,784.24,6,We include hope bring nice must new. History visit agency meeting base. Plant bill school party crime sound million.,12:44:14,CHEQUE
ZEZC96782790610481,GB65LENL00340791361820,3/14/2018,13335.49,100002,N,Credited,MI,POS,Cr,16:36:51,19:55:37,4/27/2020,30159129,784.24,3,"Eat organization strong picture husband natural.
Various subject edge structure create. Indicate itself explain level challenge. Possible vote even table nearly minute.
Do onto little star purpose.",18:59:18,RTGS
ZEZC96782790610481,GB65LENL00340791361820,3/14/2018,12551.25,100002,Y,Medicals,OPERA,POS,Dr,18:30:36,22:33:04,4/27/2020,37774103,784.24,5,"Knowledge audience light herself test. Such rock still ten Congress.
Method factor democratic find. Society nature science.",20:52:52,CARDS
ZEZC96782790610481,GB65LENL00340791361820,3/14/2018,13860.43,100002,N,Credited,FF,MOBILE,Cr,6:31:15,11:09:56,5/2/2020,81383849,1309.18,2,"Question seven home rest attack month. Put very when your first best.
Fine culture long certain. Population nice offer year some. Training book bad a would seek.",8:16:02,IMPS
ZEZC96782790610481,GB65LENL00340791361820,3/14/2018,12551.25,100002,Y,Personal Care,OPERA,POS,Dr,15:10:22,17:39:12,5/2/2020,68096885,1309.18,4,He kitchen school military. Quality itself wind black let everyone.,16:33:21,UPI
ZEZC96782790610481,GB65LENL00340791361820,3/14/2018,13860.43,100002,N,Credited,IE,MOBILE,Cr,17:26:40,20:49:52,5/2/2020,84974006,1309.18,6,"Never year quality usually blood. Fight stop guess her performance. Culture gun summer already.
Later those full city. Consider lead among factor these risk young people.",19:13:42,CHEQUE
ZEZC96782790610481,GB65LENL00340791361820,3/14/2018,13872.52,100002,N,Credited,SAFARI,POS,Cr,9:50:38,13:33:07,5/5/2020,36658572,12.09,2,"Skin short read maintain author analysis find where. Plant art commercial if author across. Part test investment performance degree environment candidate.
Find single want detail reflect friend in.",11:20:09,IMPS
ZEZC96782790610481,GB65LENL00340791361820,3/14/2018,13860.43,100002,Y,Personal Care,MI,POS,Dr,13:03:50,15:51:08,5/5/2020,95851150,12.09,1,Must remain southern southern single claim recent parent. Quite its face market none on second. Blue available expect help level window by chair.,13:40:27,NEFT
ZEZC96782790610481,GB65LENL00340791361820,3/14/2018,13872.52,100002,N,Credited,EDGE,MOBILE,Cr,17:43:36,20:09:45,5/5/2020,82991005,12.09,5,"Decide only first religious grow attention possible. Mrs either start must.
Test product impact inside like. Most general together modern against coach dinner.",19:28:30,CARDS
ZEZC96782790610481,GB65LENL00340791361820,3/14/2018,14462.43,100002,N,Credited,OPERA,MOBILE,Cr,3:41:29,5:06:32,5/9/2020,23378506,589.91,6,Nation soon soon boy fear. Full media against popular crime. Drug sometimes one economy want course general.,4:22:14,CHEQUE
ZEZC96782790610481,GB65LENL00340791361820,3/14/2018,15052.34,100002,N,Credited,SAFARI,MOBILE,Cr,10:30:47,11:45:49,5/9/2020,49224320,589.91,6,"Scientist issue trial artist seem market sound. I each child near event rock.
Market allow large save particular knowledge activity recognize. As father security room maybe research.",11:21:38,CHEQUE
ZEZC96782790610481,GB65LENL00340791361820,3/14/2018,14462.43,100002,Y,Rent,EDGE,PC,Dr,14:32:06,16:12:06,5/9/2020,47017672,589.91,1,"Specific pass seek admit. Spend pressure television often. Collection energy in create.
Debate more heart order. Bad team interview television nation sense.",15:40:44,NEFT
ZEZC96782790610481,GB65LENL00340791361820,3/14/2018,15052.34,100002,N,Credited,FF,PC,Cr,18:17:58,20:29:38,5/9/2020,6446000,589.91,3,"Defense add well site maybe sometimes per possible. Meet alone television small ball.
Citizen case surface until however size close hard. Energy the around however all group school church.",19:31:59,RTGS
ZEZC96782790610481,GB65LENL00340791361820,3/14/2018,15642.25,100002,N,Credited,CHROME,PC,Cr,19:56:28,22:48:07,5/9/2020,66889823,589.91,2,"Or tough heart challenge. Soldier tonight bed sense.
Edge tough matter nor represent plant. Staff task shake green answer responsibility ahead.",20:49:28,IMPS
ZEZC96782790610481,GB65LENL00340791361820,3/14/2018,15855.92,100002,N,Credited,FF,MOBILE,Cr,3:39:00,8:00:23,5/12/2020,65851005,213.67,4,Floor tax actually worker allow reason institution. Doctor drive hold within name he crime. Democratic always station mouth provide person source. Special item tell reflect church candidate and bank.,6:25:58,UPI
ZEZC96782790610481,GB65LENL00340791361820,3/14/2018,16069.59,100002,N,Credited,CHROME,MOBILE,Cr,13:14:12,18:08:37,5/12/2020,99736767,213.67,2,"Child century maybe plan religious. Expect standard pressure.
Nice simply official arrive market economy them church. Seek high product they. Bad find sea son lay worker.",15:15:35,IMPS
ZEZC96782790610481,GB65LENL00340791361820,3/14/2018,15855.92,100002,Y,Transportation,OPERA,PC,Dr,16:54:32,19:28:34,5/12/2020,62988520,213.67,2,"Available represent very produce simple. Itself head expert risk.
Perhaps mother organization stand. Dinner piece also as yard.",18:10:54,IMPS
ZEZC96782790610481,GB65LENL00340791361820,3/14/2018,15238.72,100002,Y,Dining,IE,POS,Dr,7:35:38,9:48:06,5/17/2020,17469418,617.2,6,Clearly whole send pick organization put law only. Admit from since herself. Cause less deep rock subject along investment.,8:58:44,CHEQUE
ZEZC96782790610481,GB65LENL00340791361820,3/14/2018,15855.92,100002,N,Credited,EDGE,MOBILE,Cr,10:18:43,12:45:18,5/17/2020,90119439,617.2,2,"Commercial bank best sure. Take write decade great modern.
Message dinner measure. You test career find family popular design energy. Run long these dog.",11:39:26,IMPS
ZEZC96782790610481,GB65LENL00340791361820,3/14/2018,15238.72,100002,Y,Utilities,IE,MOBILE,Dr,15:55:18,17:49:31,5/17/2020,68603052,617.2,1,Guy small audience go issue a Congress require. Situation smile attention discussion each answer. Expect PM it involve. Reduce in son coach.,16:47:25,NEFT
ZEZC96782790610481,GB65LENL00340791361820,3/14/2018,15855.92,100002,N,Credited,EDGE,POS,Cr,21:12:15,23:28:54,5/17/2020,58465813,617.2,3,"From child century without generation real. Cover western stay owner.
Left worry every leave. Laugh indicate anyone minute across professional tend.",22:12:57,RTGS
ZEZC96782790610481,GB65LENL00340791361820,3/14/2018,14959.96,100002,Y,Utilities,MI,POS,Dr,8:57:21,19:23:19,5/18/2020,10976494,895.96,7,"Store player ever happy. Discover camera suggest southern worry after something wait.
Energy lay board heavy simple article. Will remember play should. Particular then policy town.",14:10:49,DD
ZEZC96782790610481,GB65LENL00340791361820,3/14/2018,13596.3,100002,Y,Household Consumables,FF,POS,Dr,3:19:56,6:26:02,5/26/2020,71280943,1363.66,3,"Leave there owner relationship. Include hour happy less. Condition protect local picture network.
That buy or manager skill news red.",5:12:17,RTGS
ZEZC96782790610481,GB65LENL00340791361820,3/14/2018,14959.96,100002,N,Credited,CHROME,POS,Cr,13:04:08,15:59:23,5/26/2020,50129652,1363.66,4,"Politics because ready. International game child group majority. Cup smile beautiful again.
Expect main old country law for. Property garden find personal staff year.",14:00:06,UPI
ZEZC96782790610481,GB65LENL00340791361820,3/14/2018,13596.3,100002,Y,Utilities,SAFARI,POS,Dr,17:25:36,20:17:06,5/26/2020,96757765,1363.66,4,"Meet bring expect play more easy event. Learn process husband item. Long learn she student.
Clearly able man style ten physical try tax.",18:20:32,UPI
ZEZC96782790610481,GB65LENL00340791361820,3/14/2018,12232.64,100002,Y,Rent,EDGE,MOBILE,Dr,17:26:12,20:43:25,5/26/2020,13902773,1363.66,4,"War call we clear citizen. Side close because as article he drug.
It home old contain should happen case. Assume participant important career prove Republican low include.",19:16:16,UPI
ZEZC96782790610481,GB65LENL00340791361820,3/14/2018,13749.53,100002,N,Credited,EDGE,PC,Cr,3:40:02,8:54:29,5/27/2020,81331390,1516.89,2,Put magazine north stock expert threat space. Million pass Democrat need travel. Couple family who standard. Series professor second door inside training.,6:09:25,IMPS
ZEZC96782790610481,GB65LENL00340791361820,3/14/2018,12232.64,100002,Y,Dining,FF,PC,Dr,12:07:47,13:43:58,5/27/2020,12504237,1516.89,4,Country building ready involve direction yard. Commercial determine personal opportunity raise hand. Teach little item financial. Allow share physical simple between usually garden.,13:06:04,UPI
ZEZC96782790610481,GB65LENL00340791361820,3/14/2018,13749.53,100002,N,Credited,OPERA,MOBILE,Cr,18:13:03,22:25:13,5/27/2020,49421897,1516.89,6,Me man central dream middle nice respond. City war discover audience woman manager business course. Bar program person visit discover reveal assume.,19:56:14,CHEQUE
ZEZC96782790610481,GB65LENL00340791361820,3/14/2018,12642.27,100002,Y,Personal Care,CHROME,POS,Dr,11:03:36,13:52:43,5/29/2020,51221775,1107.26,4,"Expert few box trade. Southern hear rather let similar base. Easy stop movie.
Main health feeling officer cold baby. Sometimes market cultural blue war board serve.",11:40:37,UPI
ZEZC96782790610481,GB65LENL00340791361820,3/14/2018,13749.53,100002,N,Credited,EDGE,PC,Cr,13:08:23,17:58:47,5/29/2020,21409165,1107.26,1,"High western break call artist far. Use pay manage heavy material war.
Feel form begin everybody force ability. Republican test change never. How thing focus agent themselves those.",15:59:29,NEFT
ZEZC96782790610481,GB65LENL00340791361820,3/14/2018,12642.27,100002,Y,Online Shopping,IE,MOBILE,Dr,17:12:54,21:48:16,5/29/2020,79134033,1107.26,3,"Newspaper break down white. Drive together bank. Mission clearly his.
Recognize spring development claim ok describe threat. Much art affect everybody probably. Mind to already add.",20:10:55,RTGS
ZEZC96782790610481,GB65LENL00340791361820,3/14/2018,11182.51,100002,Y,Rent,CHROME,MOBILE,Dr,5:45:32,7:37:01,6/1/2020,5752799,1459.76,7,"Visit likely rule about forget establish environment particularly. Direction positive traditional much personal life guy. Main gun almost.
Hit just year process. Economy share occur where within few.",6:15:35,DD
ZEZC96782790610481,GB65LENL00340791361820,3/14/2018,12642.27,100002,N,Credited,MI,POS,Cr,10:14:39,12:40:47,6/1/2020,42879947,1459.76,6,"Positive would happen perform set full. Kind democratic discuss know. Baby bag last example.
While camera station work stuff. Else radio Democrat major here appear.",11:54:19,CHEQUE
ZEZC96782790610481,GB65LENL00340791361820,3/14/2018,14102.03,100002,N,Credited,SAFARI,POS,Cr,13:35:32,16:10:18,6/1/2020,94744217,1459.76,3,"Year school part cut easy some station. Bank visit drive same.
Southern rock these ask. Purpose line administration whom across.
Her home ahead contain. Degree reflect once size.",14:28:34,RTGS
ZEZC96782790610481,GB65LENL00340791361820,3/14/2018,15561.79,100002,N,Credited,IE,MOBILE,Cr,15:47:17,17:39:29,6/1/2020,3109304,1459.76,7,"Present hundred degree despite notice then national. Large bed type plant recognize.
First arrive race either. Task particular entire father financial father technology.",16:37:46,DD
ZEZC96782790610481,GB65LENL00340791361820,3/14/2018,17021.55,100002,N,Credited,SAFARI,MOBILE,Cr,19:43:25,23:30:42,6/1/2020,26539430,1459.76,1,None everything cause style TV. Might north state fact until generation enter. Hand more reality lot simple whom quickly. Now treatment report.,21:33:27,NEFT
ZEZC96782790610481,GB65LENL00340791361820,3/14/2018,18340.61,100002,N,Credited,EDGE,POS,Cr,12:12:38,16:54:48,6/8/2020,20059255,1319.06,1,"Receive wear wall. Form hair rest establish whose also never seek. Court kitchen letter.
Continue although continue bar movement gun project. Ever top pressure impact.",13:32:56,NEFT
ZEZC96782790610481,GB65LENL00340791361820,3/14/2018,17021.55,100002,Y,Medicals,CHROME,POS,Dr,17:57:46,21:58:34,6/8/2020,74743797,1319.06,3,"Despite happy learn respond. Past explain scientist per product.
Agency but way practice. Team example leader apply visit. Majority answer down realize.",19:04:57,RTGS
ZEZC96782790610481,GB65LENL00340791361820,3/14/2018,18227.06,100002,N,Credited,FF,MOBILE,Cr,5:48:41,9:39:08,6/12/2020,4370154,1205.51,4,"Economy human later. Strong father anyone drive. Early a idea often wish.
Fall each into culture cup accept. Administration others choice remain pattern. More lead on camera.
Use my either throw.",7:26:08,UPI
ZEZC96782790610481,GB65LENL00340791361820,3/14/2018,17021.55,100002,Y,Utilities,OPERA,MOBILE,Dr,9:49:45,12:55:40,6/12/2020,77312136,1205.51,4,"Trip morning allow agree. Daughter sort rich office value.
Rule attention off owner. Everything six give assume.
Society drop radio option there tell.",11:11:11,UPI
ZEZC96782790610481,GB65LENL00340791361820,3/14/2018,18227.06,100002,N,Credited,SAFARI,PC,Cr,15:15:45,18:07:59,6/12/2020,87901900,1205.51,7,"Policy human during individual physical seven write. Soldier site land blue official detail.
Staff age bit power. Front mission purpose special under. Always surface Mr even establish cut mention.",17:16:03,DD
ZEZC96782790610481,GB65LENL00340791361820,3/14/2018,19432.57,100002,N,Credited,EDGE,PC,Cr,20:16:45,23:49:04,6/12/2020,97218425,1205.51,3,Ability gas budget above perform somebody. Collection cover often no admit. Visit single no program often baby style.,22:39:24,RTGS
ZEZC96782790610481,GB65LENL00340791361820,3/14/2018,20339.84,100002,N,Credited,MI,POS,Cr,7:12:41,9:40:47,6/14/2020,31434966,907.27,4,This something rise hope public ago gun particularly. Color against day begin reason region safe. Information they discuss allow talk pull.,7:48:31,UPI
ZEZC96782790610481,GB65LENL00340791361820,3/14/2018,19432.57,100002,Y,Rent,EDGE,PC,Dr,7:33:40,10:44:53,6/14/2020,26170152,907.27,7,Part statement difference although middle the drive. Work seven learn kitchen continue.,9:03:30,DD
ZEZC96782790610481,GB65LENL00340791361820,3/14/2018,20339.84,100002,N,Credited,SAFARI,POS,Cr,13:46:20,16:56:34,6/14/2020,42168225,907.27,3,"Reflect still appear however little source sound.
Too sort relationship perhaps strong election support. Peace political key meet. Especially tend direction politics everyone community probably.",15:42:27,RTGS
ZEZC96782790610481,GB65LENL00340791361820,3/14/2018,21247.11,100002,N,Credited,SAFARI,PC,Cr,16:17:36,18:27:55,6/14/2020,63266061,907.27,1,Floor budget clear cover ball left specific. Administration law father sound project management important. Anything alone fund.,16:54:03,NEFT
ZEZC96782790610481,GB65LENL00340791361820,3/14/2018,20339.84,100002,Y,Rent,IE,POS,Dr,20:23:50,22:49:22,6/14/2020,54900554,907.27,7,Majority grow break them hear military. Represent any issue dog draw level. Occur trouble write yeah.,21:57:31,DD
ZEZC96782790610481,GB65LENL00340791361820,3/14/2018,19184.58,100002,Y,Online Shopping,OPERA,MOBILE,Dr,10:36:44,14:52:09,6/19/2020,3274750,1155.26,4,"Here world standard card live shoulder green. If camera how lose owner.
Bar sense soon time. Positive television certainly poor wish safe. Base between fill price.",11:28:21,UPI
ZEZC96782790610481,GB65LENL00340791361820,3/14/2018,20339.84,100002,N,Credited,MI,MOBILE,Cr,15:40:02,22:53:20,6/19/2020,9564008,1155.26,5,Realize heart force out. Whatever crime sit system example. Agreement image our relationship vote. Only cover alone allow some.,19:33:03,CARDS
ZEZC96782790610481,GB65LENL00340791361820,3/14/2018,21316.93,100002,N,Credited,IE,MOBILE,Cr,9:02:12,13:20:23,6/21/2020,92442573,977.09,4,Several court weight hope student. Read situation minute movie small age them. Available fly fight significant thing line. Too around consumer.,11:20:44,UPI
ZEZC96782790610481,GB65LENL00340791361820,3/14/2018,20339.84,100002,Y,Medicals,CHROME,POS,Dr,14:37:13,17:46:43,6/21/2020,93165716,977.09,3,"Along exist learn firm research rich fly.
Spring main citizen subject hotel bag push. History executive wonder name data against avoid. Inside child simple especially take provide international.",15:46:13,RTGS
ZEZC96782790610481,GB65LENL00340791361820,3/14/2018,21316.93,100002,N,Credited,OPERA,POS,Cr,21:51:59,23:38:25,6/21/2020,30728646,977.09,7,"Final ask commercial oil. Church at eat gun end sense.
Accept ok any ability his. Three remember although religious.
Power moment media then. Gas factor amount. Child sure after son my.",22:31:15,DD
ZEZC96782790610481,GB65LENL00340791361820,3/14/2018,21415.97,100002,N,Credited,SAFARI,POS,Cr,20:02:58,28:19:54,6/22/2020,34389461,99.04,7,"Here push collection American threat let send. Method another should.
The series wind.
Protect value low herself. Buy too mention series whose. Teacher company need. Social wait stand as view.",23:53:29,DD
ZEZC96782790610481,GB65LENL00340791361820,3/14/2018,19537.98,100002,Y,Medicals,FF,MOBILE,Dr,6:08:05,7:31:39,6/23/2020,12916924,1877.99,1,Build deep call should hit. Small attention record use last kid. Mind radio relationship itself however. Public be including easy.,7:07:29,NEFT
ZEZC96782790610481,GB65LENL00340791361820,3/14/2018,17659.99,100002,Y,Household Consumables,IE,POS,Dr,10:13:22,11:48:50,6/23/2020,611299,1877.99,1,"Teacher wind their sing service how decade. Heart play call stock hear college maybe check. Free main watch test eat.
Oil race instead front. Whether surface oil new establish ready network benefit.",10:47:20,NEFT
ZEZC96782790610481,GB65LENL00340791361820,3/14/2018,19537.98,100002,N,Credited,OPERA,POS,Cr,12:04:40,14:34:19,6/23/2020,31504423,1877.99,5,"Author present thousand race. Probably remember though attack piece prepare.
Bag clear behind the.",13:17:52,CARDS
ZEZC96782790610481,GB65LENL00340791361820,3/14/2018,21415.97,100002,N,Credited,OPERA,PC,Cr,19:07:45,21:02:10,6/23/2020,41436844,1877.99,6,"War notice child sort stay accept. Majority hour natural become market. Rule more top toward.
Until country population economic. Budget seem his follow example see individual serve.",19:39:21,CHEQUE
ZEZC96782790610481,GB65LENL00340791361820,3/14/2018,19537.98,100002,Y,Insurance,MI,POS,Dr,21:37:42,25:19:49,6/23/2020,98375790,1877.99,4,School office mouth education air treatment. Seven determine white their act. College whom difference.,23:25:45,UPI
ZEZC96782790610481,GB65LENL00340791361820,3/14/2018,20555.33,100002,N,Credited,OPERA,MOBILE,Cr,7:57:16,11:43:29,6/27/2020,66379478,1017.35,4,Politics foreign world push. Maintain near beautiful hope student. Grow responsibility how run let hotel whole.,9:58:46,UPI
ZEZC96782790610481,GB65LENL00340791361820,3/14/2018,21572.68,100002,N,Credited,FF,PC,Cr,15:45:13,19:57:46,6/27/2020,54490819,1017.35,5,Develop challenge then whole. Note oil relationship movie apply party. Eight stuff director cold. Give they expert until speak suggest.,18:59:56,CARDS
ZEZC96782790610481,GB65LENL00340791361820,3/14/2018,21501.84,100002,Y,Utilities,EDGE,MOBILE,Dr,4:20:17,6:53:38,7/11/2020,8457141,70.84,2,Especially heavy since outside couple before official. Study us TV without. Effect watch sound wall former billion upon. However then western big boy our.,5:00:37,IMPS
ZEZC96782790610481,GB65LENL00340791361820,3/14/2018,21431,100002,Y,Insurance,CHROME,POS,Dr,6:32:37,8:50:06,7/11/2020,79329750,70.84,7,"Rise company commercial commercial its establish. Unit several determine case air serve administration.
Computer three husband field quality soldier sort. Family way everything you specific.",8:10:27,DD
ZEZC96782790610481,GB65LENL00340791361820,3/14/2018,21360.16,100002,Y,Rent,MI,PC,Dr,11:18:35,13:29:52,7/11/2020,19230290,70.84,2,"Amount in born none game. Wide interest rule reason gas through. Level already meeting ground best.
Wrong lot stage most husband. Billion require although turn.",12:50:44,IMPS
ZEZC96782790610481,GB65LENL00340791361820,3/14/2018,21289.32,100002,Y,Online Shopping,CHROME,POS,Dr,16:28:49,17:36:58,7/11/2020,81973286,70.84,3,Shake machine work after. Left ball security nearly policy agree voice. Fish shoulder high person there somebody part.,16:57:46,RTGS
ZEZC96782790610481,GB65LENL00340791361820,3/14/2018,21218.48,100002,Y,Insurance,EDGE,MOBILE,Dr,19:29:17,21:06:43,7/11/2020,5623037,70.84,2,"Eight prevent civil friend opportunity school every.
Allow house almost or. Fast save administration news store.
View well edge for. Whole forward event good political your. Option order man success.",20:10:43,IMPS
ZEZC96782790610481,GB65LENL00340791361820,3/14/2018,22404.55,100002,N,Credited,SAFARI,MOBILE,Cr,9:55:31,16:11:32,7/12/2020,68667009,1186.07,7,"General statement establish like fund race responsibility. Executive idea baby will present live poor.
Suggest single development card security career high. Tend answer girl anyone step into.",13:33:22,DD
ZEZC96782790610481,GB65LENL00340791361820,3/14/2018,21218.48,100002,Y,Online Shopping,IE,MOBILE,Dr,19:37:22,25:24:18,7/12/2020,67550739,1186.07,7,"Shoulder central behind administration. Finish record then goal.
Positive night down offer before early similar. Economic grow before support.",23:37:08,DD
ZEZC96782790610481,GB65LENL00340791361820,3/14/2018,22423.94,100002,N,Credited,SAFARI,MOBILE,Cr,3:06:39,6:27:35,7/13/2020,76930317,1205.46,1,News similar least customer office fund north. Third lot community similar career some. Almost bit million third Republican professor step.,5:20:28,NEFT
ZEZC96782790610481,GB65LENL00340791361820,3/14/2018,23629.4,100002,N,Credited,FF,PC,Cr,7:35:27,10:48:35,7/13/2020,90295812,1205.46,4,System individual of stock. Score discuss sometimes six measure law. Resource group themselves strong then season minute.,9:37:17,UPI
ZEZC96782790610481,GB65LENL00340791361820,3/14/2018,24834.86,100002,N,Credited,CHROME,MOBILE,Cr,15:25:00,18:04:34,7/13/2020,26323978,1205.46,7,"Serve energy black five home. Evidence suddenly relationship billion Mr structure.
Protect up rise over out. Similar forward significant dog character move.",16:46:27,DD
ZEZC96782790610481,GB65LENL00340791361820,3/14/2018,26040.32,100002,N,Credited,FF,POS,Cr,18:16:32,21:12:02,7/13/2020,8352989,1205.46,7,Board agency hold cultural exactly. Concern morning though provide rather. Sit our air kid cost professor class.,19:40:40,DD
ZEZC96782790610481,GB65LENL00340791361820,3/14/2018,27529.69,100002,N,Credited,CHROME,MOBILE,Cr,6:36:58,8:34:24,7/22/2020,23430310,1489.37,7,"Make mean who trial risk minute thousand. Treatment which listen her.
Manager brother local number. Green responsibility four section.",7:18:11,DD
ZEZC96782790610481,GB65LENL00340791361820,3/14/2018,26040.32,100002,Y,Transportation,SAFARI,MOBILE,Dr,15:08:05,19:38:12,7/22/2020,44153724,1489.37,3,"Western visit event both. Play different game adult draw full. Mrs soon indicate long sure federal write.
Plan however else. Simply how art professor thought nor. Pretty popular may.",17:45:17,RTGS
ZEZC96782790610481,GB65LENL00340791361820,3/14/2018,24550.95,100002,Y,Insurance,OPERA,POS,Dr,21:13:43,24:01:43,7/22/2020,35727590,1489.37,6,Argue only woman policy scene. Air the citizen accept compare responsibility. Rise worry none never prevent agency.,22:19:04,CHEQUE
ZEZC96782790610481,GB65LENL00340791361820,3/14/2018,24455.57,100002,Y,Medicals,EDGE,MOBILE,Dr,5:10:45,11:39:22,7/23/2020,72099766,95.38,5,More while bar street century so. Them young everybody hour job another section always. Painting seven send economic among heart decision.,8:17:38,CARDS
ZEZC96782790610481,GB65LENL00340791361820,3/14/2018,24550.95,100002,N,Credited,MI,PC,Cr,15:07:46,21:13:36,7/23/2020,69592928,95.38,7,Word friend government hospital month return produce. Professional note member on dream. Former recent the without today consider.,18:27:42,DD
ZEZC96782790610481,GB65LENL00340791361820,3/14/2018,26303.22,100002,N,Credited,IE,MOBILE,Cr,9:30:58,14:15:01,8/11/2020,41632642,1752.27,4,"Report few attack they accept thing arrive perhaps. Her stay though necessary many chair.
Management read school environmental.",11:53:03,UPI
ZEZC96782790610481,GB65LENL00340791361820,3/14/2018,24550.95,100002,Y,Household Consumables,FF,PC,Dr,22:02:55,24:56:51,8/11/2020,59089742,1752.27,6,Carry detail paper from trip who. Protect strategy product newspaper onto star.,23:38:02,CHEQUE
ZEZC96782790610481,GB65LENL00340791361820,3/14/2018,23119.84,100002,Y,Insurance,OPERA,POS,Dr,12:40:00,19:03:44,8/12/2020,69055294,1431.11,6,Heart almost sit season. Moment forward condition order modern begin. Just teacher front or push lay.,17:18:28,CHEQUE
ZEZC96782790610481,GB65LENL00340791361820,3/14/2018,23667.12,100002,N,Credited,EDGE,POS,Cr,18:08:58,26:28:30,8/15/2020,85593077,547.28,1,"This level positive garden important even election. Road team year.
Decide book into voice. Well set focus speech agree church. Account dog yard. Major become choice mission many data.",23:03:37,NEFT
ZEZC96782790610481,GB65LENL00340791361820,3/14/2018,23687.89,100002,N,Credited,CHROME,PC,Cr,4:23:22,7:57:05,9/15/2020,57243733,20.77,5,Crime soon evening particular arrive. Not west allow partner tend weight. Among create instead people.,6:40:57,CARDS
ZEZC96782790610481,GB65LENL00340791361820,3/14/2018,23708.66,100002,N,Credited,IE,POS,Cr,9:09:15,13:25:13,9/15/2020,68575595,20.77,5,Least word company prove. Morning hear company hand perhaps position top. Inside small else apply decade left born region.,11:14:42,CARDS
ZEZC96782790610481,GB65LENL00340791361820,3/14/2018,23687.89,100002,Y,Personal Care,SAFARI,POS,Dr,16:30:34,19:58:45,9/15/2020,83051050,20.77,4,"Medical rule when knowledge anything public.
Rise name only simply conference among. Institution future raise.
Exactly certain conference case. Writer you special off main.",17:55:19,UPI
ZEZC96782790610481,GB65LENL00340791361820,3/14/2018,23708.66,100002,N,Credited,CHROME,MOBILE,Cr,19:41:32,22:35:42,9/15/2020,16200425,20.77,1,"End collection east behind. Cell then ever. Administration mind ok official total team.
Identify technology a ready call that structure. Local country partner. Eye collection citizen building.",20:46:08,NEFT
ZEZC96782790610481,GB65LENL00340791361820,3/14/2018,25677.71,100002,N,Credited,MI,MOBILE,Cr,9:15:39,16:20:36,9/16/2020,82184001,1969.05,5,Everyone case medical machine. Friend add subject build ever owner. Agent travel use front without real unit.,13:11:52,CARDS
ZEZC96782790610481,GB65LENL00340791361820,3/14/2018,26826.24,100002,N,Credited,SAFARI,POS,Cr,19:01:36,26:26:40,9/22/2020,35348351,1148.53,3,"Experience very consider back. Campaign outside as weight want sure.
Evidence well itself throughout might speak arrive despite. Practice sing account material.",20:42:27,RTGS
ZEZC96782790610481,GB65LENL00340791361820,3/14/2018,26634.77,100002,Y,Groceries,IE,POS,Dr,3:20:11,7:55:17,9/24/2020,19823515,191.47,2,Never until right well. Agreement style step no body. Yourself candidate try factor consumer. Time form part great animal effort whether group.,6:13:50,IMPS
ZEZC96782790610481,GB65LENL00340791361820,3/14/2018,26826.24,100002,N,Credited,EDGE,POS,Cr,12:00:19,17:23:36,9/24/2020,73869986,191.47,5,Stuff enjoy tonight training town argue. Police animal shoulder fear nothing cause cover. Better sure improve page far.,14:24:13,CARDS
ZEZC96782790610481,GB65LENL00340791361820,3/14/2018,26634.77,100002,Y,Transportation,MI,MOBILE,Dr,22:28:08,24:55:13,9/24/2020,50457922,191.47,3,"Watch class however character part. At happy town like entire. Couple card choose.
Mention wear significant your food. Term for daughter down.",23:47:51,RTGS
ZEZC96782790610481,GB65LENL00340791361820,3/14/2018,26911.9,100002,N,Credited,FF,MOBILE,Cr,7:46:42,14:48:01,9/28/2020,47894945,277.13,7,"Suggest order impact day plan specific. Movie lot speak one again. Region table eight serve relate question building.
Father step story performance stay whom. Happy Republican society employee.",11:12:58,DD
ZEZC96782790610481,GB65LENL00340791361820,3/14/2018,26634.77,100002,Y,Utilities,OPERA,MOBILE,Dr,16:30:16,22:32:38,9/28/2020,48656405,277.13,3,"Accept question certain be. Reflect support claim operation standard.
Answer attack magazine positive. Near history participant those social dog. If this benefit ago available as.",18:45:48,RTGS
ZEZC96782790610481,GB65LENL00340791361820,3/14/2018,27749.81,100002,N,Credited,CHROME,PC,Cr,18:50:04,29:01:49,10/1/2020,23414273,1115.04,3,Risk management claim particularly. Down follow dark always discussion success mother. Often positive husband card a.,23:33:26,RTGS
ZEZC96782790610481,GB65LENL00340791361820,3/14/2018,28782.98,100002,N,Credited,IE,PC,Cr,3:53:04,6:24:55,10/3/2020,7716362,1033.17,2,"Section night during tonight economic laugh. Similar thus six financial surface if degree. Adult fall nice bring picture resource.
Arm third life rise our hand.
Hold prevent huge my. Hit law movie.",5:34:59,IMPS
ZEZC96782790610481,GB65LENL00340791361820,3/14/2018,27749.81,100002,Y,Medicals,CHROME,MOBILE,Dr,7:55:21,11:08:08,10/3/2020,48716321,1033.17,2,"Light husband majority focus consider safe and. Field pattern where grow far physical.
Stock seem foot skill decision. Animal turn talk for possible rest. Itself need bank dog more.",9:36:39,IMPS
ZEZC96782790610481,GB65LENL00340791361820,3/14/2018,26716.64,100002,Y,Personal Care,FF,MOBILE,Dr,12:42:42,15:07:45,10/3/2020,14208300,1033.17,1,Economic exactly evening home five should finally society. Second ever billion than manager.,13:16:42,NEFT
ZEZC96782790610481,GB65LENL00340791361820,3/14/2018,27749.81,100002,N,Credited,SAFARI,PC,Cr,16:08:02,17:38:26,10/3/2020,16736740,1033.17,7,Foot task as good vote stand. Reality parent country hotel. Election do far fine debate look more.,17:14:01,DD
ZEZC96782790610481,GB65LENL00340791361820,3/14/2018,28782.98,100002,N,Credited,MI,PC,Cr,21:52:55,25:23:36,10/3/2020,14111143,1033.17,5,"Street music would hit. Pretty movement hospital its shake lay fear. Myself through way support. Yes morning expert common or.
Modern interest policy. Today alone produce site.",23:40:38,CARDS
ZEZC96782790610481,GB65LENL00340791361820,3/14/2018,28635.27,100002,Y,Entertainment,EDGE,POS,Dr,10:49:48,18:31:22,10/6/2020,58477847,147.71,1,"Speech room Congress civil. Particular we cover entire sing.
Word order third serious set bar. Their wife draw key economic television indicate.",14:43:03,NEFT
ZEZC96782790610481,GB65LENL00340791361820,3/14/2018,28487.56,100002,Y,Rent,IE,MOBILE,Dr,19:57:15,25:35:42,10/6/2020,38108204,147.71,7,"Show learn listen sit build. Likely speak finally they especially social understand wait.
Visit may price adult brother may. Avoid property close body.",22:07:43,DD
ZEZC96782790610481,GB65LENL00340791361820,3/14/2018,26509.47,100002,Y,Dining,SAFARI,POS,Dr,3:13:29,5:59:27,10/8/2020,54287877,1978.09,1,"Remain happy activity. Begin off require short try adult others where. Purpose close face piece.
Time stay audience. Improve others industry. Report east although available require capital believe.",5:10:06,NEFT
ZEZC96782790610481,GB65LENL00340791361820,3/14/2018,28487.56,100002,N,Credited,CHROME,PC,Cr,9:11:36,11:43:12,10/8/2020,55680196,1978.09,4,Even nor at movement someone choose. Plan first admit notice rock. Trade from together north interesting. Interesting section phone beautiful audience.,10:21:34,UPI
ZEZC96782790610481,GB65LENL00340791361820,3/14/2018,30465.65,100002,N,Credited,MI,POS,Cr,15:49:57,18:41:58,10/8/2020,42395287,1978.09,1,Section lot argue value hold late service. Force significant college audience enter. Create become never fall oil. Now structure eye most education.,16:57:42,NEFT
ZEZC96782790610481,GB65LENL00340791361820,3/14/2018,32443.74,100002,N,Credited,EDGE,MOBILE,Cr,19:44:13,22:11:57,10/8/2020,93206082,1978.09,7,"Politics wall along front. Product then we son safe here style.
Smile word cover rock leader. Here school true civil public behavior responsibility.",20:47:58,DD
ZEZC96782790610481,GB65LENL00340791361820,3/14/2018,30794.09,100002,Y,Online Shopping,OPERA,MOBILE,Dr,8:05:20,11:30:31,10/18/2020,8921406,1649.65,1,"Increase any citizen rule. Campaign movie husband economic seven want.
Firm chance cut available strong. Remember find story.",9:15:26,NEFT
ZEZC96782790610481,GB65LENL00340791361820,3/14/2018,29144.44,100002,Y,Entertainment,IE,MOBILE,Dr,9:55:30,11:59:43,10/18/2020,28899143,1649.65,1,"Enjoy high way our collection should so. Agency foreign technology attack final listen.
First conference civil myself treat notice.
It anything five to campaign. Medical full place already little.",10:55:37,NEFT
ZEZC96782790610481,GB65LENL00340791361820,3/14/2018,30794.09,100002,N,Credited,FF,POS,Cr,15:56:05,19:18:21,10/18/2020,97730545,1649.65,6,Through girl whole know. Food could identify with study yes friend. Offer blood apply learn animal a bring.,18:05:03,CHEQUE
ZEZC96782790610481,GB65LENL00340791361820,3/14/2018,29144.44,100002,Y,Online Shopping,OPERA,MOBILE,Dr,18:32:25,21:05:37,10/18/2020,14749155,1649.65,2,"Practice represent story. Camera company federal today.
Event debate discussion. Middle avoid last business.
Kitchen safe debate anyone student. Usually do politics itself deal.",19:35:33,IMPS
ZEZC96782790610481,GB65LENL00340791361820,3/14/2018,30842.94,100002,N,Credited,SAFARI,MOBILE,Cr,5:16:03,9:54:15,10/22/2020,12431304,1698.5,1,"Listen song author reality. Treat set sister college.
Let agree system view Congress. Fine since on answer know.
Always wind stop money nearly never system art. About nor fire you western.",8:05:02,NEFT
ZEZC96782790610481,GB65LENL00340791361820,3/14/2018,32541.44,100002,N,Credited,FF,PC,Cr,16:21:02,18:16:44,10/22/2020,64472287,1698.5,4,"Impact eight notice glass defense area series.
Start position no art. Oil treat sense industry again word present pick. Everything here camera player president first.",17:09:33,UPI
ZEZC96782790610481,GB65LENL00340791361820,3/14/2018,30842.94,100002,Y,Medicals,FF,POS,Dr,22:00:17,25:51:54,10/22/2020,7420818,1698.5,4,"Air policy recently. Easy Mr consider this. Where degree beat form action.
His side interest leader southern box none others.",23:25:48,UPI
ZEZC96782790610481,GB65LENL00340791361820,3/14/2018,29086,100002,Y,Dining,MI,MOBILE,Dr,6:30:12,8:56:24,10/24/2020,76466397,1756.94,5,"Financial certainly bar civil. Lawyer rich past plan teach check reduce accept.
Office machine local as sound fact. Soldier suggest language probably hand.",7:19:40,CARDS
ZEZC96782790610481,GB65LENL00340791361820,3/14/2018,27329.06,100002,Y,Dining,EDGE,MOBILE,Dr,13:05:21,14:18:32,10/24/2020,90621468,1756.94,1,"Dark minute would store. Mind main card wide cultural give though.
Democratic hospital allow peace agency attorney huge.
Child every its significant. Approach power this book.",13:44:50,NEFT
ZEZC96782790610481,GB65LENL00340791361820,3/14/2018,25572.12,100002,Y,Utilities,CHROME,POS,Dr,14:59:45,19:44:06,10/24/2020,21254918,1756.94,1,"Fine us also ground various. Age live station operation street statement. Reduce wear challenge throughout describe item.
Consider place different. Pm concern eye north television friend.",17:23:20,NEFT
ZEZC96782790610481,GB65LENL00340791361820,3/14/2018,23815.18,100002,Y,Groceries,MI,PC,Dr,18:57:40,21:47:43,10/24/2020,39216830,1756.94,5,Apply choice beat pull reduce. Answer bar whether us policy hundred. Meet technology least just this thousand several. Door discover cover moment picture.,19:57:39,CARDS
ZEZC96782790610481,GB65LENL00340791361820,3/14/2018,22180.76,100002,Y,Dining,FF,POS,Dr,5:36:17,10:35:56,10/26/2020,36139941,1634.42,2,Question out after. While stop table least price decision. Central these product to character whether business.,7:55:54,IMPS
ZEZC96782790610481,GB65LENL00340791361820,3/14/2018,20546.34,100002,Y,Entertainment,SAFARI,MOBILE,Dr,10:47:19,13:24:33,10/26/2020,20671044,1634.42,3,"Better test court report.
Value although which traditional investment. White government history available defense fund suggest director.",12:12:54,RTGS
ZEZC96782790610481,GB65LENL00340791361820,3/14/2018,18911.92,100002,Y,Entertainment,MI,MOBILE,Dr,20:06:21,22:25:39,10/26/2020,80704270,1634.42,1,"Upon view yeah consider beat into. Worker figure weight participant time especially relate. Against others issue lead our natural recently.
Writer they choose several data cup.",21:02:36,NEFT
ZEZC96782790610481,GB65LENL00340791361820,3/14/2018,19810.13,100002,N,Credited,FF,PC,Cr,6:23:08,9:45:21,10/27/2020,47329492,898.21,6,"Authority strong school my surface. Share ago once. Change democratic item car. Where show hit purpose mother man.
Move mean week against after expect. Artist of throughout around game.",7:40:54,CHEQUE
ZEZC96782790610481,GB65LENL00340791361820,3/14/2018,20708.34,100002,N,Credited,OPERA,MOBILE,Cr,9:11:18,11:54:43,10/27/2020,61954922,898.21,6,Perhaps certainly everyone our design. Simple our paper attorney sure recently this. Method country today according able.,10:48:57,CHEQUE
ZEZC96782790610481,GB65LENL00340791361820,3/14/2018,21606.55,100002,N,Credited,EDGE,MOBILE,Cr,15:49:15,19:39:44,10/27/2020,66226871,898.21,5,"World star learn stay meeting. Matter data hit stage including. Doctor food avoid floor current stock development.
My east manage blood police study. Job suffer usually either meeting ball year unit.",17:53:51,CARDS
ZEZC96782790610481,GB65LENL00340791361820,3/14/2018,22504.76,100002,N,Credited,MI,POS,Cr,20:22:21,23:30:39,10/27/2020,30150997,898.21,4,"Collection education several national tonight ability.
Recent it since.",21:14:21,UPI
ZEZC96782790610481,GB65LENL00340791361820,3/14/2018,21976.71,100002,Y,Transportation,IE,PC,Dr,4:11:51,8:56:51,10/29/2020,64983868,528.05,1,Radio product coach economy section couple. Pretty per hospital husband land.,6:17:14,NEFT
ZEZC96782790610481,GB65LENL00340791361820,3/14/2018,22504.76,100002,N,Credited,MI,PC,Cr,12:26:56,15:01:33,10/29/2020,44588137,528.05,6,"Reason collection different thus radio actually week side. Form challenge herself lose item.
Result test serve charge campaign short building common. Assume whose where national at rest.",13:03:22,CHEQUE
ZEZC96782790610481,GB65LENL00340791361820,3/14/2018,23032.81,100002,N,Credited,SAFARI,POS,Cr,21:00:06,24:13:16,10/29/2020,28822783,528.05,1,"International name responsibility since adult. Major full issue baby cultural positive then material.
Never join time effort reduce. Specific beyond activity water.",22:20:36,NEFT
ZEZC96782790610481,GB65LENL00340791361820,3/14/2018,24342.76,100002,N,Credited,OPERA,POS,Cr,7:27:48,16:49:03,11/3/2020,6430313,1309.95,1,Exist line how record large tax service. Quickly describe people. Measure beat treat computer seem nor laugh.,12:57:34,NEFT
ZEZC96782790610481,GB65LENL00340791361820,3/14/2018,24152.26,100002,Y,Transportation,OPERA,PC,Dr,5:22:05,10:03:02,11/8/2020,10838563,190.5,2,Skin cover range bag try sound bag music. Majority notice field various edge measure.,8:50:35,IMPS
ZEZC96782790610481,GB65LENL00340791361820,3/14/2018,23961.76,100002,Y,Insurance,SAFARI,PC,Dr,12:22:01,18:44:13,11/8/2020,61213623,190.5,5,"Rest share treatment. Many treatment citizen.
Recognize dream rule vote change cost science. Some never type world official yourself.",16:14:34,CARDS
ZEZC96782790610481,GB65LENL00340791361820,3/14/2018,23056.88,100002,Y,Dining,CHROME,POS,Dr,7:10:50,8:31:36,11/19/2020,40786315,904.88,1,"A among name. Adult sometimes free.
Reach role build result happen skill. Democratic company know account start day. Perhaps wonder organization east course. Least century give century.",7:47:59,NEFT
ZEZC96782790610481,GB65LENL00340791361820,3/14/2018,23961.76,100002,N,Credited,SAFARI,MOBILE,Cr,8:34:57,10:46:17,11/19/2020,17804714,904.88,6,"Well chance drop across nor history executive. Camera word evidence degree. Woman claim second yeah effort society.
With cell present. Anyone clearly onto order until close box center.",9:46:20,CHEQUE
ZEZC96782790610481,GB65LENL00340791361820,3/14/2018,23056.88,100002,Y,Medicals,SAFARI,PC,Dr,12:43:58,15:55:51,11/19/2020,49201659,904.88,6,"Style beautiful chair many. Listen investment third past couple blood. Reduce challenge employee summer play individual worker past.
Drop draw final see subject memory. Stuff do point.",14:31:00,CHEQUE
ZEZC96782790610481,GB65LENL00340791361820,3/14/2018,22152,100002,Y,Medicals,IE,POS,Dr,18:58:47,23:24:21,11/19/2020,82132019,904.88,7,"Reach poor control. Front lawyer consumer vote.
Home painting similar tree idea along we. Morning anyone answer with course body security. Quality win everyone baby although do.",21:22:31,DD
ZEZC96782790610481,GB65LENL00340791361820,3/14/2018,20949.91,100002,Y,Personal Care,IE,MOBILE,Dr,9:32:15,13:37:10,11/26/2020,71878072,1202.09,4,"Again opportunity thus federal. Western could share cell. Bill stuff notice guy.
Important let training site. Defense fast follow citizen high. Money across region war.",11:23:19,UPI
ZEZC96782790610481,GB65LENL00340791361820,3/14/2018,19747.82,100002,Y,Rent,MI,POS,Dr,10:02:05,14:27:22,11/26/2020,33906195,1202.09,5,"Well court him.
Newspaper suddenly site have each gun service. Resource must measure.
Health three conference which. May issue series shake think possible.",12:57:46,CARDS
ZEZC96782790610481,GB65LENL00340791361820,3/14/2018,20949.91,100002,N,Credited,OPERA,MOBILE,Cr,17:19:55,22:05:12,11/26/2020,40772158,1202.09,3,"As describe result message. Choose second around generation thousand. Church imagine impact.
Back marriage ten agent.",20:04:53,RTGS
ZEZC96782790610481,GB65LENL00340791361820,3/14/2018,22027.19,100002,N,Credited,IE,PC,Cr,13:31:05,22:23:08,12/13/2020,11430506,1077.28,7,"Thing air still plant not four. Piece rate strong go day. Site thank carry seven.
Method stuff trouble pull. Let camera understand.",18:03:53,DD
ZEZC96782790610481,GB65LENL00340791361820,3/14/2018,21731.18,100002,Y,Utilities,CHROME,MOBILE,Dr,18:38:36,24:30:49,12/14/2020,86731508,296.01,3,Former dark daughter account. Analysis up carry gas wish interest. Agree employee business summer build other affect.,21:06:42,RTGS
ZEZC96782790610481,GB65LENL00340791361820,3/14/2018,21817.33,100002,N,Credited,SAFARI,MOBILE,Cr,4:22:39,6:49:26,12/15/2020,15223531,86.15,1,Prove value offer evidence bring voice. Agent area above health total computer science. Note ago success reflect first story dark.,6:17:31,NEFT
ZEZC96782790610481,GB65LENL00340791361820,3/14/2018,21731.18,100002,Y,Groceries,CHROME,POS,Dr,8:27:23,11:16:42,12/15/2020,59756040,86.15,2,"Together follow expert loss window miss. East become safe sense maintain card.
Board entire environment. Executive consider just professional bar final together. Question month use medical.",10:22:02,IMPS
ZEZC96782790610481,GB65LENL00340791361820,3/14/2018,21817.33,100002,N,Credited,EDGE,PC,Cr,13:47:43,16:39:31,12/15/2020,50213467,86.15,4,"Training realize less certain quickly. Billion perform likely sure service stock art.
Level beautiful determine example television identify answer.",14:39:05,UPI
ZEZC96782790610481,GB65LENL00340791361820,3/14/2018,21903.48,100002,N,Credited,CHROME,POS,Cr,22:06:21,25:46:09,12/15/2020,65729151,86.15,1,Describe bag game society they leader enter thousand. Become sign organization face various identify former. Fine government foot too.,23:40:05,NEFT
ZEZC96782790610481,GB65LENL00340791361820,3/14/2018,23489.83,100002,N,Credited,OPERA,MOBILE,Cr,9:42:34,12:21:08,12/18/2020,61633452,1586.35,5,"Can young interview majority.
This large all. Study it change indeed democratic ready magazine fall. Quality begin continue.",10:41:54,CARDS
ZEZC96782790610481,GB65LENL00340791361820,3/14/2018,21903.48,100002,Y,Groceries,MI,MOBILE,Dr,15:31:13,19:26:09,12/18/2020,69493232,1586.35,3,Order share politics sense of expect finish. In bag store defense. Store marriage various maybe pull throw herself rock.,17:18:50,RTGS
ZEZC96782790610481,GB65LENL00340791361820,3/14/2018,20317.13,100002,Y,Groceries,CHROME,POS,Dr,20:58:20,26:04:49,12/18/2020,90941597,1586.35,6,Professor agreement food leg have contain order. Heavy add family president. Character middle nature.,23:44:35,CHEQUE
ZEZC96782790610481,GB65LENL00340791361820,3/14/2018,19578.54,100002,Y,Utilities,FF,POS,Dr,7:21:47,9:40:11,12/22/2020,88659091,738.59,2,"How authority all let receive. Indicate really performance half.
Design option develop director. Attention according health later either blue expect. Carry seven style plan name big.",8:37:25,IMPS
ZEZC96782790610481,GB65LENL00340791361820,3/14/2018,18839.95,100002,Y,Online Shopping,OPERA,POS,Dr,9:53:27,12:47:34,12/22/2020,93779081,738.59,3,"Message fire site group analysis challenge. Thank nearly anyone too return course even. During may until center blue live best.
Answer in when rest with group. Side any agree against accept and size.",10:47:45,RTGS
ZEZC96782790610481,GB65LENL00340791361820,3/14/2018,19578.54,100002,N,Credited,FF,POS,Cr,14:55:17,18:16:01,12/22/2020,82074142,738.59,2,"Method position all especially figure side skin. Short leave similar thousand truth expert least.
Head whatever behavior case let.",17:00:10,IMPS
ZEZC96782790610481,GB65LENL00340791361820,3/14/2018,20317.13,100002,N,Credited,IE,POS,Cr,18:30:10,22:06:16,12/22/2020,328531,738.59,7,"Many hair travel nothing. Military evening game contain. Dinner resource tend respond commercial.
Test continue break great sport. Rate management remain three.",19:53:17,DD
ZEZC96782790610481,GB65LENL00340791361820,3/14/2018,19847.9,100002,Y,Rent,SAFARI,POS,Dr,17:41:22,23:12:26,12/25/2020,19348797,469.23,2,"Field recognize then. Newspaper consumer process near since couple.
Leg court lot nothing still real. Open billion discuss report officer. Economic technology girl cover general shoulder.",20:14:41,IMPS
ZEZC96782790610481,GB65LENL00340791361820,3/14/2018,18533.4,100002,Y,Transportation,SAFARI,PC,Dr,11:49:13,15:57:58,1/7/2021,76891441,1314.5,7,"Fire Democrat start again. Bill smile three according such doctor.
Food alone occur friend dinner past. Tonight recently artist drive exist center represent agreement.",14:49:00,DD
ZEZC96782790610481,GB65LENL00340791361820,3/14/2018,19847.9,100002,N,Credited,SAFARI,PC,Cr,19:10:19,24:38:21,1/7/2021,84866318,1314.5,2,"Simply true night only though relationship body. Prove all open people age dog force.
Heart black less particularly entire send. Production thus true foot resource wall.",21:57:09,IMPS
ZEZC96782790610481,GB65LENL00340791361820,3/14/2018,21139.64,100002,N,Credited,FF,MOBILE,Cr,18:35:33,25:19:22,1/13/2021,46958525,1291.74,4,"War bit sit Democrat safe anything. Record try region ten service half early.
Single economy month nor phone return can very.
Financial street his. Sea beat serious religious.",21:47:30,UPI
ZEZC96782790610481,GB65LENL00340791361820,3/14/2018,22592.63,100002,N,Credited,MI,PC,Cr,12:02:20,15:24:44,1/15/2021,29991945,1452.99,6,Each language oil. He huge organization later. Race hospital mother quickly camera pattern.,14:35:17,CHEQUE
ZEZC96782790610481,GB65LENL00340791361820,3/14/2018,21139.64,100002,Y,Personal Care,EDGE,POS,Dr,19:35:32,24:50:44,1/15/2021,71330167,1452.99,3,"Reveal event control week interest think anything. Technology pick about save end.
Right history around lot rule. Wait play citizen society cell card. Else me space painting.",21:52:18,RTGS
ZEZC96782790610481,GB65LENL00340791361820,3/14/2018,22664.69,100002,N,Credited,IE,PC,Cr,15:34:49,20:47:21,1/18/2021,96841563,1525.05,1,He teacher past so. Either food officer. Today military deal item former main.,18:55:36,NEFT
ZEZC96782790610481,GB65LENL00340791361820,3/14/2018,23941.59,100002,N,Credited,FF,POS,Cr,13:10:14,17:53:51,1/29/2021,75779320,1276.9,5,Yourself claim suffer investment property drug. Our maintain early yes front. Own let responsibility once rock yes save.,15:53:12,CARDS
ZEZC96782790610481,GB65LENL00340791361820,3/14/2018,22664.69,100002,Y,Dining,CHROME,MOBILE,Dr,16:27:23,21:52:12,1/29/2021,31929769,1276.9,4,Age toward alone lead. Political community boy assume often health fine. Lay want treat space test. Hundred town despite new seven word.,17:54:27,UPI
ZEZC96782790610481,GB65LENL00340791361820,3/14/2018,23789.65,100002,N,Credited,IE,PC,Cr,6:33:21,9:29:03,1/30/2021,70489255,1124.96,6,"Low test west onto garden race.
History letter rich four final west never. Step idea own cost. Next reason analysis rock student.",7:46:43,CHEQUE
ZEZC96782790610481,GB65LENL00340791361820,3/14/2018,24914.61,100002,N,Credited,OPERA,POS,Cr,13:26:56,17:06:04,1/30/2021,36169795,1124.96,6,"Protect white example discover. Like career sometimes quite per would fast.
Why message foot thing after. Opportunity perhaps if.
Often skin exist computer leg.
Sure stay child here goal will.",14:19:53,CHEQUE
ZEZC96782790610481,GB65LENL00340791361820,3/14/2018,23789.65,100002,Y,Transportation,OPERA,POS,Dr,16:06:22,20:47:04,1/30/2021,49128796,1124.96,4,"Conference current able almost fill better.
Family hit ago tell operation out phone. Mention federal need ground. That season practice detail.",19:05:14,UPI
ZEZC96782790610481,GB65LENL00340791361820,3/14/2018,24871.65,100002,N,Credited,CHROME,MOBILE,Cr,20:22:11,26:19:33,1/31/2021,44575533,1082,6,"Field nation exist expect know need. Help other away ten drug.
Method job everybody already quality. Message whom participant student plan present respond.",22:21:47,CHEQUE
ZEZC96782790610481,GB65LENL00340791361820,3/14/2018,23746.11,100002,Y,Online Shopping,IE,PC,Dr,18:56:45,26:56:33,2/4/2021,80597834,1125.54,6,"Better decision several will offer fact history. Common structure reduce time buy sure something. Shake tough could.
Month black there idea treat performance mother.",21:17:24,CHEQUE
ZEZC96782790610481,GB65LENL00340791361820,3/14/2018,25561.09,100002,N,Credited,SAFARI,POS,Cr,7:37:41,10:31:02,2/13/2021,69371141,1814.98,6,"Throw exactly mind better southern recently. Similar raise around simply. Mother wait off off.
Task me large sort.
Box commercial allow past. Human light reality per yes.",9:20:04,CHEQUE
ZEZC96782790610481,GB65LENL00340791361820,3/14/2018,23746.11,100002,Y,Transportation,OPERA,PC,Dr,16:31:30,19:46:19,2/13/2021,50687282,1814.98,3,Form win fall. Seek everything shake floor contain collection cultural. Choose recent class growth.,17:47:14,RTGS
ZEZC96782790610481,GB65LENL00340791361820,3/14/2018,21931.13,100002,Y,Online Shopping,MI,PC,Dr,19:30:32,23:36:39,2/13/2021,46745019,1814.98,3,"Far cause hand explain language stay.
Watch network admit arm party school. Word such ever street sell help.
Stand kitchen community plan. Deal country technology be pretty cut attack.",21:28:16,RTGS
ZEZC96782790610481,GB65LENL00340791361820,3/14/2018,20608.86,100002,Y,Online Shopping,CHROME,POS,Dr,4:56:10,10:20:40,2/15/2021,31725811,1322.27,3,Never party leg. Blood item teacher. Describe respond clear most sometimes run month.,7:29:01,RTGS
ZEZC96782790610481,GB65LENL00340791361820,3/14/2018,19286.59,100002,Y,Medicals,EDGE,POS,Dr,13:37:11,15:31:52,2/15/2021,41846698,1322.27,6,"Then more nor reach analysis change risk. Into particularly much pressure machine.
Cover can impact take. Instead vote interest she state city.",14:14:51,CHEQUE
ZEZC96782790610481,GB65LENL00340791361820,3/14/2018,20608.86,100002,N,Credited,MI,PC,Cr,22:30:49,25:37:02,2/15/2021,21582493,1322.27,2,Black wall stand tell sit authority. Whole talk wait ok source pattern. Hand its recently support wall phone.,23:44:03,IMPS
ZEZC96782790610481,GB65LENL00340791361820,3/14/2018,19482.53,100002,Y,Personal Care,IE,POS,Dr,3:33:37,6:15:46,2/18/2021,31251594,1126.33,5,"Read no ago ever democratic owner. Rise trial happy hot operation student.
Standard street which east walk recently. Standard become enter even reach. Just course trade camera.",5:13:37,CARDS
ZEZC96782790610481,GB65LENL00340791361820,3/14/2018,18356.2,100002,Y,Transportation,MI,MOBILE,Dr,8:08:01,10:45:08,2/18/2021,32652062,1126.33,4,"Myself training wait hot pretty camera item. Development series walk month.
Will different fire decision when break keep. Later evening wall. Method career loss.",9:29:02,UPI
ZEZC96782790610481,GB65LENL00340791361820,3/14/2018,17229.87,100002,Y,Transportation,OPERA,POS,Dr,11:58:18,14:21:42,2/18/2021,40153575,1126.33,7,Science present like share eight arrive street. Open fly situation war far.,13:03:13,DD
ZEZC96782790610481,GB65LENL00340791361820,3/14/2018,18356.2,100002,N,Credited,CHROME,PC,Cr,14:56:24,17:10:19,2/18/2021,81821969,1126.33,2,"Since several to rich. System hour staff son who subject role. Glass city clearly indicate need occur.
Campaign box only total. Once girl arrive thus head provide role.",16:12:52,IMPS
ZEZC96782790610481,GB65LENL00340791361820,3/14/2018,17229.87,100002,Y,Rent,FF,POS,Dr,19:11:08,22:43:02,2/18/2021,27588307,1126.33,5,"Throughout then usually. Mind color join remain. Material arm capital event.
Possible strategy executive morning everyone. Believe student analysis. Each animal statement lawyer.",21:07:08,CARDS
ZEZC96782790610481,GB65LENL00340791361820,3/14/2018,18879.31,100002,N,Credited,SAFARI,POS,Cr,8:31:03,17:11:45,3/1/2021,53970770,1649.44,7,"Yeah agency system detail act walk. Note design run window response yard while. Modern hand star realize morning recent.
Collection base collection tell increase. Off language husband wonder.",13:28:29,DD
ZEZC96782790610481,GB65LENL00340791361820,3/14/2018,19702.4,100002,N,Credited,SAFARI,PC,Cr,10:39:40,15:22:51,3/19/2021,99592103,823.09,3,Garden glass voice hit wife to true. Manage produce pull production traditional. Return energy he until president include forget. Image area physical right sense.,13:26:07,RTGS
ZEZC96782790610481,GB65LENL00340791361820,3/14/2018,20570.79,100002,N,Credited,FF,POS,Cr,16:49:55,25:20:16,3/27/2021,23986817,868.39,6,Security husband with happen. Different tonight difference high turn pressure natural. Four ready method fast look.,19:51:56,CHEQUE
ZEZC96782790610481,GB65LENL00340791361820,3/14/2018,19216.15,100002,Y,Medicals,CHROME,POS,Dr,9:34:19,14:37:12,4/2/2021,2345697,1354.64,5,Day commercial develop seek factor its. Since positive hospital subject course describe impact story. That during need difference.,13:23:42,CARDS
ZEZC96782790610481,GB65LENL00340791361820,3/14/2018,20555.41,100002,N,Credited,IE,POS,Cr,10:39:59,16:13:17,4/3/2021,12896820,1339.26,4,"Record production deep cup attorney. Green where more organization window building. Southern stuff whole eye about.
My be project whom including health. Pm without interesting wonder no simply.",13:10:49,UPI
ZEZC96782790610481,GB65LENL00340791361820,3/14/2018,21894.67,100002,N,Credited,OPERA,POS,Cr,13:35:52,19:24:36,4/3/2021,25774740,1339.26,5,Thank here number baby. Hear cost imagine take just evidence grow. Own enough measure company myself.,16:59:37,CARDS
ZEZC96782790610481,GB65LENL00340791361820,3/14/2018,22136.95,100002,N,Credited,EDGE,PC,Cr,21:08:09,27:20:34,4/6/2021,46036285,242.28,6,"Congress process improve station.
Report wait Congress. Account various grow name. Film new talk thus people technology.",22:25:53,CHEQUE
ZEZC96782790610481,GB65LENL00340791361820,3/14/2018,21699.69,100002,Y,Utilities,FF,MOBILE,Dr,12:24:40,16:35:18,4/29/2021,2705224,437.26,4,"School relationship employee where discover strong man glass. Interest staff discuss. Evening live truth will agent.
Into ready down. Involve main soldier culture likely. Point include already cost.",14:14:05,UPI
ZEZC96782790610481,GB65LENL00340791361820,3/14/2018,21881.89,100002,N,Credited,OPERA,POS,Cr,4:14:22,6:13:04,5/1/2021,53970145,182.2,4,"Child term arm recent finish how carry.
Avoid treatment part example enjoy lose. Rule true international campaign owner.",5:10:34,UPI
ZEZC96782790610481,GB65LENL00340791361820,3/14/2018,22064.09,100002,N,Credited,EDGE,POS,Cr,12:48:20,15:40:45,5/1/2021,97832225,182.2,3,"Base agency a. Country summer safe cultural team. Before catch though others.
Tax fine after baby. Campaign fill peace once. Stay man too.
North worker each interest begin.",13:46:32,RTGS
ZEZC96782790610481,GB65LENL00340791361820,3/14/2018,22246.29,100002,N,Credited,MI,PC,Cr,14:21:28,16:52:56,5/1/2021,31768733,182.2,5,Skill eat father security cold about light know. Cup particularly alone her generation.,16:07:57,CARDS
ZEZC96782790610481,GB65LENL00340791361820,3/14/2018,22428.49,100002,N,Credited,IE,PC,Cr,19:20:36,22:42:57,5/1/2021,30514478,182.2,2,"Even know station. Morning market set whom movie against.
Town real discuss rise stage report get. Page on thank brother method she. Something situation continue doctor get.",21:14:01,IMPS
ZEZC96782790610481,GB65LENL00340791361820,3/14/2018,24338.77,100002,N,Credited,EDGE,MOBILE,Cr,13:28:08,17:34:25,5/4/2021,76834073,1910.28,1,"Head value art assume senior. Score strategy much finally.
Say change year movie. Identify little crime one.
Story may me consider unit yeah professional. Hour example could.",15:47:36,NEFT
ZEZC96782790610481,GB65LENL00340791361820,3/14/2018,26249.05,100002,N,Credited,FF,PC,Cr,14:45:57,21:24:40,5/4/2021,31232456,1910.28,2,"Move figure rather successful. Authority age language. Street unit direction pass evening your out.
Or present evidence maybe. Local never able. Guess street mission edge instead.",17:52:47,IMPS
ZEZC96782790610481,GB65LENL00340791361820,3/14/2018,26807.97,100002,N,Credited,MI,POS,Cr,5:46:38,9:39:44,5/6/2021,66598480,558.92,6,"Realize entire thing growth. Lose record everything director western nice perhaps.
Consumer guy involve. Out wait difficult program soldier half.",8:36:19,CHEQUE
ZEZC96782790610481,GB65LENL00340791361820,3/14/2018,27366.89,100002,N,Credited,FF,MOBILE,Cr,17:59:14,23:24:51,5/6/2021,98098903,558.92,7,"Public throw reach determine sort box. Move such identify. Window cold material day station rich.
Writer serious place commercial reduce huge light. Throw wear help cause Mrs along.",21:04:51,DD
ZEZC96782790610481,GB65LENL00340791361820,3/14/2018,25629.97,100002,Y,Transportation,SAFARI,MOBILE,Dr,3:52:41,5:10:50,5/15/2021,86231930,1736.92,1,"Scientist any issue leg.
World the war staff perhaps. Factor news Democrat bag. Perhaps pressure rock population never produce and to.",4:42:50,NEFT
ZEZC96782790610481,GB65LENL00340791361820,3/14/2018,23893.05,100002,Y,Online Shopping,MI,POS,Dr,8:14:27,9:11:10,5/15/2021,45641046,1736.92,2,"Build property tax few class play learn. Draw wait east today. Wish rock voice general.
Father yet kitchen success moment. Before someone account bed.",8:41:35,IMPS
ZEZC96782790610481,GB65LENL00340791361820,3/14/2018,22156.13,100002,Y,Insurance,IE,MOBILE,Dr,11:17:33,14:34:50,5/15/2021,2496986,1736.92,2,Increase middle water wish foreign catch. Ask move most expect and budget. Green actually indeed speech enough account. Yet scientist letter start return in.,13:11:35,IMPS
ZEZC96782790610481,GB65LENL00340791361820,3/14/2018,23893.05,100002,N,Credited,CHROME,POS,Cr,19:00:51,20:20:31,5/15/2021,90022401,1736.92,7,"Wonder place old reflect particularly customer ago. Say fill every imagine. What hand anything check peace ok building.
Next true reduce.
Mrs foot purpose executive him.",19:52:12,DD
ZEZC96782790610481,GB65LENL00340791361820,3/14/2018,22156.13,100002,Y,Transportation,EDGE,MOBILE,Dr,22:21:32,23:59:05,5/15/2021,92415683,1736.92,1,"Front like hold field candidate item recent. Magazine maybe draw enter. Figure name area first establish appear simply.
Personal open happy chance popular. Worry hospital base leader.",23:19:33,NEFT
ZEZC96782790610481,GB65LENL00340791361820,3/14/2018,21189.7,100002,Y,Groceries,EDGE,POS,Dr,5:18:18,9:28:53,5/24/2021,57470450,966.43,3,"Professional whether consider important soldier. Send identify bank film data six my.
My around upon structure investment could. Recent training wait style. Foreign low year order.",8:11:07,RTGS
ZEZC96782790610481,GB65LENL00340791361820,3/14/2018,22156.13,100002,N,Credited,CHROME,PC,Cr,15:01:59,18:00:06,5/24/2021,4479758,966.43,5,"Race out service red. Near material especially.
Three natural song across reveal agreement. Start tend goal organization color age. Stock so above meeting.",15:42:40,CARDS
ZEZC96782790610481,GB65LENL00340791361820,3/14/2018,21189.7,100002,Y,Entertainment,EDGE,MOBILE,Dr,17:01:57,20:16:36,5/24/2021,73085966,966.43,7,"Stay quality same social so wait. Man hard give wife state wall live. Activity approach brother discussion customer agency.
Too section media down. Exactly year level spend network first.",19:12:40,DD
ZEZC96782790610481,GB65LENL00340791361820,3/14/2018,20829.31,100002,Y,Utilities,IE,PC,Dr,9:39:39,13:49:24,5/29/2021,77873538,360.39,3,Majority best help partner produce. Fund too central arm art. Mr less score table. Mean miss ok that remain next everything.,10:54:19,RTGS
ZEZC96782790610481,GB65LENL00340791361820,3/14/2018,21189.7,100002,N,Credited,CHROME,MOBILE,Cr,14:19:54,19:03:43,5/29/2021,86140911,360.39,5,"No tend religious commercial. Own instead science expert daughter. Body very show network begin.
Real it strategy raise. Country black have.",17:05:04,CARDS
ZEZC96782790610481,GB65LENL00340791361820,3/14/2018,20829.31,100002,Y,Transportation,IE,POS,Dr,21:20:17,26:38:10,5/29/2021,60082534,360.39,1,Set small money friend pretty difference care. Write American task. Authority give subject until story pretty. Sure style water strategy million fall enjoy.,23:50:38,NEFT
ZEZC96782790610481,GB65LENL00340791361820,3/14/2018,18960.94,100002,Y,Entertainment,OPERA,POS,Dr,6:21:20,8:45:40,6/11/2021,72014141,1868.37,3,"Season lose local enter. Bed meeting walk fine. None mouth might eight can feeling fear.
Cost go three suggest surface interview today. Generation cup employee two need top attack.",7:04:12,RTGS
ZEZC96782790610481,GB65LENL00340791361820,3/14/2018,20829.31,100002,N,Credited,SAFARI,POS,Cr,8:26:40,11:38:11,6/11/2021,69897665,1868.37,3,Popular garden billion size cover scene identify talk. Field work glass fund expert reason. Institution ball firm yard ready whole bad.,10:24:33,RTGS
ZEZC96782790610481,GB65LENL00340791361820,3/14/2018,22697.68,100002,N,Credited,SAFARI,POS,Cr,14:56:14,19:35:12,6/11/2021,962995,1868.37,4,Audience if guy protect explain. Involve writer between finish window TV claim economy.,17:12:39,UPI
ZEZC96782790610481,GB65LENL00340791361820,3/14/2018,20829.31,100002,Y,Transportation,IE,PC,Dr,18:14:56,22:24:42,6/11/2021,39347442,1868.37,7,"Its gun trade eight. Their social stage forward.
Everybody travel stop case produce technology training write. Order not hold both season matter.",20:09:36,DD
ZEZC96782790610481,GB65LENL00340791361820,3/14/2018,20823.58,100002,Y,Household Consumables,SAFARI,MOBILE,Dr,17:33:46,24:39:25,6/13/2021,20677299,5.73,7,"Realize whole major. Practice heavy lot while arm team level.
Memory great many though race behind situation. Way only be seven put should. Its budget back accept glass itself.",22:19:35,DD
ZEZC96782790610481,GB65LENL00340791361820,3/14/2018,20971.67,100002,N,Credited,OPERA,PC,Cr,5:51:34,8:35:41,6/19/2021,96609101,148.09,5,"First have old effort close western dark determine. Free just day move across know.
President fine play sell. Prove try actually green speak do. Visit be main measure staff base check.",7:45:44,CARDS
ZEZC96782790610481,GB65LENL00340791361820,3/14/2018,21119.76,100002,N,Credited,MI,MOBILE,Cr,8:24:44,10:53:15,6/19/2021,62930284,148.09,7,"Quickly tell training see no human organization. Bank decade position.
After economy bed someone. Do simple follow process.",10:13:30,DD
ZEZC96782790610481,GB65LENL00340791361820,3/14/2018,20971.67,100002,Y,Rent,FF,MOBILE,Dr,15:00:41,18:10:10,6/19/2021,77634337,148.09,2,"Audience model painting forget. Popular method stop collection. Across travel her fund staff condition project. Some former social pick lot management administration.
Stop very site everyone under.",15:48:26,IMPS
ZEZC96782790610481,GB65LENL00340791361820,3/14/2018,21119.76,100002,N,Credited,SAFARI,POS,Cr,19:47:10,22:31:22,6/19/2021,50529964,148.09,1,"Across opportunity air speech score attorney amount. Economic toward give rather many.
Listen father camera discuss.",20:41:05,NEFT
ZEZC96782790610481,GB65LENL00340791361820,3/14/2018,21036.26,100002,Y,Groceries,IE,POS,Dr,7:50:24,12:32:15,6/23/2021,40032214,83.5,2,Major scientist million theory compare run. Political police school accept certain make continue ball. Top degree sit story.,10:46:02,IMPS
ZEZC96782790610481,GB65LENL00340791361820,3/14/2018,21119.76,100002,N,Credited,SAFARI,MOBILE,Cr,10:29:29,14:14:09,6/23/2021,32828054,83.5,7,Card trial recently court personal she. Wish visit above it on hard matter. Rest affect food public. Month century plant ground contain current.,13:05:40,DD
ZEZC96782790610481,GB65LENL00340791361820,3/14/2018,21036.26,100002,Y,Medicals,MI,PC,Dr,22:23:30,25:38:34,6/23/2021,2497563,83.5,2,"Physical itself low production unit future. Can main beautiful force.
Little present month newspaper. Series effect significant hair trip over resource. Rich player house apply soon truth yet.",23:08:07,IMPS
ZEZC96782790610481,GB65LENL00340791361820,3/14/2018,22092.41,100002,N,Credited,OPERA,POS,Cr,7:34:36,18:55:57,6/25/2021,96650639,1056.15,5,"Those next smile result fall power. Career ask catch box realize.
Personal wall yard another.",13:33:15,CARDS
ZEZC96782790610481,GB65LENL00340791361820,3/14/2018,20572.34,100002,Y,Household Consumables,MI,POS,Dr,14:03:13,21:31:19,6/27/2021,13056896,1520.07,5,Cause budget huge large push newspaper leader. Miss ten federal our fact ability. Score price produce like.,17:08:51,CARDS
ZEZC96782790610481,GB65LENL00340791361820,3/14/2018,20501.15,100002,Y,Personal Care,SAFARI,PC,Dr,11:52:23,17:34:33,6/30/2021,52965234,71.19,2,"Social many degree return within company least. Few former term popular team method.
Tell relationship arrive explain future. Activity run everything meeting its father whose.",14:56:28,IMPS
ZEZC96782790610481,GB65LENL00340791361820,3/14/2018,20429.96,100002,Y,Medicals,EDGE,PC,Dr,15:09:35,18:51:27,6/30/2021,38468551,71.19,4,"Center arrive threat build. That over memory more member. Set provide best letter.
Course nor purpose cut. Admit example prepare degree usually.",17:55:45,UPI
ZEZC96782790610481,GB65LENL00340791361820,3/14/2018,18671.34,100002,Y,Groceries,IE,MOBILE,Dr,4:00:11,5:33:44,7/3/2021,32381894,1758.62,4,Move economy employee work rise. Art arrive attorney leave themselves lay how.,4:42:46,UPI
ZEZC96782790610481,GB65LENL00340791361820,3/14/2018,20429.96,100002,N,Credited,IE,MOBILE,Cr,7:54:24,9:44:38,7/3/2021,6911317,1758.62,2,Change education career chair back. Amount community response wide amount enjoy. Yes box carry response wall.,8:20:01,IMPS
ZEZC96782790610481,GB65LENL00340791361820,3/14/2018,22188.58,100002,N,Credited,CHROME,POS,Cr,14:14:41,16:07:01,7/3/2021,12619498,1758.62,5,"Cup soldier compare medical.
Radio single movement experience maintain financial book. Maybe whole require however western research week.",15:32:26,CARDS
ZEZC96782790610481,GB65LENL00340791361820,3/14/2018,20429.96,100002,Y,Personal Care,MI,MOBILE,Dr,14:11:55,17:08:20,7/3/2021,17629270,1758.62,2,Clearly player baby respond old those. Result score watch understand throughout common group. Else building subject color feel remain finally blood. Seat new type modern wall.,16:10:46,IMPS
ZEZC96782790610481,GB65LENL00340791361820,3/14/2018,18671.34,100002,Y,Dining,SAFARI,POS,Dr,19:35:48,21:52:31,7/3/2021,9345270,1758.62,2,"Side positive his. Computer early across contain. Information recently ability response far.
Long collection perform trip.
Difficult quite return cultural various movie wish keep. Stage the culture.",21:07:21,IMPS
ZEZC96782790610481,GB65LENL00340791361820,3/14/2018,20634.19,100002,N,Credited,OPERA,POS,Cr,8:46:24,11:23:35,7/7/2021,78775657,1962.85,5,"Model only religious number modern simple. Process television realize trip allow book. Eat officer carry box tell.
Write ahead quickly trade. Practice doctor produce world wait western heavy.",9:35:14,CARDS
ZEZC96782790610481,GB65LENL00340791361820,3/14/2018,22597.04,100002,N,Credited,CHROME,PC,Cr,12:48:56,16:51:55,7/7/2021,75854751,1962.85,2,Blue after change myself peace. Where growth ago animal certainly account follow. Network important alone there.,15:45:22,IMPS
ZEZC96782790610481,GB65LENL00340791361820,3/14/2018,24559.89,100002,N,Credited,IE,POS,Cr,20:32:00,23:56:14,7/7/2021,8904478,1962.85,1,Vote use fact of word put choose idea. Area education assume me idea. Go worker sense doctor heavy possible respond.,22:37:19,NEFT
ZEZC96782790610481,GB65LENL00340791361820,3/14/2018,22744.58,100002,Y,Entertainment,MI,PC,Dr,3:53:12,6:11:10,7/10/2021,3224243,1815.31,2,General or send color. Beat meeting marriage. Exactly region financial seem blood property increase we.,5:08:28,IMPS
ZEZC96782790610481,GB65LENL00340791361820,3/14/2018,24559.89,100002,N,Credited,FF,MOBILE,Cr,10:50:13,14:25:08,7/10/2021,46796370,1815.31,4,None ready bar ball never so significant answer. Light wait perhaps leader take painting. Federal act act less people situation.,12:47:01,UPI
ZEZC96782790610481,GB65LENL00340791361820,3/14/2018,22744.58,100002,Y,Rent,EDGE,PC,Dr,15:41:16,18:09:21,7/10/2021,81102303,1815.31,6,Party material same answer never become hotel. Fight itself picture level idea minute property. Organization hear true company produce.,16:19:53,CHEQUE
ZEZC96782790610481,GB65LENL00340791361820,3/14/2018,24559.89,100002,N,Credited,CHROME,POS,Cr,20:03:06,22:33:18,7/10/2021,86020350,1815.31,5,Go season when Mr Mr market. Position help provide unit. Leave wife authority drop ground.,20:55:54,CARDS
ZEZC96782790610481,GB65LENL00340791361820,3/14/2018,23223.69,100002,Y,Household Consumables,IE,MOBILE,Dr,6:51:02,12:36:14,7/12/2021,2126463,1336.2,7,"Economic population account work. Film media others year data raise we. Single current modern next great.
Hair long travel provide certain maybe. Always hear international they own page since.",10:23:48,DD
ZEZC96782790610481,GB65LENL00340791361820,3/14/2018,21887.49,100002,Y,Personal Care,MI,MOBILE,Dr,16:44:43,22:04:17,7/12/2021,35911791,1336.2,3,"Quality candidate guy subject. Fish coach cut try.
Clearly store hear wait. Process prevent little gas sometimes decade trade.
Money oil major reduce. Arm teach create.",19:47:28,RTGS
ZEZC96782790610481,GB65LENL00340791361820,3/14/2018,22914.33,100002,N,Credited,CHROME,PC,Cr,9:20:40,13:17:19,7/21/2021,94474411,1026.84,2,Source commercial dream smile night want. Spend thus left control interview establish special view.,11:23:47,IMPS
ZEZC96782790610481,GB65LENL00340791361820,3/14/2018,21887.49,100002,Y,Utilities,IE,PC,Dr,15:07:47,18:42:44,7/21/2021,11426707,1026.84,1,"Seven record threat cut.
Kind station sit rich. Support that she.
A manager say scientist.",17:26:55,NEFT
ZEZC96782790610481,GB65LENL00340791361820,3/14/2018,22914.33,100002,N,Credited,CHROME,PC,Cr,16:28:35,19:45:49,7/21/2021,90413544,1026.84,1,"Generation project such program situation. Price quality attorney car always make. Hope since him live across loss.
Decide southern clearly house. Call check even not thought view.",18:58:38,NEFT
ZEZC96782790610481,GB65LENL00340791361820,3/14/2018,21559.97,100002,Y,Rent,CHROME,PC,Dr,6:32:00,13:09:02,7/24/2021,71148731,1354.36,2,"Ground general picture many early wear. Impact gun board.
American alone community be writer yard find total. Fight finally draw science.",9:42:49,IMPS
ZEZC96782790610481,GB65LENL00340791361820,3/14/2018,22914.33,100002,N,Credited,FF,MOBILE,Cr,22:37:45,27:32:39,7/24/2021,25783803,1354.36,4,Agree everything put Mr involve success investment. Find short law various girl believe. Run mouth new article less.,23:41:29,UPI
ZEZC96782790610481,GB65LENL00340791361820,3/14/2018,23147.29,100002,N,Credited,SAFARI,PC,Cr,6:00:18,12:28:32,7/28/2021,35270461,232.96,6,"Save analysis own simply. Left bring hot name director participant field. Hot affect image over present feeling.
Movement center sound.",9:06:31,CHEQUE
ZEZC96782790610481,GB65LENL00340791361820,3/14/2018,23380.25,100002,N,Credited,CHROME,POS,Cr,17:04:50,23:30:50,7/28/2021,41697030,232.96,2,"Security business north question thank. Whether a popular water man money. Attention us environmental office treatment.
Challenge interview church it.",20:22:15,IMPS
ZEZC96782790610481,GB65LENL00340791361820,3/14/2018,22320.35,100002,Y,Utilities,CHROME,PC,Dr,3:50:11,6:23:03,8/2/2021,31114998,1059.9,7,Say cover history everybody. Action create hundred watch start. Yourself message finally I job experience.,5:14:32,DD
ZEZC96782790610481,GB65LENL00340791361820,3/14/2018,23380.25,100002,N,Credited,CHROME,PC,Cr,8:21:07,10:56:31,8/2/2021,41209073,1059.9,7,"Figure hope bank history. Energy response lot since something home hear.
Source age list information case Mrs painting. Court real while air.",9:12:39,DD
ZEZC96782790610481,GB65LENL00340791361820,3/14/2018,22320.35,100002,Y,Utilities,OPERA,POS,Dr,14:18:05,16:15:04,8/2/2021,74735129,1059.9,7,"Authority over science page. Question very cut mean especially. Upon fly piece person development future ever.
Pm or resource drive. Factor feel step idea movie. Remain reduce raise raise.",15:49:16,DD
ZEZC96782790610481,GB65LENL00340791361820,3/14/2018,23380.25,100002,N,Credited,EDGE,PC,Cr,15:17:14,17:27:41,8/2/2021,79451635,1059.9,7,"Positive change but everybody day. And resource grow political that why easy play. End lawyer lot necessary fight production.
Of hotel per address suffer. Option rock social executive.",16:11:06,DD
ZEZC96782790610481,GB65LENL00340791361820,3/14/2018,24440.15,100002,N,Credited,OPERA,PC,Cr,21:11:19,23:23:16,8/2/2021,40952956,1059.9,1,Offer me against contain growth recent five. Middle give rest Democrat of technology. Remain example rate boy thousand join watch.,22:25:02,NEFT
ZEZC96782790610481,GB65LENL00340791361820,3/14/2018,26313.51,100002,N,Credited,SAFARI,MOBILE,Cr,5:00:24,8:38:42,8/7/2021,8689511,1873.36,1,"Employee into bank although.
Property finish change administration door life. Hotel training foreign five.",6:42:58,NEFT
ZEZC96782790610481,GB65LENL00340791361820,3/14/2018,28186.87,100002,N,Credited,EDGE,MOBILE,Cr,8:17:09,11:05:05,8/7/2021,82275099,1873.36,4,"Voice anything behind phone sense explain. Tree door second card although keep.
Area fall page. Defense clear sometimes.",9:36:53,UPI
ZEZC96782790610481,GB65LENL00340791361820,3/14/2018,30060.23,100002,N,Credited,MI,PC,Cr,13:51:14,15:05:24,8/7/2021,13714710,1873.36,2,"Country pay move during. Surface development cut away cold. Cell certainly behind quality.
Eight near take.
Newspaper political offer care.",14:17:54,IMPS
ZEZC96782790610481,GB65LENL00340791361820,3/14/2018,31933.59,100002,N,Credited,OPERA,MOBILE,Cr,18:51:51,19:59:23,8/7/2021,4613350,1873.36,1,"Manager class hundred white specific oil. Save heavy main land place expect wish.
Although fall benefit forward.",19:16:12,NEFT
ZEZC96782790610481,GB65LENL00340791361820,3/14/2018,33806.95,100002,N,Credited,IE,POS,Cr,20:39:13,23:40:20,8/7/2021,56864335,1873.36,4,"Fight poor stage teacher still. Area forget open value. Try notice grow international.
Always camera how.",22:00:34,UPI
ZEZC96782790610481,GB65LENL00340791361820,3/14/2018,33817.06,100002,N,Credited,IE,MOBILE,Cr,5:57:28,8:09:40,8/30/2021,21702259,10.11,6,"Vote he rule or east cost. Main different nor. Coach response above.
Group of within service even. Believe why land change. Bit left thousand our take. Wait success buy finally too.",7:20:28,CHEQUE
ZEZC96782790610481,GB65LENL00340791361820,3/14/2018,33827.17,100002,N,Credited,OPERA,POS,Cr,12:09:40,16:25:19,8/30/2021,2075259,10.11,4,"Recently above pick local. Tonight lead similar.
Particular heavy player wait north sound check.
But PM cell total. Husband tree available. Window same perhaps red standard significant.",14:18:37,UPI
ZEZC96782790610481,GB65LENL00340791361820,3/14/2018,33817.06,100002,Y,Insurance,EDGE,PC,Dr,12:40:26,15:43:05,8/30/2021,6912628,10.11,7,Own blue girl meeting talk simple. How natural quickly commercial relate model. System marriage rest hard ago.,14:42:06,DD
ZEZC96782790610481,GB65LENL00340791361820,3/14/2018,33827.17,100002,N,Credited,FF,PC,Cr,21:43:28,23:13:16,8/30/2021,19997216,10.11,7,To serious herself hair care dinner. Western run down adult.,22:23:20,DD
ZEZC96782790610481,GB65LENL00340791361820,3/14/2018,35031.59,100002,N,Credited,SAFARI,POS,Cr,4:09:39,6:16:25,8/31/2021,27642825,1204.42,6,Of list south since raise special key direction. Air off detail picture heavy material member. Stop so possible power. Much consider finally western.,5:25:55,CHEQUE
ZEZC96782790610481,GB65LENL00340791361820,3/14/2018,36236.01,100002,N,Credited,CHROME,MOBILE,Cr,11:30:44,14:44:30,8/31/2021,63119558,1204.42,6,"Rest model figure shake around yet newspaper across. Choose learn particularly candidate guy how own. Unit outside have near claim impact full.
Your building hand my industry opportunity.",12:58:34,CHEQUE
ZEZC96782790610481,GB65LENL00340791361820,3/14/2018,35031.59,100002,Y,Groceries,MI,POS,Dr,17:05:58,20:10:02,8/31/2021,74509973,1204.42,2,"Member talk by site opportunity.
Time country in leave relate and from. Practice teacher focus window minute attention fly field. Let option way push thank.",18:50:34,IMPS
ZEZC96782790610481,GB65LENL00340791361820,3/14/2018,33827.17,100002,Y,Online Shopping,CHROME,POS,Dr,18:26:17,21:24:06,8/31/2021,43790005,1204.42,1,Positive ask concern drop third able. Describe participant other old station class. Social cultural cut company.,19:53:01,NEFT
ZEZC96782790610481,GB65LENL00340791361820,3/14/2018,34218.3,100002,N,Credited,OPERA,POS,Cr,10:52:32,15:05:10,9/12/2021,84655226,391.13,5,"Forward southern event serious mother cut very.
Election draw meet.
Try become ability sense like perform face really. Experience computer though together maintain author summer.",14:08:00,CARDS
ZEZC96782790610481,GB65LENL00340791361820,3/14/2018,33827.17,100002,Y,Medicals,EDGE,MOBILE,Dr,14:59:23,18:47:37,9/12/2021,68846664,391.13,2,"Tree mind staff teach former face most in. Upon protect indeed main red.
Break level doctor pull final or. Artist order that ahead sport.",17:00:08,IMPS
ZEZC96782790610481,GB65LENL00340791361820,3/14/2018,35083.46,100002,N,Credited,OPERA,POS,Cr,2:43:40,4:46:54,9/14/2021,74707492,1256.29,2,Color home despite interesting animal give. Usually white fine. You community chair medical material local resource wear.,4:02:06,IMPS
ZEZC96782790610481,GB65LENL00340791361820,3/14/2018,33827.17,100002,Y,Entertainment,IE,MOBILE,Dr,7:26:22,9:19:45,9/14/2021,41616819,1256.29,3,Wife wife inside task return station paper key. Wonder rich growth next art ahead. Type season low whether career.,8:00:23,RTGS
ZEZC96782790610481,GB65LENL00340791361820,3/14/2018,35083.46,100002,N,Credited,CHROME,MOBILE,Cr,13:35:12,15:09:23,9/14/2021,19750705,1256.29,3,Quite move how learn create us appear face. Medical require option run.,14:05:00,RTGS
ZEZC96782790610481,GB65LENL00340791361820,3/14/2018,33827.17,100002,Y,Medicals,OPERA,MOBILE,Dr,14:49:11,17:46:14,9/14/2021,13667955,1256.29,7,"Everything contain follow step bill. Determine along career lot dream cold.
Admit enough fear already chair away. Letter southern write our hear two plant forward.",16:20:46,DD
ZEZC96782790610481,GB65LENL00340791361820,3/14/2018,32570.88,100002,Y,Utilities,FF,POS,Dr,19:32:12,21:27:47,9/14/2021,65197356,1256.29,5,Environmental indicate sport. Pass night imagine safe place image. Under dark mission late stage week. Wear human eye life nearly I.,20:38:37,CARDS
ZEZC96782790610481,GB65LENL00340791361820,3/14/2018,31259.05,100002,Y,Groceries,IE,POS,Dr,3:56:27,7:09:48,9/21/2021,75740146,1311.83,6,"Politics dark industry security democratic many. It ahead development he natural rest.
Democrat impact skin somebody onto store.",6:09:58,CHEQUE
ZEZC96782790610481,GB65LENL00340791361820,3/14/2018,32570.88,100002,N,Credited,OPERA,POS,Cr,17:05:57,18:32:29,9/21/2021,75217143,1311.83,4,"Job away marriage support. Claim chance inside serve minute deal. Capital have college something.
Product body look ok scientist necessary woman. Person education voice by decision.",17:43:27,UPI
ZEZC96782790610481,GB65LENL00340791361820,3/14/2018,31259.05,100002,Y,Utilities,EDGE,MOBILE,Dr,17:39:17,22:27:20,9/21/2021,56083521,1311.83,5,One color key still condition focus expert. Girl production worker statement wife.,19:52:02,CARDS
ZEZC96782790610481,GB65LENL00340791361820,3/14/2018,30074.76,100002,Y,Rent,EDGE,POS,Dr,5:13:18,6:25:30,9/29/2021,67633890,1184.29,3,"Probably these debate sit clearly. Beyond set simply pull former her article. Style before personal.
West remember tax force save. Write water later.",5:50:46,RTGS
ZEZC96782790610481,GB65LENL00340791361820,3/14/2018,28890.47,100002,Y,Groceries,MI,PC,Dr,9:56:14,11:39:35,9/29/2021,28606796,1184.29,1,Religious toward still certainly measure reality social. Brother area choose box candidate smile so father. Career grow determine base need wait. Treat here this let alone.,10:49:07,NEFT
ZEZC96782790610481,GB65LENL00340791361820,3/14/2018,27706.18,100002,Y,Household Consumables,CHROME,PC,Dr,11:46:51,15:04:32,9/29/2021,58023990,1184.29,5,Yes four without partner air success. Major time drop concern style early. President boy around buy newspaper important.,13:25:49,CARDS
ZEZC96782790610481,GB65LENL00340791361820,3/14/2018,28890.47,100002,N,Credited,SAFARI,PC,Cr,16:01:23,18:10:35,9/29/2021,33000916,1184.29,5,Section body area six explain property can. Court strategy line plan whatever charge mouth.,16:50:24,CARDS
ZEZC96782790610481,GB65LENL00340791361820,3/14/2018,27706.18,100002,Y,Online Shopping,FF,PC,Dr,19:14:29,22:08:01,9/29/2021,76311871,1184.29,3,"System husband within project stuff always. Safe tonight drive.
Less PM agency head hand. Challenge see believe say avoid civil bar. Television probably cup prepare be order.",21:09:42,RTGS
ZEZC96782790610481,GB65LENL00340791361820,3/14/2018,28836.97,100002,N,Credited,OPERA,POS,Cr,14:45:05,21:10:26,9/30/2021,92042650,1130.79,6,"Stock deep admit class include property base. Quickly our dark fear security relate.
Challenge consumer smile enough somebody home suggest. Might still wear dark. Evening organization present.",17:48:17,CHEQUE
ZEZC96782790610481,GB65LENL00340791361820,3/14/2018,29421.17,100002,N,Credited,FF,MOBILE,Cr,3:59:40,5:52:08,10/3/2021,97173366,584.2,5,"Increase happen your reach. Sure factor realize.
Debate trip among president game. Follow our dog approach study. People position car often sound if.",5:08:31,CARDS
ZEZC96782790610481,GB65LENL00340791361820,3/14/2018,28836.97,100002,Y,Insurance,OPERA,PC,Dr,9:27:58,12:09:06,10/3/2021,15177957,584.2,4,"Start democratic enter court tonight model whatever. Yourself somebody since tax else your out.
Continue century yourself particularly worry police final. Cost everyone join world it season.",10:47:40,UPI
ZEZC96782790610481,GB65LENL00340791361820,3/14/2018,28252.77,100002,Y,Insurance,FF,PC,Dr,15:41:35,18:59:54,10/3/2021,28052265,584.2,2,"Up current majority. Few church region would suggest able ready.
System care board perform long. Write health oil hot.",17:00:21,IMPS
ZEZC96782790610481,GB65LENL00340791361820,3/14/2018,27668.57,100002,Y,Household Consumables,OPERA,MOBILE,Dr,19:56:35,22:27:37,10/3/2021,14400889,584.2,5,"Local spend tend sort ever.
Cold modern allow with floor system deal.",21:07:44,CARDS
ZEZC96782790610481,GB65LENL00340791361820,3/14/2018,27714.57,100002,N,Credited,OPERA,PC,Cr,8:01:43,10:40:50,10/5/2021,97819790,46,1,"Staff child make ever health. How environmental born admit television.
Free cultural brother better agency. Similar none action.
Receive understand accept indicate. Consider sure what could cost.",8:56:56,NEFT
ZEZC96782790610481,GB65LENL00340791361820,3/14/2018,27760.57,100002,N,Credited,OPERA,MOBILE,Cr,10:14:43,13:18:31,10/5/2021,99211486,46,4,"Certain couple window serious every foot. Majority spring along sport.
Your three alone whom where left. Prove check music method space ground be.",10:59:21,UPI
ZEZC96782790610481,GB65LENL00340791361820,3/14/2018,27806.57,100002,N,Credited,MI,PC,Cr,14:20:32,16:59:58,10/5/2021,26903682,46,5,Lose majority notice. Nothing involve practice green never into which network. Sister change government computer.,15:40:10,CARDS
ZEZC96782790610481,GB65LENL00340791361820,3/14/2018,27852.57,100002,N,Credited,OPERA,PC,Cr,18:47:52,22:37:20,10/5/2021,67153442,46,3,Health science either time talk picture. Someone shoulder moment relate alone. Sometimes board enter wife school rich matter.,20:22:50,RTGS
ZEZC96782790610481,GB65LENL00340791361820,3/14/2018,29580.94,100002,N,Credited,EDGE,MOBILE,Cr,5:41:26,10:53:12,10/7/2021,12849611,1728.37,7,"Congress owner feeling red piece fall. Top back necessary camera.
Suddenly conference into military interest but as. Remain catch yourself inside someone road. Send instead forget analysis.",8:24:48,DD
ZEZC96782790610481,GB65LENL00340791361820,3/14/2018,27852.57,100002,Y,Groceries,EDGE,MOBILE,Dr,12:51:58,17:02:47,10/7/2021,8322524,1728.37,6,"Record test drop soon. Follow north new article attorney difficult. Figure even maintain benefit want large else.
Baby thank very region. Actually front yard soldier tell appear stock.",15:44:17,CHEQUE
ZEZC96782790610481,GB65LENL00340791361820,3/14/2018,29580.94,100002,N,Credited,SAFARI,PC,Cr,18:53:13,22:07:18,10/7/2021,78090651,1728.37,4,Scientist theory eight. Century his such science. Church mind operation happy scene.,21:03:52,UPI
ZEZC96782790610481,GB65LENL00340791361820,3/14/2018,28097.45,100002,Y,Insurance,EDGE,MOBILE,Dr,17:46:24,27:37:10,10/15/2021,50007233,1483.49,6,"Avoid vote north recognize watch difficult somebody something. Front listen world stand.
Form minute doctor scientist foot. Thing tree ago speak receive huge. Happy strong method.",23:00:21,CHEQUE
ZEZC96782790610481,GB65LENL00340791361820,3/14/2018,26379.43,100002,Y,Dining,CHROME,POS,Dr,5:09:03,7:14:59,10/19/2021,63889161,1718.02,1,"Probably where I cup theory oil. Feeling movie born federal house. Especially believe support exactly offer break.
Film daughter night. Matter participant enough situation catch country.",6:12:42,NEFT
ZEZC96782790610481,GB65LENL00340791361820,3/14/2018,24661.41,100002,Y,Household Consumables,MI,MOBILE,Dr,8:43:22,11:07:14,10/19/2021,74806096,1718.02,1,"Research past about music laugh by my key. Through speech allow itself kitchen. Remain performance himself.
Benefit there center house garden strong. Hour writer you employee wear.",10:22:01,NEFT
ZEZC96782790610481,GB65LENL00340791361820,3/14/2018,26379.43,100002,N,Credited,OPERA,MOBILE,Cr,12:20:53,14:38:14,10/19/2021,41708040,1718.02,3,Street analysis American lawyer official. East top apply. To hope discuss the.,12:44:54,RTGS
ZEZC96782790610481,GB65LENL00340791361820,3/14/2018,24661.41,100002,Y,Utilities,SAFARI,MOBILE,Dr,17:02:08,19:01:29,10/19/2021,59384557,1718.02,7,"Major strong nothing friend interview. First thing leave end far machine man.
News certainly their analysis open practice. Drug fine mother short another.",17:34:41,DD
ZEZC96782790610481,GB65LENL00340791361820,3/14/2018,22943.39,100002,Y,Medicals,EDGE,PC,Dr,21:44:19,23:47:50,10/19/2021,86416016,1718.02,2,"Reveal instead between this what career.
Movie ok chance reflect voice by. Protect my successful group place. Sign most better close provide choice card radio.",23:04:51,IMPS
